,position,token,information_gain,total_ocurences,total_flaky_occurences,total_nonflaky_occurences
0,0,then,0.10202531532247869,1313,1312,1
1,1,0,0.08103612926487994,1566,1440,126
2,2,function,0.07603698154494787,1031,1024,7
3,3,1,0.06803701945138002,1324,1216,108
4,4,var,0.06493244537905711,864,864,0
5,5,gd,0.0649324453790571,864,864,0
6,6,cy,0.05599957154863659,771,768,3
7,7,fixtureEl,0.0531748977762743,626,0,626
8,8,click,0.052962295623096886,1120,1024,96
9,9,getByTestID,0.04968429122848704,672,672,0
10,10,await,0.04789359956568002,2117,1216,901
11,11,const,0.04781200446637052,3552,1600,1952
12,12,it,0.04471293791610012,608,608,0
13,13,should,0.03979517581590784,544,544,0
14,14,done,0.0388976362022206,1390,1152,238
15,15,layout,0.03801799115258252,550,544,6
16,16,Plotly,0.03735601815153755,512,512,0
17,17,return,0.035704712181725995,868,768,100
18,18,browser,0.03390324600926813,737,224,513
19,19,2,0.033567626330247124,696,640,56
20,20,true,0.0308883521374801,1062,864,198
21,21,data,0.030577298846834442,688,608,80
22,22,to,0.028867943526715234,735,640,95
23,23,expect,0.0288653294264663,3850,2240,1610
24,24,y,0.028640126622823475,464,448,16
25,25,page,0.0264867797044775,440,416,24
26,26,next,0.024978827635485173,388,32,356
27,27,100,0.024905324732951713,437,416,21
28,28,machine,0.024776386276173575,300,0,300
29,29,400,0.024705092029830678,353,352,1
30,30,3,0.023869168390625202,487,448,39
31,31,x,0.023535399188322783,486,448,38
32,32,actual,0.022919071744021302,329,96,233
33,33,get,0.022422635672155505,549,480,69
34,34,$,0.022393787060450233,284,32,252
35,35,false,0.020923351028886907,577,480,97
36,36,i,0.020336125163529804,344,320,24
37,37,fixture,0.020227850032552026,289,288,1
38,38,if,0.019539423654881313,459,416,43
39,39,type,0.019122060076794883,908,640,268
40,40,"
			",0.019112035926088053,291,288,3
41,41,8,0.018297475880937025,256,256,0
42,42,detectChanges,0.018297475880937022,256,256,0
43,43,assert,0.01732168658618457,259,256,3
44,44,async,0.016094348832474514,569,416,153
45,45,org,0.015969984536417965,224,224,0
46,46,xaxis,0.015969984536417965,224,224,0
47,47,'exist',0.015969984536417958,224,224,0
48,48,yaxis,0.015969984536417958,224,224,0
49,49,toBeCloseToArray,0.015969984536417948,224,224,0
50,50,5,0.01558419526575729,266,256,10
51,51,Math,0.015565326101533434,226,224,2
52,52,span,0.015487400813617627,225,224,1
53,53,called,0.01546539145294478,235,224,11
54,54,service,0.015382180072522705,188,0,188
55,55,getBoundingClientRect,0.015352098180479378,225,224,1
56,56,20,0.01514462695169037,227,224,3
57,57,have,0.014747981102197348,242,224,18
58,58,resolve,0.014609244534907325,531,192,339
59,59,50,0.014397407874003992,228,224,4
60,60,res,0.014289126516576359,360,64,296
61,61,let,0.013923837676502565,357,320,37
62,62,equal,0.013776630739111423,427,352,75
63,63,4,0.013672670295031063,271,256,15
64,64,range,0.013654249547715974,192,192,0
65,65,_fullLayout,0.01365424954771597,192,192,0
66,66,contains,0.01365424954771597,192,192,0
67,67,been,0.013654249547715963,192,192,0
68,68,scratch,0.013654249547715963,192,192,0
69,69,waitFor,0.013535531606368067,204,192,12
70,70,text,0.013528966334886587,578,256,322
71,71,toBe,0.013328714523612267,1340,832,508
72,72,delay,0.013235295357519316,232,224,8
73,73,result,0.013082221277008869,287,32,255
74,74,eval,0.012981112343806098,241,96,145
75,75,find,0.012924873734911647,197,192,5
76,76,Foo,0.012495081125317324,197,192,5
77,77,trigger,0.011937089047478552,246,224,22
78,78,'have.length',0.011350148442041033,160,160,0
79,79,_mock,0.011350148442041033,160,160,0
80,80,Lib,0.011350148442041023,160,160,0
81,81,componentInstance,0.011350148442041023,160,160,0
82,82,extendDeep,0.011350148442041023,160,160,0
83,83,j,0.011350148442041023,160,160,0
84,84,componentDidUnmount,0.011350148442041016,160,160,0
85,85,msg,0.011336295300288008,166,160,6
86,86,document,0.011316176198290433,306,256,50
87,87,body,0.011265769771231171,264,224,40
88,88,spy,0.011170654752463203,341,192,149
89,89,expected,0.011107860105423003,160,128,32
90,90,user,0.0111000964588716,163,160,3
91,91,html,0.010930870339368907,262,32,230
92,92,800,0.010868333980426657,161,160,1
93,93,10,0.010819295744282163,203,192,11
94,94,length,0.01060916160831351,299,256,43
95,95,check,0.010512904264711456,149,64,85
96,96,window,0.010414758226022594,165,160,5
97,97,a,0.009759004384495482,147,32,115
98,98,actions,0.009607566274701437,154,96,58
99,99,wrapper,0.009593138558635528,167,160,7
100,100,not,0.009534984051067561,333,256,77
101,101,`${,0.009368669000464035,185,160,25
102,102,null,0.00922991023093965,229,192,37
103,103,height,0.00915009193047236,169,160,9
104,104,floor,0.009136625181990569,129,128,1
105,105,'time-machine-submit-button',0.009057560714815383,128,128,0
106,106,_fullData,0.009057560714815383,128,128,0
107,107,componentWillUnmount,0.009057560714815383,128,128,0
108,108,toBeWithin,0.009057560714815383,128,128,0
109,109,within,0.009057560714815383,128,128,0
110,110,mockCopy,0.00905756071481538,128,128,0
111,111,plot,0.00905756071481538,128,128,0
112,112,150,0.009057560714815373,128,128,0
113,113,Overlay,0.009057560714815373,128,128,0
114,114,difference,0.009057560714815373,128,128,0
115,115,marker,0.009057560714815373,128,128,0
116,116,mouseTo,0.009057560714815373,128,128,0
117,117,orgs,0.009057560714815373,128,128,0
118,118,relayout,0.009057560714815373,128,128,0
119,119,selectors,0.009057560714815373,128,128,0
120,120,bottom,0.009057560714815366,128,128,0
121,121,t,0.009037208500077387,161,128,33
122,122,args,0.008995694251257614,168,160,8
123,123,url,0.008988750220158537,213,32,181
124,124,item,0.008915672726410905,171,160,11
125,125,catch,0.008729566562625848,130,128,2
126,126,new,0.008672544196384887,553,224,329
127,127,props,0.008597341900362963,264,224,40
128,128,proto,0.008501354366092884,129,128,1
129,129,tooltip,0.008380378349174175,108,32,76
130,130,toEqual,0.008257202787688045,640,352,288
131,131,mock,0.008243430672107019,130,128,2
132,132,wait,0.008243430672107012,130,128,2
133,133,context,0.00817419175684672,166,64,102
134,134,200,0.008081857941303502,273,224,49
135,135,on,0.007849375107004857,145,32,113
136,136,elementByCss,0.007834310603439316,260,96,164
137,137,states,0.007631943449701056,94,0,94
138,138,foo,0.007592378126133404,215,160,55
139,139,}`,0.007578472839557777,217,192,25
140,140,input,0.00726963298188011,158,128,30
141,141,forEach,0.0072421753363583995,133,128,5
142,142,fn,0.007223043916575212,89,0,89
143,143,event,0.007141304117042705,88,0,88
144,144,'success',0.007082977263138307,98,32,66
145,145,Helmet,0.006999912359267481,142,32,110
146,146,child,0.006987059831296275,95,64,31
147,147,password,0.006935272066794989,98,96,2
148,148,'body',0.0069352720667949785,98,96,2
149,149,render,0.006866145491024857,181,160,21
150,150,16,0.006855813503704568,97,96,1
151,151,total,0.006855813503704568,97,96,1
152,152,'y',0.006855813503704565,97,96,1
153,153,13,0.006855813503704565,97,96,1
154,154,ctx,0.006814478456800507,84,0,84
155,155,'@org',0.006776367786465086,96,96,0
156,156,'@orgSetup',0.006776367786465086,96,96,0
157,157,1.5,0.006776367786465086,96,96,0
158,158,Organization,0.006776367786465086,96,96,0
159,159,_hover,0.006776367786465086,96,96,0
160,160,bBox,0.006776367786465086,96,96,0
161,161,day,0.006776367786465086,96,96,0
162,162,firstElementChild,0.006776367786465086,96,96,0
163,163,heroesList,0.006776367786465086,96,96,0
164,164,orgId,0.006776367786465086,96,96,0
165,165,scrollContainer,0.006776367786465086,96,96,0
166,166,xhr,0.006776367786465086,96,96,0
167,167,'be.visible',0.0067763677864650824,96,96,0
168,168,'rootId: 1',0.0067763677864650824,96,96,0
169,169,'x',0.0067763677864650824,96,96,0
170,170,dragmode,0.0067763677864650824,96,96,0
171,171,evaluate,0.0067763677864650824,96,96,0
172,172,fail,0.0067763677864650824,96,96,0
173,173,fig,0.0067763677864650824,96,96,0
174,174,getText,0.0067763677864650824,96,96,0
175,175,keyCode,0.0067763677864650824,96,96,0
176,176,toSnapshot,0.0067763677864650824,96,96,0
177,177,'include',0.0067763677864650755,96,96,0
178,178,'pathname',0.0067763677864650755,96,96,0
179,179,'plot',0.0067763677864650755,96,96,0
180,180,'scattergl',0.0067763677864650755,96,96,0
181,181,'transitionAxes',0.0067763677864650755,96,96,0
182,182,'transitionFromReact',0.0067763677864650755,96,96,0
183,183,0.01,0.0067763677864650755,96,96,0
184,184,0.5,0.0067763677864650755,96,96,0
185,185,Plots,0.0067763677864650755,96,96,0
186,186,Simulate,0.0067763677864650755,96,96,0
187,187,TestUtils,0.0067763677864650755,96,96,0
188,188,_basePlotModules,0.0067763677864650755,96,96,0
189,189,assertSpies,0.0067763677864650755,96,96,0
190,190,autorange,0.0067763677864650755,96,96,0
191,191,capture,0.0067763677864650755,96,96,0
192,192,centerX,0.0067763677864650755,96,96,0
193,193,centerY,0.0067763677864650755,96,96,0
194,194,colorbar,0.0067763677864650755,96,96,0
195,195,copyM,0.0067763677864650755,96,96,0
196,196,datePicker,0.0067763677864650755,96,96,0
197,197,describe,0.0067763677864650755,96,96,0
198,198,drag,0.0067763677864650755,96,96,0
199,199,each,0.0067763677864650755,96,96,0
200,200,gemini,0.0067763677864650755,96,96,0
201,201,keyDown,0.0067763677864650755,96,96,0
202,202,methods,0.0067763677864650755,96,96,0
203,203,navigate,0.0067763677864650755,96,96,0
204,204,nodeInput,0.0067763677864650755,96,96,0
205,205,option,0.0067763677864650755,96,96,0
206,206,renderer,0.0067763677864650755,96,96,0
207,207,restyle,0.0067763677864650755,96,96,0
208,208,sortAttributes,0.0067763677864650755,96,96,0
209,209,strictEqual,0.0067763677864650755,96,96,0
210,210,suite,0.0067763677864650755,96,96,0
211,211,taskName,0.0067763677864650755,96,96,0
212,212,testFormat,0.0067763677864650755,96,96,0
213,213,triggerHeight,0.0067763677864650755,96,96,0
214,214,color,0.006772261387839016,103,96,7
215,215,any,0.006759169639017744,88,32,56
216,216,setTimeout,0.006747048448992329,138,128,10
217,217,node,0.0066080918573758595,100,96,4
218,218,val,0.006599131762353747,106,96,10
219,219,'a',0.006596852840973028,92,32,60
220,220,name,0.006471909866461841,194,128,66
221,221,react,0.006374775732644682,98,96,2
222,222,'bar',0.0063463493411679665,94,64,30
223,223,Number,0.006295317169554261,97,96,1
224,224,fontSize,0.006295317169554261,97,96,1
225,225,15,0.006251611015755355,97,96,1
226,226,children,0.006203370830104398,152,128,24
227,227,state,0.006174459535921689,235,96,139
228,228,6,0.006142603882018314,102,96,6
229,229,duration,0.0061101023351570576,98,96,2
230,230,container,0.0060794249927643325,143,128,15
231,231,width,0.006061346290034282,107,96,11
232,232,size,0.006042471699040311,99,96,3
233,233,toMatch,0.006010693582798567,121,64,57
234,234,500,0.00596300028575732,98,96,2
235,235,div,0.005940981908247725,623,416,207
236,236,initial,0.005878511069990881,118,32,86
237,237,be,0.005748142372008018,111,96,15
238,238,client,0.005703437857921226,99,96,3
239,239,location,0.0056290774142897584,99,96,3
240,240,el,0.005568656194350601,105,64,41
241,241,Promise,0.005534735551817577,103,96,7
242,242,tooltipEl,0.0055093073179314,68,0,68
243,243,'b',0.00546599789708173,72,32,40
244,244,jasmine,0.00538524444108313,75,64,11
245,245,this,0.0053597849641952595,156,96,60
246,246,toBeDefined,0.005305289738650927,74,64,10
247,247,headers,0.0051835459553170055,64,0,64
248,248,nextState,0.005183545955317004,64,0,64
249,249,index,0.0051454191093724955,72,64,8
250,250,require,0.005065503173796585,71,64,7
251,251,1024,0.004985600151778328,70,64,6
252,252,title,0.00495780122827888,111,64,47
253,253,value,0.0049408186248472655,165,64,101
254,254,slice,0.004935054906715444,104,96,8
255,255,add,0.004905710038957964,69,64,5
256,256,toHaveBeenCalled,0.004901290916840665,65,32,33
257,257,key,0.004868259106364809,91,64,27
258,258,status,0.004776642328656362,59,0,59
259,259,p,0.004740063755586487,63,32,31
260,260,30,0.004666117112128842,66,64,2
261,261,7,0.004666117112128842,66,64,2
262,262,9,0.004666117112128842,66,64,2
263,263,clear,0.004666117112128842,66,64,2
264,264,else,0.004666117112128842,66,64,2
265,265,z,0.004666117112128842,66,64,2
266,266,success,0.004666117112128835,66,64,2
267,267,logs,0.004659283218853666,72,64,8
268,268,target,0.004646689262428623,97,64,33
269,269,prototype,0.004640042342897107,76,64,12
270,270,action,0.004613973497229662,57,0,57
271,271,element,0.0045945616222462776,79,64,15
272,272,exp,0.004586278592554257,65,64,1
273,273,toBeGreaterThan,0.004586278592554257,65,64,1
274,274,toggleButton,0.004586278592554257,65,64,1
275,275,calledWith,0.00458627859255425,65,64,1
276,276,num,0.00458627859255425,65,64,1
277,277,send,0.004532658910488471,56,0,56
278,278,"
            ",0.004506452960413791,64,64,0
279,279,"
                ",0.004506452960413791,64,64,0
280,280,$$,0.004506452960413791,64,64,0
281,281,'.gl-canvas-context',0.004506452960413791,64,64,0
282,282,'ArrowLeft',0.004506452960413791,64,64,0
283,283,'Enter',0.004506452960413791,64,64,0
284,284,'call',0.004506452960413791,64,64,0
285,285,'contain',0.004506452960413791,64,64,0
286,286,'dragmode',0.004506452960413791,64,64,0
287,287,'flux-editor',0.004506452960413791,64,64,0
288,288,'lasso',0.004506452960413791,64,64,0
289,289,'pan',0.004506452960413791,64,64,0
290,290,'select',0.004506452960413791,64,64,0
291,291,'user',0.004506452960413791,64,64,0
292,292,'visible',0.004506452960413791,64,64,0
293,293,'xaxis.range',0.004506452960413791,64,64,0
294,294,33,0.004506452960413791,64,64,0
295,295,35,0.004506452960413791,64,64,0
296,296,350,0.004506452960413791,64,64,0
297,297,37,0.004506452960413791,64,64,0
298,298,450,0.004506452960413791,64,64,0
299,299,600,0.004506452960413791,64,64,0
300,300,Inner,0.004506452960413791,64,64,0
301,301,Outer,0.004506452960413791,64,64,0
302,302,Registry,0.004506452960413791,64,64,0
303,303,_click,0.004506452960413791,64,64,0
304,304,admin,0.004506452960413791,64,64,0
305,305,applyFilters,0.004506452960413791,64,64,0
306,306,assertSelectedPoints,0.004506452960413791,64,64,0
307,307,bucket,0.004506452960413791,64,64,0
308,308,calledOnce,0.004506452960413791,64,64,0
309,309,defaults,0.004506452960413791,64,64,0
310,310,desc,0.004506452960413791,64,64,0
311,311,dimensions,0.004506452960413791,64,64,0
312,312,doRender,0.004506452960413791,64,64,0
313,313,eq,0.004506452960413791,64,64,0
314,314,eventData,0.004506452960413791,64,64,0
315,315,expectedExtraScroll,0.004506452960413791,64,64,0
316,316,failTest,0.004506452960413791,64,64,0
317,317,font,0.004506452960413791,64,64,0
318,318,formMonkey,0.004506452960413791,64,64,0
319,319,format,0.004506452960413791,64,64,0
320,320,getCssValue,0.004506452960413791,64,64,0
321,321,label,0.004506452960413791,64,64,0
322,322,mock1,0.004506452960413791,64,64,0
323,323,mount,0.004506452960413791,64,64,0
324,324,navBarPage,0.004506452960413791,64,64,0
325,325,numLines,0.004506452960413791,64,64,0
326,326,ordering,0.004506452960413791,64,64,0
327,327,orgID,0.004506452960413791,64,64,0
328,328,overlayPane,0.004506452960413791,64,64,0
329,329,precision,0.004506452960413791,64,64,0
330,330,relayoutCallback,0.004506452960413791,64,64,0
331,331,rerender,0.004506452960413791,64,64,0
332,332,scenarioName,0.004506452960413791,64,64,0
333,333,select,0.004506452960413791,64,64,0
334,334,selectedValue,0.004506452960413791,64,64,0
335,335,selectedpoints,0.004506452960413791,64,64,0
336,336,shiftKey,0.004506452960413791,64,64,0
337,337,signInPage,0.004506452960413791,64,64,0
338,338,sinon,0.004506452960413791,64,64,0
339,339,token,0.004506452960413791,64,64,0
340,340,traceType,0.004506452960413791,64,64,0
341,341,waitUntilDisplayed,0.004506452960413791,64,64,0
342,342,which,0.004506452960413791,64,64,0
343,343,x0,0.004506452960413791,64,64,0
344,344,xy,0.004506452960413791,64,64,0
345,345,y0,0.004506452960413791,64,64,0
346,346,$eval,0.004506452960413784,64,64,0
347,347,'.react-monaco-editor-container',0.004506452960413784,64,64,0
348,348,'.ring-select',0.004506452960413784,64,64,0
349,349,'.table-graph-cell__sort-asc',0.004506452960413784,64,64,0
350,350,'.table-graph-cell__sort-desc',0.004506452960413784,64,64,0
351,351,'2',0.004506452960413784,64,64,0
352,352,'3',0.004506452960413784,64,64,0
353,353,'[data-test=ring-popup]',0.004506452960413784,64,64,0
354,354,'_value-table-header',0.004506452960413784,64,64,0
355,355,'cubic-in-out',0.004506452960413784,64,64,0
356,356,'dashboard-card',0.004506452960413784,64,64,0
357,357,'data-column-index',0.004506452960413784,64,64,0
358,358,'not.exist',0.004506452960413784,64,64,0
359,359,'selectPopup',0.004506452960413784,64,64,0
360,360,'task-card',0.004506452960413784,64,64,0
361,361,190,0.004506452960413784,64,64,0
362,362,24,0.004506452960413784,64,64,0
363,363,Infinity,0.004506452960413784,64,64,0
364,364,Mutation,0.004506452960413784,64,64,0
365,365,THEME,0.004506452960413784,64,64,0
366,366,TYPE_DELAY,0.004506452960413784,64,64,0
367,367,VIEWPORT,0.004506452960413784,64,64,0
368,368,actualSpaceAboveSelectedItem,0.004506452960413784,64,64,0
369,369,assertAxAutorange,0.004506452960413784,64,64,0
370,370,attributes,0.004506452960413784,64,64,0
371,371,ceil,0.004506452960413784,64,64,0
372,372,columnIndex,0.004506452960413784,64,64,0
373,373,desktop,0.004506452960413784,64,64,0
374,374,dev,0.004506452960413784,64,64,0
375,375,driver,0.004506452960413784,64,64,0
376,376,easing,0.004506452960413784,64,64,0
377,377,eql,0.004506452960413784,64,64,0
378,378,focused,0.004506452960413784,64,64,0
379,379,force,0.004506452960413784,64,64,0
380,380,formField,0.004506452960413784,64,64,0
381,381,getAttributes,0.004506452960413784,64,64,0
382,382,goalType,0.004506452960413784,64,64,0
383,383,gridItem,0.004506452960413784,64,64,0
384,384,hero,0.004506452960413784,64,64,0
385,385,idealScrollTop,0.004506452960413784,64,64,0
386,386,idealSpaceAboveSelectedItem,0.004506452960413784,64,64,0
387,387,interaction,0.004506452960413784,64,64,0
388,388,isNaN,0.004506452960413784,64,64,0
389,389,light,0.004506452960413784,64,64,0
390,390,lineHeightEm,0.004506452960413784,64,64,0
391,391,mobile,0.004506452960413784,64,64,0
392,392,mouseMove,0.004506452960413784,64,64,0
393,393,newLabelName,0.004506452960413784,64,64,0
394,394,overlayBottom,0.004506452960413784,64,64,0
395,395,preparePageForSnapshot,0.004506452960413784,64,64,0
396,396,readPixel,0.004506452960413784,64,64,0
397,397,returned,0.004506452960413784,64,64,0
398,398,selectItemHeight,0.004506452960413784,64,64,0
399,399,selectMenuHeight,0.004506452960413784,64,64,0
400,400,selectMenuViewportPadding,0.004506452960413784,64,64,0
401,401,selectedIndex,0.004506452960413784,64,64,0
402,402,setCaptureElements,0.004506452960413784,64,64,0
403,403,setUrl,0.004506452960413784,64,64,0
404,404,simulate,0.004506452960413784,64,64,0
405,405,snapshot,0.004506452960413784,64,64,0
406,406,snapshotConfig,0.004506452960413784,64,64,0
407,407,toBeCloseTo2DArray,0.004506452960413784,64,64,0
408,408,top,0.004506452960413784,64,64,0
409,409,triggerBottom,0.004506452960413784,64,64,0
410,410,wrap,0.004506452960413784,64,64,0
411,411,x1,0.004506452960413784,64,64,0
412,412,y1,0.004506452960413784,64,64,0
413,413,jQueryMock,0.004451357537073718,55,0,55
414,414,output,0.004451357537073708,55,0,55
415,415,'show',0.004355366914598115,72,32,40
416,416,carousel,0.004288794412242379,53,0,53
417,417,documentElement,0.004209550128978773,111,96,15
418,418,response,0.004207532651848651,52,0,52
419,419,first,0.004185472189338929,67,64,3
420,420,join,0.004176179863158777,56,32,24
421,421,count,0.0041065065092769065,236,160,76
422,422,items,0.004105620777978538,66,64,2
423,423,'ArrowDown',0.0041001427020354204,65,64,1
424,424,'admin',0.0041001427020354204,65,64,1
425,425,40,0.0041001427020354204,65,64,1
426,426,Component,0.0041001427020354204,65,64,1
427,427,ok,0.0041001427020354204,65,64,1
428,428,reverse,0.0041001427020354204,65,64,1
429,429,update,0.0041001427020354204,65,64,1
430,430,instance,0.004095677174791784,55,32,23
431,431,code,0.004045048712679007,50,0,50
432,432,push,0.004039596578310751,184,128,56
433,433,mode,0.004025782258403953,65,64,1
434,434,prev,0.004025782258403953,65,64,1
435,435,initialState,0.003963826524940829,49,0,49
436,436,TypesMeta,0.003963826524940824,49,0,49
437,437,modal,0.003963826524940822,49,0,49
438,438,deep,0.003949524424773108,111,96,15
439,439,"
				",0.003920798791851312,67,64,3
440,440,'red',0.003920798791851312,67,64,3
441,441,'function',0.0038535610499435095,68,64,4
442,442,regex,0.0038535610499435026,68,64,4
443,443,'right',0.003840947380490921,66,64,2
444,444,Set,0.003840947380490921,66,64,2
445,445,waitForElementByCss,0.003811281942347081,145,64,81
446,446,btnDropdown,0.003801421690758245,47,0,47
447,447,scrollTo,0.0037736967424515603,67,64,3
448,448,carouselEl,0.003720239035369121,46,0,46
449,449,res2,0.0036390695484827323,45,0,45
450,450,start,0.0036129344179288495,49,32,17
451,451,load,0.00355791322563297,44,0,44
452,452,toHaveClass,0.00355791322563297,44,0,44
453,453,values,0.003545375836713707,83,64,19
454,454,getAttribute,0.003508423326817559,128,64,64
455,455,cheerio,0.0034767700623514284,43,0,43
456,456,modalEl,0.003476770062351426,43,0,43
457,457,'c',0.003448574978483332,53,32,21
458,458,'FOO',0.0033956400541758454,42,0,42
459,459,addEventListener,0.0033407684296540277,138,32,106
460,460,fetchViaHTTP,0.003314523196643543,41,0,41
461,461,o,0.0032913659463875682,45,32,13
462,462,href,0.003233419485295333,40,0,40
463,463,and,0.00321281047794055,119,96,23
464,464,'green',0.0032110062923803202,44,32,12
465,465,'keydown',0.0031875779816066003,70,64,6
466,466,innerHTML,0.0031875779816066003,70,64,6
467,467,toBeNull,0.003152328915674551,39,0,39
468,468,existingTags,0.0031523289156745495,39,0,39
469,469,__dirname,0.003130659615155332,43,32,11
470,470,query,0.003130659615155332,43,32,11
471,471,Parent,0.0031306596151553312,43,32,11
472,472,css,0.003050325910332775,42,32,10
473,473,button,0.0030463869224231343,48,32,16
474,474,set,0.0030444021055158277,75,64,11
475,475,observable,0.002990187183801245,37,0,37
476,476,'p',0.0029700051735342594,41,32,9
477,477,fetch,0.0029091360126441215,36,0,36
478,478,cliOutput,0.0028911560635389195,67,32,35
479,479,ref,0.0028896974003848434,40,32,8
480,480,300,0.0028896974003848426,40,32,8
481,481,_,0.0028896974003848426,40,32,8
482,482,description,0.002884406499190124,75,64,11
483,483,basePath,0.0028736843465392873,91,64,27
484,484,toBeTruthy,0.0028280979654106177,35,0,35
485,485,"
                        ",0.0028280979654106125,35,0,35
486,486,callback,0.0028094025865105805,39,32,7
487,487,'</div>',0.0028094025865105796,39,32,7
488,488,map,0.002805230055868732,45,32,13
489,489,selector,0.0027643381868111064,70,64,6
490,490,$2,0.0027470730376548845,34,0,34
491,491,model,0.0027470730376548836,34,0,34
492,492,b,0.002747073037654883,34,0,34
493,493,match,0.002745375854871517,73,64,9
494,494,'left',0.0027291207275414653,38,32,6
495,495,comp,0.0027291207275414653,38,32,6
496,496,createElement,0.0027291207275414653,38,32,6
497,497,opts,0.0027291207275414653,38,32,6
498,498,stringify,0.0027291207275414653,38,32,6
499,499,spyOn,0.0026660612249366014,33,0,33
500,500,e,0.0026651976820500347,138,96,42
501,501,'yellow',0.0026488518191102716,37,32,5
502,502,appPort,0.0026488518191102716,37,32,5
503,503,createSpy,0.0026488518191102716,37,32,5
504,504,toHaveBeenCalledTimes,0.0026488518191102716,37,32,5
505,505,events,0.0025850625228113202,32,0,32
506,506,replace,0.002568595856847714,36,32,4
507,507,'#link',0.0025685958568477138,36,32,4
508,508,'next',0.0025685958568477138,36,32,4
509,509,fontFamily,0.0025685958568477138,36,32,4
510,510,hasClass,0.0025685958568477138,36,32,4
511,511,invoke,0.002564190019813938,42,32,10
512,512,mobx,0.0025641900198139374,42,32,10
513,513,string,0.002504076926843698,31,0,31
514,514,42,0.002504076926843698,31,0,31
515,515,s,0.0025040769268436965,31,0,31
516,516,'div',0.002488352836390451,35,32,3
517,517,alt,0.002488352836390451,35,32,3
518,518,focus,0.002488352836390451,35,32,3
519,519,from,0.002488352836390451,35,32,3
520,520,keyboard,0.002488352836390451,35,32,3
521,521,links,0.002488352836390451,35,32,3
522,522,nodes,0.002488352836390451,35,32,3
523,523,trace,0.002488352836390451,35,32,3
524,524,webdriver,0.002488352836390451,35,32,3
525,525,offCanvasEl,0.002423104432596173,30,0,30
526,526,offCanvas,0.0024231044325961717,30,0,30
527,527,'.tooltip',0.0024081227533759714,34,32,2
528,528,'g',0.0024081227533759714,34,32,2
529,529,"'rgb(255, 0, 0)'",0.0024081227533759714,34,32,2
530,530,12,0.0024081227533759714,34,32,2
531,531,doc,0.0024081227533759714,34,32,2
532,532,placement,0.0024035615098660073,40,32,8
533,533,includes,0.0023966365859955864,74,64,10
534,534,1000,0.0023858365607423992,44,32,12
535,535,toContain,0.002362968078835922,103,32,71
536,536,file,0.0023421450356387336,29,0,29
537,537,ev,0.0023421450356387328,29,0,29
538,538,c,0.0023310292917162905,50,32,18
539,539,'blue',0.0023279056034488706,33,32,1
540,540,'four',0.0023279056034488706,33,32,1
541,541,'pages',0.0023279056034488706,33,32,1
542,542,10000,0.0023279056034488706,33,32,1
543,543,Array,0.0023279056034488706,33,32,1
544,544,all,0.0023279056034488706,33,32,1
545,545,close,0.0023279056034488706,33,32,1
546,546,finally,0.0023279056034488706,33,32,1
547,547,hover,0.0023279056034488706,33,32,1
548,548,icon,0.0023279056034488706,33,32,1
549,549,isRequired,0.0023279056034488706,33,32,1
550,550,pos,0.0023279056034488706,33,32,1
551,551,position,0.0023279056034488706,33,32,1
552,552,run2,0.0023279056034488706,33,32,1
553,553,scrollIntoView,0.0023279056034488706,33,32,1
554,554,scrollPositionMemories,0.0023279056034488706,33,32,1
555,555,scrollX,0.0023279056034488706,33,32,1
556,556,scrollY,0.0023279056034488706,33,32,1
557,557,self,0.0023279056034488706,33,32,1
558,558,settings,0.0023279056034488706,33,32,1
559,559,testCase,0.0023279056034488706,33,32,1
560,560,toBeCloseTo,0.0023279056034488706,33,32,1
561,561,try,0.0023279056034488706,33,32,1
562,562,'one',0.002305489883517411,43,32,11
563,563,for,0.0022680903502869804,73,64,9
564,564,obj,0.002261198731537316,28,0,28
565,565,paths,0.002261198731537316,28,0,28
566,566,A,0.0022611987315373154,28,0,28
567,567,"
		",0.0022477013822477486,32,32,0
568,568,"
  ",0.0022477013822477486,32,32,0
569,569,"
    ",0.0022477013822477486,32,32,0
570,570,"
      ",0.0022477013822477486,32,32,0
571,571,"
        ",0.0022477013822477486,32,32,0
572,572,"""ArrowLeft""",0.0022477013822477486,32,32,0
573,573,"""div""",0.0022477013822477486,32,32,0
574,574,"""es""",0.0022477013822477486,32,32,0
575,575,"""steplist""",0.0022477013822477486,32,32,0
576,576,"""stuff""",0.0022477013822477486,32,32,0
577,577,"""text""",0.0022477013822477486,32,32,0
578,578,$CM,0.0022477013822477486,32,32,0
579,579,$cm,0.0022477013822477486,32,32,0
580,580,$el,0.0022477013822477486,32,32,0
581,581,$iframe,0.0022477013822477486,32,32,0
582,582,$span,0.0022477013822477486,32,32,0
583,583,$table,0.0022477013822477486,32,32,0
584,584,'#FF0000',0.0022477013822477486,32,32,0
585,585,'#dynamic-tt-test',0.0022477013822477486,32,32,0
586,586,'#something-else-link',0.0022477013822477486,32,32,0
587,587,'#something-else-page',0.0022477013822477486,32,32,0
588,588,'(call #',0.0022477013822477486,32,32,0
589,589,') ',0.0022477013822477486,32,32,0
590,590,'../',0.0022477013822477486,32,32,0
591,591,'.CodeMirror',0.0022477013822477486,32,32,0
592,592,'.cf-button',0.0022477013822477486,32,32,0
593,593,'.cf-button--label',0.0022477013822477486,32,32,0
594,594,'.cf-overlay--dismiss',0.0022477013822477486,32,32,0
595,595,'.mat-select-panel',0.0022477013822477486,32,32,0
596,596,'.patient-input .tt-input',0.0022477013822477486,32,32,0
597,597,'.test-patient-summary',0.0022477013822477486,32,32,0
598,598,'/api/v2/orgs/',0.0022477013822477486,32,32,0
599,599,'/api/v2/orgs/e483753c9bdb47bf',0.0022477013822477486,32,32,0
600,600,'/hmr/about',0.0022477013822477486,32,32,0
601,601,'/imaging/edit/new',0.0022477013822477486,32,32,0
602,602,'/story/UI-DesktopLayout-noNav',0.0022477013822477486,32,32,0
603,603,'0.387',0.0022477013822477486,32,32,0
604,604,'0001-01-01T00:00:00Z',0.0022477013822477486,32,32,0
605,605,'02/02/2017',0.0022477013822477486,32,32,0
606,606,'150px',0.0022477013822477486,32,32,0
607,607,'2017-01-01',0.0022477013822477486,32,32,0
608,608,'2017-02-01',0.0022477013822477486,32,32,0
609,609,'2017-02-02',0.0022477013822477486,32,32,0
610,610,'2017-03-01',0.0022477013822477486,32,32,0
611,611,'2018-01-01',0.0022477013822477486,32,32,0
612,612,'2018-06-01',0.0022477013822477486,32,32,0
613,613,'2019-06-01',0.0022477013822477486,32,32,0
614,614,'2019-10-15T11:10:27.970567-07:00',0.0022477013822477486,32,32,0
615,615,'2019-11-05T08:58:16.873502-08:00',0.0022477013822477486,32,32,0
616,616,'2019/03/10',0.0022477013822477486,32,32,0
617,617,'2020-01-01',0.0022477013822477486,32,32,0
618,618,'@flux',0.0022477013822477486,32,32,0
619,619,'@mocks/box_grouped_horz.json',0.0022477013822477486,32,32,0
620,620,'@mocks/histogram_colorscale.json',0.0022477013822477486,32,32,0
621,621,'@resourceIDs',0.0022477013822477486,32,32,0
622,622,'A better name!',0.0022477013822477486,32,32,0
623,623,'All Messages',0.0022477013822477486,32,32,0
624,624,'Arial',0.0022477013822477486,32,32,0
625,625,'Config Description',0.0022477013822477486,32,32,0
626,626,'Continue',0.0022477013822477486,32,32,0
627,627,'DropdownContainer',0.0022477013822477486,32,32,0
628,628,'Expect slide toggle value not changed',0.0022477013822477486,32,32,0
629,629,'Expected trigger to align with the first option.',0.0022477013822477486,32,32,0
630,630,'GBR',0.0022477013822477486,32,32,0
631,631,'IRL',0.0022477013822477486,32,32,0
632,632,'InfluxData',0.0022477013822477486,32,32,0
633,633,'New Config',0.0022477013822477486,32,32,0
634,634,'Powered by',0.0022477013822477486,32,32,0
635,635,'Roboto',0.0022477013822477486,32,32,0
636,636,'S',0.0022477013822477486,32,32,0
637,637,'TTT',0.0022477013822477486,32,32,0
638,638,'This is the about page.',0.0022477013822477486,32,32,0
639,639,'UI-DesktopLayout-noNav',0.0022477013822477486,32,32,0
640,640,'Update timings 1',0.0022477013822477486,32,32,0
641,641,'Welcome to InfluxDB 2.0',0.0022477013822477486,32,32,0
642,642,'XXX',0.0022477013822477486,32,32,0
643,643,'YYY',0.0022477013822477486,32,32,0
644,644,"'[placeholder=""Name this Cell""]'",0.0022477013822477486,32,32,0
645,645,'_monitoring',0.0022477013822477486,32,32,0
646,646,'_storeDirectGUIEdit',0.0022477013822477486,32,32,0
647,647,'_tasks',0.0022477013822477486,32,32,0
648,648,'about.js',0.0022477013822477486,32,32,0
649,649,'alpha',0.0022477013822477486,32,32,0
650,650,'attr',0.0022477013822477486,32,32,0
651,651,'backgroundColor',0.0022477013822477486,32,32,0
652,652,'be.disabled',0.0022477013822477486,32,32,0
653,653,'be.true',0.0022477013822477486,32,32,0
654,654,'buck2',0.0022477013822477486,32,32,0
655,655,'bucket-card',0.0022477013822477486,32,32,0
656,656,'bucket-name',0.0022477013822477486,32,32,0
657,657,'bucket-sorter',0.0022477013822477486,32,32,0
658,658,'bucket1',0.0022477013822477486,32,32,0
659,659,'button=End Goal',0.0022477013822477486,32,32,0
660,660,'button=Start Goal',0.0022477013822477486,32,32,0
661,661,'category ascending',0.0022477013822477486,32,32,0
662,662,'center',0.0022477013822477486,32,32,0
663,663,'checkmark',0.0022477013822477486,32,32,0
664,664,'closest',0.0022477013822477486,32,32,0
665,665,'collector-card--name',0.0022477013822477486,32,32,0
666,666,'componentDidMount',0.0022477013822477486,32,32,0
667,667,'componentWillUnmount',0.0022477013822477486,32,32,0
668,668,'credits',0.0022477013822477486,32,32,0
669,669,'current',0.0022477013822477486,32,32,0
670,670,'curveNumber',0.0022477013822477486,32,32,0
671,671,'day 1',0.0022477013822477486,32,32,0
672,672,'day 2',0.0022477013822477486,32,32,0
673,673,'day',0.0022477013822477486,32,32,0
674,674,'days',0.0022477013822477486,32,32,0
675,675,'delete-data-predicate',0.0022477013822477486,32,32,0
676,676,'disco inferno',0.0022477013822477486,32,32,0
677,677,'div.cf-label',0.0022477013822477486,32,32,0
678,678,'div.cf-resource-card--contents',0.0022477013822477486,32,32,0
679,679,'div.cf-resource-card--row',0.0022477013822477486,32,32,0
680,680,'dom',0.0022477013822477486,32,32,0
681,681,'down',0.0022477013822477486,32,32,0
682,682,'drawOne',0.0022477013822477486,32,32,0
683,683,'dropdown--button',0.0022477013822477486,32,32,0
684,684,'e483753c9bdb47bf',0.0022477013822477486,32,32,0
685,685,'emitted plotly_unhover',0.0022477013822477486,32,32,0
686,686,'empty-state',0.0022477013822477486,32,32,0
687,687,'error-in-gip.js',0.0022477013822477486,32,32,0
688,688,'event+select',0.0022477013822477486,32,32,0
689,689,'expire',0.0022477013822477486,32,32,0
690,690,'export default',0.0022477013822477486,32,32,0
691,691,'flux',0.0022477013822477486,32,32,0
692,692,'flux-function from',0.0022477013822477486,32,32,0
693,693,'flux-function range',0.0022477013822477486,32,32,0
694,694,'for ',0.0022477013822477486,32,32,0
695,695,'freeform',0.0022477013822477486,32,32,0
696,696,'functions-toolbar-tab',0.0022477013822477486,32,32,0
697,697,'geo',0.0022477013822477486,32,32,0
698,698,'giraffe-layer-line',0.0022477013822477486,32,32,0
699,699,'have.class',0.0022477013822477486,32,32,0
700,700,'heatmapgl',0.0022477013822477486,32,32,0
701,701,'height',0.0022477013822477486,32,32,0
702,702,'hide',0.0022477013822477486,32,32,0
703,703,'hmr',0.0022477013822477486,32,32,0
704,704,'init-step--head-main',0.0022477013822477486,32,32,0
705,705,'inner scroll',0.0022477013822477486,32,32,0
706,706,'input',0.0022477013822477486,32,32,0
707,707,'items',0.0022477013822477486,32,32,0
708,708,'keyboard event spy',0.0022477013822477486,32,32,0
709,709,'label-card',0.0022477013822477486,32,32,0
710,710,'lat',0.0022477013822477486,32,32,0
711,711,'layout first',0.0022477013822477486,32,32,0
712,712,'lon',0.0022477013822477486,32,32,0
713,713,'mapbox',0.0022477013822477486,32,32,0
714,714,'markers',0.0022477013822477486,32,32,0
715,715,'markers+lines',0.0022477013822477486,32,32,0
716,716,'months',0.0022477013822477486,32,32,0
717,717,'mouseup',0.0022477013822477486,32,32,0
718,718,'nav-step--complete',0.0022477013822477486,32,32,0
719,719,'nav-step--setup',0.0022477013822477486,32,32,0
720,720,'nav-step--welcome',0.0022477013822477486,32,32,0
721,721,'new york',0.0022477013822477486,32,32,0
722,722,'node ',0.0022477013822477486,32,32,0
723,723,'not.be.disabled',0.0022477013822477486,32,32,0
724,724,'oauth2',0.0022477013822477486,32,32,0
725,725,'onboarding-get-started',0.0022477013822477486,32,32,0
726,726,'overlay',0.0022477013822477486,32,32,0
727,727,'overlay--header',0.0022477013822477486,32,32,0
728,728,'overlayOne keyboard event spy',0.0022477013822477486,32,32,0
729,729,'raw-data--toggle',0.0022477013822477486,32,32,0
730,730,'relayout',0.0022477013822477486,32,32,0
731,731,'render',0.0022477013822477486,32,32,0
732,732,'resource-card',0.0022477013822477486,32,32,0
733,733,'retention-sorter',0.0022477013822477486,32,32,0
734,734,'return {}',0.0022477013822477486,32,32,0
735,735,"'rgb(0, 0, 255)'",0.0022477013822477486,32,32,0
736,736,"'rgb(255, 127, 14)'",0.0022477013822477486,32,32,0
737,737,"'rgb(255, 255, 0)'",0.0022477013822477486,32,32,0
738,738,"'rgb(255, 255, 255)'",0.0022477013822477486,32,32,0
739,739,"'rgb(44, 160, 44)'",0.0022477013822477486,32,32,0
740,740,"'rgb(68, 68, 68)'",0.0022477013822477486,32,32,0
741,741,'sankey-node',0.0022477013822477486,32,32,0
742,742,'save-cell--button',0.0022477013822477486,32,32,0
743,743,'scattergeo',0.0022477013822477486,32,32,0
744,744,'search-widget',0.0022477013822477486,32,32,0
745,745,'selector-list v',0.0022477013822477486,32,32,0
746,746,'setup-instructions',0.0022477013822477486,32,32,0
747,747,'shot',0.0022477013822477486,32,32,0
748,748,'story',0.0022477013822477486,32,32,0
749,749,'system',0.0022477013822477486,32,32,0
750,750,'task-card--slide-toggle',0.0022477013822477486,32,32,0
751,751,'tasks',0.0022477013822477486,32,32,0
752,752,'three',0.0022477013822477486,32,32,0
753,753,'throw error',0.0022477013822477486,32,32,0
754,754,'time-machine--bottom',0.0022477013822477486,32,32,0
755,755,'timezone-picker',0.0022477013822477486,32,32,0
756,756,'touchstart',0.0022477013822477486,32,32,0
757,757,'traces first',0.0022477013822477486,32,32,0
758,758,'up',0.0022477013822477486,32,32,0
759,759,'view-type--dropdown',0.0022477013822477486,32,32,0
760,760,'weeks',0.0022477013822477486,32,32,0
761,761,'wheel',0.0022477013822477486,32,32,0
762,762,'x coords',0.0022477013822477486,32,32,0
763,763,'xaxis.autorange',0.0022477013822477486,32,32,0
764,764,'y coords',0.0022477013822477486,32,32,0
765,765,'yaxis.range',0.0022477013822477486,32,32,0
766,766,'years',0.0022477013822477486,32,32,0
767,767,'zebra',0.0022477013822477486,32,32,0
768,768,'zoom',0.0022477013822477486,32,32,0
769,769,/Hello/,0.0022477013822477486,32,32,0
770,770,/This is the about page/,0.0022477013822477486,32,32,0
771,771,/Unterminated JSX contents/,0.0022477013822477486,32,32,0
772,772,/an-expected-error-in-gip/,0.0022477013822477486,32,32,0
773,773,0.02,0.0022477013822477486,32,32,0
774,774,0.045,0.0022477013822477486,32,32,0
775,775,0.12852664576802508,0.0022477013822477486,32,32,0
776,776,0.1875,0.0022477013822477486,32,32,0
777,777,0.2,0.0022477013822477486,32,32,0
778,778,0.25,0.0022477013822477486,32,32,0
779,779,0.27,0.0022477013822477486,32,32,0
780,780,0.3,0.0022477013822477486,32,32,0
781,781,0.336,0.0022477013822477486,32,32,0
782,782,0.356,0.0022477013822477486,32,32,0
783,783,0.368,0.0022477013822477486,32,32,0
784,784,0.371,0.0022477013822477486,32,32,0
785,785,0.387,0.0022477013822477486,32,32,0
786,786,0.473,0.0022477013822477486,32,32,0
787,787,0.485,0.0022477013822477486,32,32,0
788,788,0.53,0.0022477013822477486,32,32,0
789,789,0.591,0.0022477013822477486,32,32,0
790,790,0.6,0.0022477013822477486,32,32,0
791,791,0.69,0.0022477013822477486,32,32,0
792,792,0.7,0.0022477013822477486,32,32,0
793,793,0.71,0.0022477013822477486,32,32,0
794,794,0.75,0.0022477013822477486,32,32,0
795,795,0.8,0.0022477013822477486,32,32,0
796,796,0.9,0.0022477013822477486,32,32,0
797,797,1.02,0.0022477013822477486,32,32,0
798,798,1.66,0.0022477013822477486,32,32,0
799,799,1.8,0.0022477013822477486,32,32,0
800,800,105,0.0022477013822477486,32,32,0
801,801,108,0.0022477013822477486,32,32,0
802,802,11,0.0022477013822477486,32,32,0
803,803,11.1,0.0022477013822477486,32,32,0
804,804,1100,0.0022477013822477486,32,32,0
805,805,120,0.0022477013822477486,32,32,0
806,806,1200,0.0022477013822477486,32,32,0
807,807,13.28,0.0022477013822477486,32,32,0
808,808,136,0.0022477013822477486,32,32,0
809,809,14.33,0.0022477013822477486,32,32,0
810,810,141,0.0022477013822477486,32,32,0
811,811,15.772,0.0022477013822477486,32,32,0
812,812,18,0.0022477013822477486,32,32,0
813,813,180,0.0022477013822477486,32,32,0
814,814,19.11,0.0022477013822477486,32,32,0
815,815,2.128526645768025,0.0022477013822477486,32,32,0
816,816,2.17,0.0022477013822477486,32,32,0
817,817,2.2,0.0022477013822477486,32,32,0
818,818,2.75,0.0022477013822477486,32,32,0
819,819,20.73248407643312,0.0022477013822477486,32,32,0
820,820,21,0.0022477013822477486,32,32,0
821,821,216,0.0022477013822477486,32,32,0
822,822,220,0.0022477013822477486,32,32,0
823,823,230,0.0022477013822477486,32,32,0
824,824,235,0.0022477013822477486,32,32,0
825,825,240,0.0022477013822477486,32,32,0
826,826,25.71,0.0022477013822477486,32,32,0
827,827,25.97,0.0022477013822477486,32,32,0
828,828,250,0.0022477013822477486,32,32,0
829,829,26.507354205352502,0.0022477013822477486,32,32,0
830,830,260,0.0022477013822477486,32,32,0
831,831,28.13,0.0022477013822477486,32,32,0
832,832,280,0.0022477013822477486,32,32,0
833,833,3.2,0.0022477013822477486,32,32,0
834,834,3.59,0.0022477013822477486,32,32,0
835,835,321,0.0022477013822477486,32,32,0
836,836,327,0.0022477013822477486,32,32,0
837,837,330,0.0022477013822477486,32,32,0
838,838,34,0.0022477013822477486,32,32,0
839,839,342,0.0022477013822477486,32,32,0
840,840,345,0.0022477013822477486,32,32,0
841,841,358,0.0022477013822477486,32,32,0
842,842,36,0.0022477013822477486,32,32,0
843,843,370,0.0022477013822477486,32,32,0
844,844,38,0.0022477013822477486,32,32,0
845,845,380,0.0022477013822477486,32,32,0
846,846,39,0.0022477013822477486,32,32,0
847,847,395,0.0022477013822477486,32,32,0
848,848,4.87,0.0022477013822477486,32,32,0
849,849,4.9,0.0022477013822477486,32,32,0
850,850,43,0.0022477013822477486,32,32,0
851,851,435,0.0022477013822477486,32,32,0
852,852,445,0.0022477013822477486,32,32,0
853,853,45,0.0022477013822477486,32,32,0
854,854,49,0.0022477013822477486,32,32,0
855,855,5.1,0.0022477013822477486,32,32,0
856,856,5.2,0.0022477013822477486,32,32,0
857,857,5.24,0.0022477013822477486,32,32,0
858,858,5.3,0.0022477013822477486,32,32,0
859,859,5.4,0.0022477013822477486,32,32,0
860,860,5.5,0.0022477013822477486,32,32,0
861,861,5.6,0.0022477013822477486,32,32,0
862,862,5.63,0.0022477013822477486,32,32,0
863,863,5.74,0.0022477013822477486,32,32,0
864,864,51,0.0022477013822477486,32,32,0
865,865,52,0.0022477013822477486,32,32,0
866,866,53,0.0022477013822477486,32,32,0
867,867,53.72,0.0022477013822477486,32,32,0
868,868,54,0.0022477013822477486,32,32,0
869,869,540,0.0022477013822477486,32,32,0
870,870,55,0.0022477013822477486,32,32,0
871,871,56,0.0022477013822477486,32,32,0
872,872,56.25,0.0022477013822477486,32,32,0
873,873,61.88,0.0022477013822477486,32,32,0
874,874,610,0.0022477013822477486,32,32,0
875,875,63.06,0.0022477013822477486,32,32,0
876,876,634,0.0022477013822477486,32,32,0
877,877,650,0.0022477013822477486,32,32,0
878,878,670,0.0022477013822477486,32,32,0
879,879,695,0.0022477013822477486,32,32,0
880,880,7.31,0.0022477013822477486,32,32,0
881,881,80,0.0022477013822477486,32,32,0
882,882,86.4125147625692,0.0022477013822477486,32,32,0
883,883,9.26751592356688,0.0022477013822477486,32,32,0
884,884,Axes,0.0022477013822477486,32,32,0
885,885,BOXEVENTS,0.0022477013822477486,32,32,0
886,886,BUTTONS,0.0022477013822477486,32,32,0
887,887,Bar,0.0022477013822477486,32,32,0
888,888,By,0.0022477013822477486,32,32,0
889,889,COLUMN_COUNT,0.0022477013822477486,32,32,0
890,890,ChatAPI,0.0022477013822477486,32,32,0
891,891,CodeMirror,0.0022477013822477486,32,32,0
892,892,Col,0.0022477013822477486,32,32,0
893,893,ComponentPortal,0.0022477013822477486,32,32,0
894,894,Desktop,0.0022477013822477486,32,32,0
895,895,Doc,0.0022477013822477486,32,32,0
896,896,ERROR_COUNT,0.0022477013822477486,32,32,0
897,897,ESCAPE,0.0022477013822477486,32,32,0
898,898,FORMATS,0.0022477013822477486,32,32,0
899,899,FROM,0.0022477013822477486,32,32,0
900,900,File,0.0022477013822477486,32,32,0
901,901,Fragment,0.0022477013822477486,32,32,0
902,902,HTMLElement,0.0022477013822477486,32,32,0
903,903,ITEM_MOUNT_COUNT,0.0022477013822477486,32,32,0
904,904,LASSOEVENTS,0.0022477013822477486,32,32,0
905,905,LASSO_PATH,0.0022477013822477486,32,32,0
906,906,LONG_TIMEOUT_INTERVAL,0.0022477013822477486,32,32,0
907,907,MATH_ABS,0.0022477013822477486,32,32,0
908,908,MockNav,0.0022477013822477486,32,32,0
909,909,MockPanel,0.0022477013822477486,32,32,0
910,910,MockPreview,0.0022477013822477486,32,32,0
911,911,MockedProvider,0.0022477013822477486,32,32,0
912,912,Msg,0.0022477013822477486,32,32,0
913,913,NEXT_FETCH,0.0022477013822477486,32,32,0
914,914,NOEVENTS,0.0022477013822477486,32,32,0
915,915,Nav,0.0022477013822477486,32,32,0
916,916,NavBarPage,0.0022477013822477486,32,32,0
917,917,Notifications,0.0022477013822477486,32,32,0
918,918,OverlayContainer,0.0022477013822477486,32,32,0
919,919,OverlayKeyboardDispatcher,0.0022477013822477486,32,32,0
920,920,PIN_INSERTION_TIME,0.0022477013822477486,32,32,0
921,921,Panel,0.0022477013822477486,32,32,0
922,922,PlaceholderBlock,0.0022477013822477486,32,32,0
923,923,PlaceholderClock,0.0022477013822477486,32,32,0
924,924,Preview,0.0022477013822477486,32,32,0
925,925,RANGE,0.0022477013822477486,32,32,0
926,926,ResourceIDs,0.0022477013822477486,32,32,0
927,927,STRINGS_TITLE,0.0022477013822477486,32,32,0
928,928,Sidebar,0.0022477013822477486,32,32,0
929,929,SlideToggleBasic,0.0022477013822477486,32,32,0
930,930,SpeedDial,0.0022477013822477486,32,32,0
931,931,SpeedDialAction,0.0022477013822477486,32,32,0
932,932,String,0.0022477013822477486,32,32,0
933,933,TEST_FETCH_COUNTS,0.0022477013822477486,32,32,0
934,934,TOLERANCE_OVERRIDE_BECAUSE_OF_EDGE,0.0022477013822477486,32,32,0
935,935,TestBed,0.0022477013822477486,32,32,0
936,936,VIRTUALIZED_TOP,0.0022477013822477486,32,32,0
937,937,WebGLRenderingContext,0.0022477013822477486,32,32,0
938,938,_assertBase,0.0022477013822477486,32,32,0
939,939,_assertDrag,0.0022477013822477486,32,32,0
940,940,_assertRange,0.0022477013822477486,32,32,0
941,941,_assertSelectedPoints,0.0022477013822477486,32,32,0
942,942,_attachedOverlays,0.0022477013822477486,32,32,0
943,943,_calc,0.0022477013822477486,32,32,0
944,944,_clickPt,0.0022477013822477486,32,32,0
945,945,_constructor,0.0022477013822477486,32,32,0
946,946,_drag,0.0022477013822477486,32,32,0
947,947,_immediateClickPt,0.0022477013822477486,32,32,0
948,948,_plots,0.0022477013822477486,32,32,0
949,949,_preGUI,0.0022477013822477486,32,32,0
950,950,_reset,0.0022477013822477486,32,32,0
951,951,_run,0.0022477013822477486,32,32,0
952,952,_scene,0.0022477013822477486,32,32,0
953,953,_unhover,0.0022477013822477486,32,32,0
954,954,_xcategories,0.0022477013822477486,32,32,0
955,955,_ycategories,0.0022477013822477486,32,32,0
956,956,"`[data-column-index=""${",0.0022477013822477486,32,32,0
957,957,"`[data-column-index=\""${",0.0022477013822477486,32,32,0
958,958,`orgs/${,0.0022477013822477486,32,32,0
959,959,`post-${,0.0022477013822477486,32,32,0
960,960,`selector-list m`,0.0022477013822477486,32,32,0
961,961,`selector-list tv1`,0.0022477013822477486,32,32,0
962,962,aboutPage,0.0022477013822477486,32,32,0
963,963,accessibilityReport,0.0022477013822477486,32,32,0
964,964,act,0.0022477013822477486,32,32,0
965,965,activeColor,0.0022477013822477486,32,32,0
966,966,addDecorator,0.0022477013822477486,32,32,0
967,967,addInvisible,0.0022477013822477486,32,32,0
968,968,afterDragFn,0.0022477013822477486,32,32,0
969,969,afterErrors,0.0022477013822477486,32,32,0
970,970,afterGridItems,0.0022477013822477486,32,32,0
971,971,afterLoadItemCount,0.0022477013822477486,32,32,0
972,972,allowStateChanges,0.0022477013822477486,32,32,0
973,973,amt,0.0022477013822477486,32,32,0
974,974,andThen,0.0022477013822477486,32,32,0
975,975,animationMessages,0.0022477013822477486,32,32,0
976,976,ann,0.0022477013822477486,32,32,0
977,977,anotherContainer,0.0022477013822477486,32,32,0
978,978,appendChild,0.0022477013822477486,32,32,0
979,979,appendTo,0.0022477013822477486,32,32,0
980,980,arrangement,0.0022477013822477486,32,32,0
981,981,arrowKey,0.0022477013822477486,32,32,0
982,982,asc,0.0022477013822477486,32,32,0
983,983,assertAnnotation,0.0022477013822477486,32,32,0
984,984,assertEvent,0.0022477013822477486,32,32,0
985,985,assertEventCounts,0.0022477013822477486,32,32,0
986,986,assertEventData,0.0022477013822477486,32,32,0
987,987,assertFocus,0.0022477013822477486,32,32,0
988,988,assertLassoPoints,0.0022477013822477486,32,32,0
989,989,assertPoints,0.0022477013822477486,32,32,0
990,990,assertRanges,0.0022477013822477486,32,32,0
991,991,assertRouterWrapperFocus,0.0022477013822477486,32,32,0
992,992,assertSelectionCleared,0.0022477013822477486,32,32,0
993,993,asserters,0.0022477013822477486,32,32,0
994,994,attach,0.0022477013822477486,32,32,0
995,995,attachTo,0.0022477013822477486,32,32,0
996,996,authenticationType,0.0022477013822477486,32,32,0
997,997,autoFocus,0.0022477013822477486,32,32,0
998,998,background_color,0.0022477013822477486,32,32,0
999,999,backup,0.0022477013822477486,32,32,0
1000,1000,backup3,0.0022477013822477486,32,32,0
1001,1001,bar_bg_color,0.0022477013822477486,32,32,0
1002,1002,bar_color,0.0022477013822477486,32,32,0
1003,1003,bar_text_color,0.0022477013822477486,32,32,0
1004,1004,bbox,0.0022477013822477486,32,32,0
1005,1005,beforeEach,0.0022477013822477486,32,32,0
1006,1006,bgColor,0.0022477013822477486,32,32,0
1007,1007,bgcolor,0.0022477013822477486,32,32,0
1008,1008,bodyHtml,0.0022477013822477486,32,32,0
1009,1009,bordercolor,0.0022477013822477486,32,32,0
1010,1010,bottomMostPositionForPerfectCentering,0.0022477013822477486,32,32,0
1011,1011,bringFocusSpy,0.0022477013822477486,32,32,0
1012,1012,buckets,0.0022477013822477486,32,32,0
1013,1013,bucketz,0.0022477013822477486,32,32,0
1014,1014,buttonPan,0.0022477013822477486,32,32,0
1015,1015,buttonRef,0.0022477013822477486,32,32,0
1016,1016,by,0.0022477013822477486,32,32,0
1017,1017,callNumber,0.0022477013822477486,32,32,0
1018,1018,canceler,0.0022477013822477486,32,32,0
1019,1019,canvas,0.0022477013822477486,32,32,0
1020,1020,categoryorder,0.0022477013822477486,32,32,0
1021,1021,cell,0.0022477013822477486,32,32,0
1022,1022,cellID,0.0022477013822477486,32,32,0
1023,1023,cellResp,0.0022477013822477486,32,32,0
1024,1024,changeLocale,0.0022477013822477486,32,32,0
1025,1025,checkDashCount,0.0022477013822477486,32,32,0
1026,1026,checkTitle,0.0022477013822477486,32,32,0
1027,1027,checked,0.0022477013822477486,32,32,0
1028,1028,checker,0.0022477013822477486,32,32,0
1029,1029,childAt,0.0022477013822477486,32,32,0
1030,1030,clearInterval,0.0022477013822477486,32,32,0
1031,1031,clickBox,0.0022477013822477486,32,32,0
1032,1032,clickButton,0.0022477013822477486,32,32,0
1033,1033,clickFirstBin,0.0022477013822477486,32,32,0
1034,1034,clickFirstBinImmediately,0.0022477013822477486,32,32,0
1035,1035,clickOnAdminMenuItem,0.0022477013822477486,32,32,0
1036,1036,clickOpts,0.0022477013822477486,32,32,0
1037,1037,clickPt,0.0022477013822477486,32,32,0
1038,1038,clickPtImmediately,0.0022477013822477486,32,32,0
1039,1039,clickmode,0.0022477013822477486,32,32,0
1040,1040,clientHeight,0.0022477013822477486,32,32,0
1041,1041,closedHeight,0.0022477013822477486,32,32,0
1042,1042,cm,0.0022477013822477486,32,32,0
1043,1043,coloraxis,0.0022477013822477486,32,32,0
1044,1044,combination,0.0022477013822477486,32,32,0
1045,1045,combinationUntilNot,0.0022477013822477486,32,32,0
1046,1046,completeSpy,0.0022477013822477486,32,32,0
1047,1047,componentDidMount,0.0022477013822477486,32,32,0
1048,1048,componentWillMount,0.0022477013822477486,32,32,0
1049,1049,concat,0.0022477013822477486,32,32,0
1050,1050,configDescription,0.0022477013822477486,32,32,0
1051,1051,configOptions,0.0022477013822477486,32,32,0
1052,1052,configureContainer,0.0022477013822477486,32,32,0
1053,1053,constraintrange,0.0022477013822477486,32,32,0
1054,1054,containerHeight,0.0022477013822477486,32,32,0
1055,1055,contexts,0.0022477013822477486,32,32,0
1056,1056,contributors,0.0022477013822477486,32,32,0
1057,1057,coords,0.0022477013822477486,32,32,0
1058,1058,create,0.0022477013822477486,32,32,0
1059,1059,createAndAddLabel,0.0022477013822477486,32,32,0
1060,1060,createTask,0.0022477013822477486,32,32,0
1061,1061,createTelegraf,0.0022477013822477486,32,32,0
1062,1062,createTodo,0.0022477013822477486,32,32,0
1063,1063,createdAt,0.0022477013822477486,32,32,0
1064,1064,curveNumber,0.0022477013822477486,32,32,0
1065,1065,customConfigOptions,0.0022477013822477486,32,32,0
1066,1066,customLayoutOptions,0.0022477013822477486,32,32,0
1067,1067,databaseType,0.0022477013822477486,32,32,0
1068,1068,datalist,0.0022477013822477486,32,32,0
1069,1069,date,0.0022477013822477486,32,32,0
1070,1070,dayOfMonth,0.0022477013822477486,32,32,0
1071,1071,daylight,0.0022477013822477486,32,32,0
1072,1072,dbID,0.0022477013822477486,32,32,0
1073,1073,dblClickPos,0.0022477013822477486,32,32,0
1074,1074,deactivatedButton,0.0022477013822477486,32,32,0
1075,1075,debugElement,0.0022477013822477486,32,32,0
1076,1076,defaultLayoutOpts,0.0022477013822477486,32,32,0
1077,1077,deselectPromise,0.0022477013822477486,32,32,0
1078,1078,dialDirection,0.0022477013822477486,32,32,0
1079,1079,dispatchKeyboardEvent,0.0022477013822477486,32,32,0
1080,1080,dp,0.0022477013822477486,32,32,0
1081,1081,dragPath,0.0022477013822477486,32,32,0
1082,1082,dragTriggered,0.0022477013822477486,32,32,0
1083,1083,editTitle,0.0022477013822477486,32,32,0
1084,1084,elementFinder,0.0022477013822477486,32,32,0
1085,1085,elementFromPoint,0.0022477013822477486,32,32,0
1086,1086,emptyChoroplethTrace,0.0022477013822477486,32,32,0
1087,1087,end,0.0022477013822477486,32,32,0
1088,1088,enforceFocus,0.0022477013822477486,32,32,0
1089,1089,erroredPage,0.0022477013822477486,32,32,0
1090,1090,eventCnts,0.0022477013822477486,32,32,0
1091,1091,eventCounts,0.0022477013822477486,32,32,0
1092,1092,everySeconds,0.0022477013822477486,32,32,0
1093,1093,example,0.0022477013822477486,32,32,0
1094,1094,expectedFocusedAction,0.0022477013822477486,32,32,0
1095,1095,expectedPts,0.0022477013822477486,32,32,0
1096,1096,expectedPtsPerTrace,0.0022477013822477486,32,32,0
1097,1097,expectedResult,0.0022477013822477486,32,32,0
1098,1098,explorer,0.0022477013822477486,32,32,0
1099,1099,exprCount,0.0022477013822477486,32,32,0
1100,1100,extra,0.0022477013822477486,32,32,0
1101,1101,extractMessages,0.0022477013822477486,32,32,0
1102,1102,extras,0.0022477013822477486,32,32,0
1103,1103,fill,0.0022477013822477486,32,32,0
1104,1104,fillIn,0.0022477013822477486,32,32,0
1105,1105,filterStagger,0.0022477013822477486,32,32,0
1106,1106,findWithAssert,0.0022477013822477486,32,32,0
1107,1107,firstArg,0.0022477013822477486,32,32,0
1108,1108,firstBinPts,0.0022477013822477486,32,32,0
1109,1109,firstBucket,0.0022477013822477486,32,32,0
1110,1110,firstCanvas,0.0022477013822477486,32,32,0
1111,1111,firstFocusedAction,0.0022477013822477486,32,32,0
1112,1112,firstGlContext,0.0022477013822477486,32,32,0
1113,1113,firstGlplotObject,0.0022477013822477486,32,32,0
1114,1114,firstKey,0.0022477013822477486,32,32,0
1115,1115,firstTelegraf,0.0022477013822477486,32,32,0
1116,1116,flush,0.0022477013822477486,32,32,0
1117,1117,fluxEqual,0.0022477013822477486,32,32,0
1118,1118,foci,0.0022477013822477486,32,32,0
1119,1119,focusBtnAndAssert,0.0022477013822477486,32,32,0
1120,1120,fontColor,0.0022477013822477486,32,32,0
1121,1121,formFieldBottom,0.0022477013822477486,32,32,0
1122,1122,formFieldBottomSpace,0.0022477013822477486,32,32,0
1123,1123,formFieldTop,0.0022477013822477486,32,32,0
1124,1124,formFieldTopSpace,0.0022477013822477486,32,32,0
1125,1125,formInput,0.0022477013822477486,32,32,0
1126,1126,formatDate,0.0022477013822477486,32,32,0
1127,1127,friend,0.0022477013822477486,32,32,0
1128,1128,fullDataItem,0.0022477013822477486,32,32,0
1129,1129,fullLayout,0.0022477013822477486,32,32,0
1130,1130,func,0.0022477013822477486,32,32,0
1131,1131,g,0.0022477013822477486,32,32,0
1132,1132,generalContainer,0.0022477013822477486,32,32,0
1133,1133,getByInputName,0.0022477013822477486,32,32,0
1134,1134,getCellContentsAtColumnIndex,0.0022477013822477486,32,32,0
1135,1135,getComponentContainer,0.0022477013822477486,32,32,0
1136,1136,getContributorNames,0.0022477013822477486,32,32,0
1137,1137,getDashArray,0.0022477013822477486,32,32,0
1138,1138,getElementsByClassName,0.0022477013822477486,32,32,0
1139,1139,getFirstShapeNode,0.0022477013822477486,32,32,0
1140,1140,getKey,0.0022477013822477486,32,32,0
1141,1141,getOnInputKeyDownStuff,0.0022477013822477486,32,32,0
1142,1142,getReactErrorOverlayContent,0.0022477013822477486,32,32,0
1143,1143,getTime,0.0022477013822477486,32,32,0
1144,1144,getToggleButton,0.0022477013822477486,32,32,0
1145,1145,getValue,0.0022477013822477486,32,32,0
1146,1146,gl,0.0022477013822477486,32,32,0
1147,1147,gridItems,0.0022477013822477486,32,32,0
1148,1148,gridItemsAfter,0.0022477013822477486,32,32,0
1149,1149,groupButtons,0.0022477013822477486,32,32,0
1150,1150,h2,0.0022477013822477486,32,32,0
1151,1151,heading,0.0022477013822477486,32,32,0
1152,1152,heightAbove,0.0022477013822477486,32,32,0
1153,1153,heightBeforeDrag,0.0022477013822477486,32,32,0
1154,1154,heightBelow,0.0022477013822477486,32,32,0
1155,1155,hex2BgColor,0.0022477013822477486,32,32,0
1156,1156,hoverinfo,0.0022477013822477486,32,32,0
1157,1157,hoverlabel,0.0022477013822477486,32,32,0
1158,1158,hovermode,0.0022477013822477486,32,32,0
1159,1159,identifier,0.0022477013822477486,32,32,0
1160,1160,immediate,0.0022477013822477486,32,32,0
1161,1161,import,0.0022477013822477486,32,32,0
1162,1162,include,0.0022477013822477486,32,32,0
1163,1163,initTest,0.0022477013822477486,32,32,0
1164,1164,initialDashArray0,0.0022477013822477486,32,32,0
1165,1165,initialElement,0.0022477013822477486,32,32,0
1166,1166,initialErrors,0.0022477013822477486,32,32,0
1167,1167,initialFetchCount,0.0022477013822477486,32,32,0
1168,1168,initialGridItems,0.0022477013822477486,32,32,0
1169,1169,initialMountCount,0.0022477013822477486,32,32,0
1170,1170,initialServerItemCount,0.0022477013822477486,32,32,0
1171,1171,inject,0.0022477013822477486,32,32,0
1172,1172,inline,0.0022477013822477486,32,32,0
1173,1173,innerScroll,0.0022477013822477486,32,32,0
1174,1174,innerScrollTest,0.0022477013822477486,32,32,0
1175,1175,innerText,0.0022477013822477486,32,32,0
1176,1176,inputElement,0.0022477013822477486,32,32,0
1177,1177,insertTrigger,0.0022477013822477486,32,32,0
1178,1178,isActionFocused,0.0022477013822477486,32,32,0
1179,1179,isActive,0.0022477013822477486,32,32,0
1180,1180,isArray,0.0022477013822477486,32,32,0
1181,1181,isChromatic,0.0022477013822477486,32,32,0
1182,1182,isDisplayed,0.0022477013822477486,32,32,0
1183,1183,isFullscreen,0.0022477013822477486,32,32,0
1184,1184,isOpen,0.0022477013822477486,32,32,0
1185,1185,isPresent,0.0022477013822477486,32,32,0
1186,1186,kbd,0.0022477013822477486,32,32,0
1187,1187,keyboardDispatcher,0.0022477013822477486,32,32,0
1188,1188,keycodes,0.0022477013822477486,32,32,0
1189,1189,keydownEvents,0.0022477013822477486,32,32,0
1190,1190,labelElement,0.0022477013822477486,32,32,0
1191,1191,labelToShortCode,0.0022477013822477486,32,32,0
1192,1192,labels,0.0022477013822477486,32,32,0
1193,1193,languageField,0.0022477013822477486,32,32,0
1194,1194,lassoPoints,0.0022477013822477486,32,32,0
1195,1195,lat,0.0022477013822477486,32,32,0
1196,1196,layoutOptions,0.0022477013822477486,32,32,0
1197,1197,layoutOpts,0.0022477013822477486,32,32,0
1198,1198,left,0.0022477013822477486,32,32,0
1199,1199,leftTooltip,0.0022477013822477486,32,32,0
1200,1200,linux,0.0022477013822477486,32,32,0
1201,1201,loggingCheckbox,0.0022477013822477486,32,32,0
1202,1202,lon,0.0022477013822477486,32,32,0
1203,1203,makeAssertLassoPoints,0.0022477013822477486,32,32,0
1204,1204,makeAssertPoints,0.0022477013822477486,32,32,0
1205,1205,makeAssertRanges,0.0022477013822477486,32,32,0
1206,1206,makeAssertSelectedPoints,0.0022477013822477486,32,32,0
1207,1207,makeClickFn,0.0022477013822477486,32,32,0
1208,1208,makeHoverFn,0.0022477013822477486,32,32,0
1209,1209,makeRunner,0.0022477013822477486,32,32,0
1210,1210,makeUnhoverFn,0.0022477013822477486,32,32,0
1211,1211,matchArrayElements,0.0022477013822477486,32,32,0
1212,1212,members,0.0022477013822477486,32,32,0
1213,1213,menuItemHeight,0.0022477013822477486,32,32,0
1214,1214,metrics,0.0022477013822477486,32,32,0
1215,1215,mid,0.0022477013822477486,32,32,0
1216,1216,mock14Pts,0.0022477013822477486,32,32,0
1217,1217,mock3,0.0022477013822477486,32,32,0
1218,1218,mock4,0.0022477013822477486,32,32,0
1219,1219,mockData,0.0022477013822477486,32,32,0
1220,1220,mockDataset,0.0022477013822477486,32,32,0
1221,1221,mockLayout,0.0022477013822477486,32,32,0
1222,1222,mockList,0.0022477013822477486,32,32,0
1223,1223,mockProps,0.0022477013822477486,32,32,0
1224,1224,mocked,0.0022477013822477486,32,32,0
1225,1225,mocks,0.0022477013822477486,32,32,0
1226,1226,modifiedDateSortButton,0.0022477013822477486,32,32,0
1227,1227,moment,0.0022477013822477486,32,32,0
1228,1228,mostOfDrag,0.0022477013822477486,32,32,0
1229,1229,mouseEvent,0.0022477013822477486,32,32,0
1230,1230,move,0.0022477013822477486,32,32,0
1231,1231,msgFull,0.0022477013822477486,32,32,0
1232,1232,mutation,0.0022477013822477486,32,32,0
1233,1233,names1,0.0022477013822477486,32,32,0
1234,1234,names2,0.0022477013822477486,32,32,0
1235,1235,names3,0.0022477013822477486,32,32,0
1236,1236,names4,0.0022477013822477486,32,32,0
1237,1237,nativeElement,0.0022477013822477486,32,32,0
1238,1238,newConfig,0.0022477013822477486,32,32,0
1239,1239,newConfigName,0.0022477013822477486,32,32,0
1240,1240,newDashArray,0.0022477013822477486,32,32,0
1241,1241,newDimension,0.0022477013822477486,32,32,0
1242,1242,newFetchCount,0.0022477013822477486,32,32,0
1243,1243,newLabelColor,0.0022477013822477486,32,32,0
1244,1244,newLabelDescription,0.0022477013822477486,32,32,0
1245,1245,newName,0.0022477013822477486,32,32,0
1246,1246,newPage,0.0022477013822477486,32,32,0
1247,1247,newTotal,0.0022477013822477486,32,32,0
1248,1248,newX,0.0022477013822477486,32,32,0
1249,1249,newY,0.0022477013822477486,32,32,0
1250,1250,noHoverLabel,0.0022477013822477486,32,32,0
1251,1251,noUnHover,0.0022477013822477486,32,32,0
1252,1252,nodeId,0.0022477013822477486,32,32,0
1253,1253,nowElement,0.0022477013822477486,32,32,0
1254,1254,oldLabelColor,0.0022477013822477486,32,32,0
1255,1255,oldLabelDescription,0.0022477013822477486,32,32,0
1256,1256,oldLabelName,0.0022477013822477486,32,32,0
1257,1257,onCompletedFn,0.0022477013822477486,32,32,0
1258,1258,onRenderCellMock,0.0022477013822477486,32,32,0
1259,1259,open,0.0022477013822477486,32,32,0
1260,1260,openClose,0.0022477013822477486,32,32,0
1261,1261,openHeight,0.0022477013822477486,32,32,0
1262,1262,optionTop,0.0022477013822477486,32,32,0
1263,1263,originalX,0.0022477013822477486,32,32,0
1264,1264,originalY,0.0022477013822477486,32,32,0
1265,1265,out,0.0022477013822477486,32,32,0
1266,1266,out1,0.0022477013822477486,32,32,0
1267,1267,overlay,0.0022477013822477486,32,32,0
1268,1268,overlayContainer,0.0022477013822477486,32,32,0
1269,1269,overlayElement,0.0022477013822477486,32,32,0
1270,1270,overlayOne,0.0022477013822477486,32,32,0
1271,1271,overlayOnePane,0.0022477013822477486,32,32,0
1272,1272,overlayOneSpy,0.0022477013822477486,32,32,0
1273,1273,overlayRef,0.0022477013822477486,32,32,0
1274,1274,overlayTwo,0.0022477013822477486,32,32,0
1275,1275,overlayTwoSpy,0.0022477013822477486,32,32,0
1276,1276,owners,0.0022477013822477486,32,32,0
1277,1277,p0,0.0022477013822477486,32,32,0
1278,1278,package,0.0022477013822477486,32,32,0
1279,1279,panelCount,0.0022477013822477486,32,32,0
1280,1280,panelLeft,0.0022477013822477486,32,32,0
1281,1281,panelPosition,0.0022477013822477486,32,32,0
1282,1282,panels,0.0022477013822477486,32,32,0
1283,1283,platform,0.0022477013822477486,32,32,0
1284,1284,plotMock14,0.0022477013822477486,32,32,0
1285,1285,plotly_relayout,0.0022477013822477486,32,32,0
1286,1286,pointNumber,0.0022477013822477486,32,32,0
1287,1287,points,0.0022477013822477486,32,32,0
1288,1288,popperChildren,0.0022477013822477486,32,32,0
1289,1289,pre,0.0022477013822477486,32,32,0
1290,1290,preSelection,0.0022477013822477486,32,32,0
1291,1291,press,0.0022477013822477486,32,32,0
1292,1292,previewProps,0.0022477013822477486,32,32,0
1293,1293,previousFocusedAction,0.0022477013822477486,32,32,0
1294,1294,provide,0.0022477013822477486,32,32,0
1295,1295,pt,0.0022477013822477486,32,32,0
1296,1296,pts,0.0022477013822477486,32,32,0
1297,1297,r2l,0.0022477013822477486,32,32,0
1298,1298,ranges,0.0022477013822477486,32,32,0
1299,1299,realNavProps,0.0022477013822477486,32,32,0
1300,1300,realProps,0.0022477013822477486,32,32,0
1301,1301,relayoutNumber,0.0022477013822477486,32,32,0
1302,1302,reload,0.0022477013822477486,32,32,0
1303,1303,resetNumber,0.0022477013822477486,32,32,0
1304,1304,resolvers,0.0022477013822477486,32,32,0
1305,1305,restore,0.0022477013822477486,32,32,0
1306,1306,restored,0.0022477013822477486,32,32,0
1307,1307,results,0.0022477013822477486,32,32,0
1308,1308,retentionRules,0.0022477013822477486,32,32,0
1309,1309,right,0.0022477013822477486,32,32,0
1310,1310,rightTooltip,0.0022477013822477486,32,32,0
1311,1311,rng,0.0022477013822477486,32,32,0
1312,1312,run,0.0022477013822477486,32,32,0
1313,1313,saveChangesButton,0.0022477013822477486,32,32,0
1314,1314,scatter2d,0.0022477013822477486,32,32,0
1315,1315,sceneTarget,0.0022477013822477486,32,32,0
1316,1316,screen,0.0022477013822477486,32,32,0
1317,1317,scrollHeight,0.0022477013822477486,32,32,0
1318,1318,scrollMaxY,0.0022477013822477486,32,32,0
1319,1319,scrollToY,0.0022477013822477486,32,32,0
1320,1320,secondBinPts,0.0022477013822477486,32,32,0
1321,1321,secondBucket,0.0022477013822477486,32,32,0
1322,1322,secondCanvas,0.0022477013822477486,32,32,0
1323,1323,secondGlContext,0.0022477013822477486,32,32,0
1324,1324,secondGlplotObject,0.0022477013822477486,32,32,0
1325,1325,secondTelegraf,0.0022477013822477486,32,32,0
1326,1326,selPts,0.0022477013822477486,32,32,0
1327,1327,selectedData,0.0022477013822477486,32,32,0
1328,1328,sendKeys,0.0022477013822477486,32,32,0
1329,1329,serverItems,0.0022477013822477486,32,32,0
1330,1330,setI,0.0022477013822477486,32,32,0
1331,1331,setOpen,0.0022477013822477486,32,32,0
1332,1332,setScrollTop,0.0022477013822477486,32,32,0
1333,1333,shapeNodeAfterDrag,0.0022477013822477486,32,32,0
1334,1334,shapeNodeBeforeDrag,0.0022477013822477486,32,32,0
1335,1335,shapes,0.0022477013822477486,32,32,0
1336,1336,shiftClickSecondBin,0.0022477013822477486,32,32,0
1337,1337,shiftClickThirdBin,0.0022477013822477486,32,32,0
1338,1338,short,0.0022477013822477486,32,32,0
1339,1339,showLongItems,0.0022477013822477486,32,32,0
1340,1340,showNav,0.0022477013822477486,32,32,0
1341,1341,showPanel,0.0022477013822477486,32,32,0
1342,1342,showlegend,0.0022477013822477486,32,32,0
1343,1343,slideToggle,0.0022477013822477486,32,32,0
1344,1344,slideToggleDebug,0.0022477013822477486,32,32,0
1345,1345,snapDelay,0.0022477013822477486,32,32,0
1346,1346,sortColumnAtIndex,0.0022477013822477486,32,32,0
1347,1347,standard,0.0022477013822477486,32,32,0
1348,1348,statusSlider,0.0022477013822477486,32,32,0
1349,1349,storyFn,0.0022477013822477486,32,32,0
1350,1350,storyId,0.0022477013822477486,32,32,0
1351,1351,subplot,0.0022477013822477486,32,32,0
1352,1352,subscribe,0.0022477013822477486,32,32,0
1353,1353,subtract,0.0022477013822477486,32,32,0
1354,1354,telegrafConfigName,0.0022477013822477486,32,32,0
1355,1355,telegrafs,0.0022477013822477486,32,32,0
1356,1356,temporaryWrapper,0.0022477013822477486,32,32,0
1357,1357,testCombination,0.0022477013822477486,32,32,0
1358,1358,testComponent,0.0022477013822477486,32,32,0
1359,1359,testData,0.0022477013822477486,32,32,0
1360,1360,testSet1,0.0022477013822477486,32,32,0
1361,1361,testSet2,0.0022477013822477486,32,32,0
1362,1362,testsContainerElement,0.0022477013822477486,32,32,0
1363,1363,text_color,0.0022477013822477486,32,32,0
1364,1364,thirdBinPts,0.0022477013822477486,32,32,0
1365,1365,thirdBucket,0.0022477013822477486,32,32,0
1366,1366,thirdTelegraf,0.0022477013822477486,32,32,0
1367,1367,timeDiff,0.0022477013822477486,32,32,0
1368,1368,toBeGreaterThanOrEqual,0.0022477013822477486,32,32,0
1369,1369,toBeLessThan,0.0022477013822477486,32,32,0
1370,1370,toCheck,0.0022477013822477486,32,32,0
1371,1371,toggleMountTrigger,0.0022477013822477486,32,32,0
1372,1372,toggleTriggered,0.0022477013822477486,32,32,0
1373,1373,tol,0.0022477013822477486,32,32,0
1374,1374,tooltipTitle,0.0022477013822477486,32,32,0
1375,1375,topMostPositionForPerfectCentering,0.0022477013822477486,32,32,0
1376,1376,topTooltip,0.0022477013822477486,32,32,0
1377,1377,touchDrag,0.0022477013822477486,32,32,0
1378,1378,touchEvent,0.0022477013822477486,32,32,0
1379,1379,traceNum,0.0022477013822477486,32,32,0
1380,1380,triggerEvent,0.0022477013822477486,32,32,0
1381,1381,triggerFontSize,0.0022477013822477486,32,32,0
1382,1382,triggerLineHeightEm,0.0022477013822477486,32,32,0
1383,1383,triggerTop,0.0022477013822477486,32,32,0
1384,1384,ttContainer,0.0022477013822477486,32,32,0
1385,1385,unsubscribeFromFriendStatus,0.0022477013822477486,32,32,0
1386,1386,updateSettings,0.0022477013822477486,32,32,0
1387,1387,updatedAt,0.0022477013822477486,32,32,0
1388,1388,updatedCount,0.0022477013822477486,32,32,0
1389,1389,updatedMountCount,0.0022477013822477486,32,32,0
1390,1390,utils,0.0022477013822477486,32,32,0
1391,1391,variables,0.0022477013822477486,32,32,0
1392,1392,viewMode,0.0022477013822477486,32,32,0
1393,1393,viewport,0.0022477013822477486,32,32,0
1394,1394,visit,0.0022477013822477486,32,32,0
1395,1395,waitForVisible,0.0022477013822477486,32,32,0
1396,1396,waitForWidgetSettingsSync,0.0022477013822477486,32,32,0
1397,1397,waitToAppear,0.0022477013822477486,32,32,0
1398,1398,waitUntilClickable,0.0022477013822477486,32,32,0
1399,1399,webElement,0.0022477013822477486,32,32,0
1400,1400,webviewContext,0.0022477013822477486,32,32,0
1401,1401,whenStable,0.0022477013822477486,32,32,0
1402,1402,windows,0.0022477013822477486,32,32,0
1403,1403,windows1,0.0022477013822477486,32,32,0
1404,1404,write,0.0022477013822477486,32,32,0
1405,1405,xa,0.0022477013822477486,32,32,0
1406,1406,xa2,0.0022477013822477486,32,32,0
1407,1407,xaxis2,0.0022477013822477486,32,32,0
1408,1408,xr,0.0022477013822477486,32,32,0
1409,1409,xr2,0.0022477013822477486,32,32,0
1410,1410,} ${,0.0022477013822477486,32,32,0
1411,1411,} should be ${,0.0022477013822477486,32,32,0
1412,1412,}/cells/${,0.0022477013822477486,32,32,0
1413,1413,}/dashboards/${,0.0022477013822477486,32,32,0
1414,1414,}/edit`,0.0022477013822477486,32,32,0
1415,1415,"}\""]`",0.0022477013822477486,32,32,0
1416,1416,}__${,0.0022477013822477486,32,32,0
1417,1417,}__dark`,0.0022477013822477486,32,32,0
1418,1418,}__desktop`,0.0022477013822477486,32,32,0
1419,1419,}__mobile`,0.0022477013822477486,32,32,0
1420,1420,"}|>
        ${",0.0022477013822477486,32,32,0
1421,1421,}|>${,0.0022477013822477486,32,32,0
1422,1422,is,0.002225156178694853,42,32,10
1423,1423,undefined,0.002196098414176522,105,64,41
1424,1424,src,0.002180265515862408,27,0,27
1425,1425,createMachine,0.0021802655158624073,27,0,27
1426,1426,food,0.0021802655158624073,27,0,27
1427,1427,head,0.0021802655158624073,27,0,27
1428,1428,elementById,0.0021802655158624064,27,0,27
1429,1429,activeElement,0.0021627159285914355,37,32,5
1430,1430,JSON,0.002130331746911782,127,64,63
1431,1431,'foo',0.0020993453841887146,26,0,26
1432,1432,attr,0.0020993453841887137,26,0,26
1433,1433,slug,0.00209934538418871,26,0,26
1434,1434,getInstance,0.0020184383320964398,25,0,25
1435,1435,toast,0.002018438332096439,25,0,25
1436,1436,m,0.0020184383320964385,25,0,25
1437,1437,Machine,0.002018438332096438,25,0,25
1438,1438,interval,0.0020022169458716148,35,32,3
1439,1439,textarea,0.0020022169458716148,35,32,3
1440,1440,pathname,0.0019853839475102615,95,64,31
1441,1441,childMachine,0.0019375443551578478,24,0,24
1442,1442,rel,0.001937544355157847,24,0,24
1443,1443,collapse,0.001937544355157846,24,0,24
1444,1444,forward,0.0019219868628571352,34,32,2
1445,1445,last,0.0019219868628571352,34,32,2
1446,1446,sort,0.0019219868628571352,34,32,2
1447,1447,store,0.0019219868628571352,34,32,2
1448,1448,path,0.001916115840361332,96,32,64
1449,1449,'two',0.0019039509959035445,38,32,6
1450,1450,onDone,0.0018566634489551367,23,0,23
1451,1451,Util,0.0018566634489551365,23,0,23
1452,1452,entry,0.0018566634489551365,23,0,23
1453,1453,'test',0.0018566634489551356,23,0,23
1454,1454,tagNodes,0.001856663448955135,23,0,23
1455,1455,Tooltip,0.0018486765624661135,44,32,12
1456,1456,"""keywords""",0.0018417697129300345,33,32,1
1457,1457,'absolute',0.0018417697129300345,33,32,1
1458,1458,'style',0.0018417697129300345,33,32,1
1459,1459,/routeChangeComplete/,0.0018417697129300345,33,32,1
1460,1460,2000,0.0018417697129300345,33,32,1
1461,1461,before,0.0018417697129300345,33,32,1
1462,1462,codeToDelete,0.0018417697129300345,33,32,1
1463,1463,domain,0.0018417697129300345,33,32,1
1464,1464,email,0.0018417697129300345,33,32,1
1465,1465,h1,0.0018417697129300345,33,32,1
1466,1466,image,0.0018417697129300345,33,32,1
1467,1467,isReady,0.0018417697129300345,33,32,1
1468,1468,k,0.0018417697129300345,33,32,1
1469,1469,scrollRestoration,0.0018417697129300345,33,32,1
1470,1470,translate,0.0018417697129300345,33,32,1
1471,1471,"}""]`",0.0018417697129300345,33,32,1
1472,1472,html2,0.0017757956090726727,22,0,22
1473,1473,parentMachine,0.0017757956090726727,22,0,22
1474,1474,patchFile,0.001775795609072671,22,0,22
1475,1475,module,0.0017757956090726705,22,0,22
1476,1476,back,0.001743426125209793,36,32,4
1477,1477,EventHandler,0.0016949408310964914,21,0,21
1478,1478,_accept,0.0016949408310964907,21,0,21
1479,1479,isAction,0.0016949408310964905,21,0,21
1480,1480,options,0.0016879961804185674,42,32,10
1481,1481,class,0.0016640260704577842,87,64,23
1482,1482,message,0.001654102032110304,47,32,15
1483,1483,extends,0.001618489745057855,38,32,6
1484,1484,renderViaHTTP,0.0016140991106135061,20,0,20
1485,1485,dispatchEvent,0.0016140991106135048,20,0,20
1486,1486,computed,0.0016140991106135048,20,0,20
1487,1487,params,0.0016140991106135048,20,0,20
1488,1488,'BAR',0.0016140991106135042,20,0,20
1489,1489,querySelector,0.001612882295988913,362,160,202
1490,1490,'100%',0.0015829530217380502,34,32,2
1491,1491,pages,0.0015829530217380502,34,32,2
1492,1492,promise,0.0015829530217380502,34,32,2
1493,1493,PropTypes,0.0015382208366266604,37,32,5
1494,1494,sections,0.0015332704432115254,19,0,19
1495,1495,that,0.0015332704432115254,19,0,19
1496,1496,getByTestId,0.0015332704432115245,19,0,19
1497,1497,popover,0.0015332704432115245,19,0,19
1498,1498,tree,0.0015332704432115245,19,0,19
1499,1499,route,0.0015332704432115243,19,0,19
1500,1500,"
                            ",0.0015332704432115243,19,0,19
1501,1501,tab,0.0015332704432115243,19,0,19
1502,1502,URL,0.001533270443211524,19,0,19
1503,1503,keydown,0.001533270443211524,19,0,19
1504,1504,property,0.0015332704432115235,19,0,19
1505,1505,transition,0.001496851695587581,86,32,54
1506,1506,scroll,0.0014579648743641032,36,32,4
1507,1507,B,0.0014524548244856834,18,0,18
1508,1508,scrollSpy,0.0014524548244856834,18,0,18
1509,1509,HELMET_ATTRIBUTE,0.0014524548244856832,18,0,18
1510,1510,an,0.0014524548244856832,18,0,18
1511,1511,toastEl,0.001452454824485683,18,0,18
1512,1512,matches,0.0014524548244856828,18,0,18
1513,1513,cb,0.0014524548244856821,18,0,18
1514,1514,callThrough,0.0014524548244856817,18,0,18
1515,1515,assign,0.0014524548244856813,18,0,18
1516,1516,dropdown,0.0014047873255328856,84,32,52
1517,1517,classes,0.00137772185390684,35,32,3
1518,1518,dispose,0.00137772185390684,35,32,3
1519,1519,post,0.00137772185390684,35,32,3
1520,1520,u,0.00137772185390684,35,32,3
1521,1521,popoverEl,0.0013716522500283415,17,0,17
1522,1522,port,0.001371652250028341,17,0,17
1523,1523,link,0.0013716522500283408,17,0,17
1524,1524,collapseEl,0.0013716522500283404,17,0,17
1525,1525,Object,0.0013716522500283402,17,0,17
1526,1526,expectLog,0.0013716522500283402,17,0,17
1527,1527,'fileDir',0.0013716522500283397,17,0,17
1528,1528,plugins,0.001371652250028339,17,0,17
1529,1529,makeObservable,0.0013716522500283389,17,0,17
1530,1530,content,0.0013633085572526294,69,32,37
1531,1531,style,0.0013053685396137488,60,32,28
1532,1532,console,0.0013000657757293254,40,32,8
1533,1533,toThrow,0.0013000657757293252,40,32,8
1534,1534,json,0.0012908627154379635,16,0,16
1535,1535,call,0.0012908627154379628,16,0,16
1536,1536,components,0.0012908627154379626,16,0,16
1537,1537,flushTracked,0.0012908627154379626,16,0,16
1538,1538,request,0.0012908627154379626,16,0,16
1539,1539,lightMachine,0.0012908627154379624,16,0,16
1540,1540,never,0.0012908627154379624,16,0,16
1541,1541,'h1',0.0012908627154379622,16,0,16
1542,1542,Ctx,0.0012908627154379622,16,0,16
1543,1543,err,0.0012908627154379609,16,0,16
1544,1544,Events,0.0012100862163156225,15,0,15
1545,1545,FixtureTreeNode,0.0012100862163156225,15,0,15
1546,1546,req,0.0012100862163156225,15,0,15
1547,1547,testEl,0.0012100862163156225,15,0,15
1548,1548,toString,0.0012100862163156225,15,0,15
1549,1549,constructor,0.0012100862163156223,15,0,15
1550,1550,isObservableProp,0.001210086216315622,15,0,15
1551,1551,testMachine,0.001210086216315622,15,0,15
1552,1552,TestComponent,0.0012062661269335077,36,32,4
1553,1553,keys,0.0012062661269335077,36,32,4
1554,1554,newValue,0.0012062661269335077,36,32,4
1555,1555,'',0.0011911799472630927,94,64,30
1556,1556,as,0.0011530015071255886,143,64,79
1557,1557,parse,0.0011459199923427557,71,32,39
1558,1558,meta,0.0011459199923427549,71,32,39
1559,1559,manifest,0.0011293227482600645,14,0,14
1560,1560,toggle,0.0011293227482600642,14,0,14
1561,1561,firstTag,0.001129322748260064,14,0,14
1562,1562,'#page-data',0.0011293227482600636,14,0,14
1563,1563,Tab,0.0011293227482600636,14,0,14
1564,1564,_element,0.0011293227482600636,14,0,14
1565,1565,cosmosConfig,0.0011293227482600636,14,0,14
1566,1566,fixtureId,0.0011293227482600636,14,0,14
1567,1567,'en',0.0011293227482600634,14,0,14
1568,1568,error,0.0011293227482600632,14,0,14
1569,1569,filePath,0.0011293227482600632,14,0,14
1570,1570,triggerDropdown,0.001129322748260063,14,0,14
1571,1571,'INC',0.0011293227482600623,14,0,14
1572,1572,bound,0.0011293227482600623,14,0,14
1573,1573,'final',0.0011293227482600619,14,0,14
1574,1574,render$,0.0011293227482600619,14,0,14
1575,1575,"
                    ",0.0011120964760358402,49,32,17
1576,1576,textContent,0.001059223256169423,42,32,10
1577,1577,now,0.0010592201944547536,37,32,5
1578,1578,config,0.0010525539776685552,76,32,44
1579,1579,'EVENT',0.0010485723068753587,13,0,13
1580,1580,dropdownMenu,0.0010485723068753587,13,0,13
1581,1581,files,0.0010485723068753587,13,0,13
1582,1582,Button,0.0010485723068753576,13,0,13
1583,1583,Carousel,0.0010485723068753576,13,0,13
1584,1584,Modal,0.0010485723068753576,13,0,13
1585,1585,createEvent,0.0010485723068753576,13,0,13
1586,1586,twoState,0.0010485723068753574,13,0,13
1587,1587,'fixture',0.0010485723068753572,13,0,13
1588,1588,flow,0.0010485723068753572,13,0,13
1589,1589,requests,0.001048572306875357,13,0,13
1590,1590,'  </div>',0.001048572306875356,13,0,13
1591,1591,collapsedTree,0.001048572306875356,13,0,13
1592,1592,getOrCreateInstance,0.001048572306875356,13,0,13
1593,1593,'active',0.0010291602802058146,55,32,23
1594,1594,number,0.0010014456016404101,126,64,62
1595,1595,instanceof,0.0009789025193709083,41,32,9
1596,1596,active,0.0009678348877680202,12,0,12
1597,1597,'#layout-data',0.0009678348877680196,12,0,12
1598,1598,'NEXT',0.0009678348877680196,12,0,12
1599,1599,alert,0.0009678348877680196,12,0,12
1600,1600,api,0.0009678348877680196,12,0,12
1601,1601,fs,0.0009678348877680196,12,0,12
1602,1602,markup,0.0009678348877680196,12,0,12
1603,1603,matchMultiDom,0.0009678348877680196,12,0,12
1604,1604,offcanvas,0.0009678348877680196,12,0,12
1605,1605,toBeFalse,0.0009678348877680196,12,0,12
1606,1606,historyMachine,0.0009678348877680194,12,0,12
1607,1607,myProp,0.0009678348877680191,12,0,12
1608,1608,Offcanvas,0.0009678348877680189,12,0,12
1609,1609,'src',0.0009678348877680187,12,0,12
1610,1610,Toast,0.0009678348877680185,12,0,12
1611,1611,Date,0.0008985947462214925,40,32,8
1612,1612,NEXT,0.000887110486548783,11,0,11
1613,1613,deepMachine,0.000887110486548783,11,0,11
1614,1614,origContent,0.000887110486548783,11,0,11
1615,1615,rules,0.000887110486548783,11,0,11
1616,1616,'pass',0.0008871104865487821,11,0,11
1617,1617,countMachine,0.0008871104865487821,11,0,11
1618,1618,layoutData,0.0008871104865487821,11,0,11
1619,1619,pageData,0.0008871104865487821,11,0,11
1620,1620,toStrictEqual,0.0008871104865487821,11,0,11
1621,1621,bar,0.0008871104865487819,11,0,11
1622,1622,outerHTML,0.0008871104865487819,11,0,11
1623,1623,'yes',0.0008871104865487819,11,0,11
1624,1624,Dashboard,0.0008871104865487819,11,0,11
1625,1625,Test,0.0008871104865487819,11,0,11
1626,1626,focustrap,0.0008871104865487819,11,0,11
1627,1627,initialHtml,0.0008871104865487819,11,0,11
1628,1628,myAction,0.0008871104865487819,11,0,11
1629,1629,ontouchstart,0.0008871104865487819,11,0,11
1630,1630,arr,0.0008871104865487817,11,0,11
1631,1631,stringMatching,0.0008871104865487815,11,0,11
1632,1632,countService,0.0008871104865487813,11,0,11
1633,1633,Dropdown,0.0008871104865487811,11,0,11
1634,1634,scrollBar,0.0008871104865487811,11,0,11
1635,1635,ScrollSpy,0.0008871104865487808,11,0,11
1636,1636,show,0.0008063990988252156,10,0,10
1637,1637,joined,0.0008063990988252156,10,0,10
1638,1638,language,0.0008063990988252156,10,0,10
1639,1639,use,0.0008063990988252156,10,0,10
1640,1640,"'link[as=""font""]'",0.0008063990988252147,10,0,10
1641,1641,res1,0.0008063990988252147,10,0,10
1642,1642,scrollspy,0.0008063990988252147,10,0,10
1643,1643,toMatchInlineSnapshot,0.0008063990988252147,10,0,10
1644,1644,'image/png',0.0008063990988252145,10,0,10
1645,1645,matchesState,0.0008063990988252145,10,0,10
1646,1646,report,0.0008063990988252145,10,0,10
1647,1647,res3,0.0008063990988252145,10,0,10
1648,1648,scheduler,0.0008063990988252145,10,0,10
1649,1649,bodySize,0.0008063990988252142,10,0,10
1650,1650,Popover,0.000806399098825214,10,0,10
1651,1651,tip,0.000806399098825214,10,0,10
1652,1652,toThrowErrorMatchingInlineSnapshot,0.000806399098825214,10,0,10
1653,1653,'idle',0.0008063990988252138,10,0,10
1654,1654,prop,0.0008063990988252138,10,0,10
1655,1655,script,0.0008063990988252138,10,0,10
1656,1656,toBeTrue,0.0008063990988252138,10,0,10
1657,1657,counterMachine,0.0008063990988252134,10,0,10
1658,1658,env,0.0008063990988252134,10,0,10
1659,1659,component,0.0007257007202130464,9,0,9
1660,1660,global,0.0007257007202130464,9,0,9
1661,1661,toHaveBeenCalledWith,0.0007257007202130464,9,0,9
1662,1662,'a nice desc',0.0007257007202130464,9,0,9
1663,1663,'rr',0.0007257007202130464,9,0,9
1664,1664,'world',0.0007257007202130464,9,0,9
1665,1665,answer,0.0007257007202130464,9,0,9
1666,1666,lang,0.0007257007202130464,9,0,9
1667,1667,promiseMachine,0.0007257007202130464,9,0,9
1668,1668,secondTag,0.0007257007202130464,9,0,9
1669,1669,services,0.0007257007202130464,9,0,9
1670,1670,stateOff,0.0007257007202130464,9,0,9
1671,1671,"""description""",0.0007257007202130462,9,0,9
1672,1672,'font',0.0007257007202130462,9,0,9
1673,1673,'font/woff2',0.0007257007202130462,9,0,9
1674,1674,'preload',0.0007257007202130462,9,0,9
1675,1675,Element,0.0007257007202130462,9,0,9
1676,1676,array,0.0007257007202130462,9,0,9
1677,1677,counter,0.0007257007202130462,9,0,9
1678,1678,crossorigin,0.0007257007202130462,9,0,9
1679,1679,hasOwnProperty,0.0007257007202130462,9,0,9
1680,1680,'d',0.000725700720213046,9,0,9
1681,1681,outputIndex,0.000725700720213046,9,0,9
1682,1682,version,0.000725700720213046,9,0,9
1683,1683,super,0.0007257007202130458,9,0,9
1684,1684,'true',0.0007257007202130456,9,0,9
1685,1685,Collapse,0.0007257007202130456,9,0,9
1686,1686,newHtml,0.0007257007202130456,9,0,9
1687,1687,template,0.0007257007202130456,9,0,9
1688,1688,testModel,0.0007257007202130456,9,0,9
1689,1689,'normal',0.0007257007202130454,9,0,9
1690,1690,FileRef,0.0007257007202130454,9,0,9
1691,1691,typeof,0.0006450153463265634,8,0,8
1692,1692,"""canonical""",0.0006450153463265634,8,0,8
1693,1693,'child',0.0006450153463265634,8,0,8
1694,1694,'link',0.0006450153463265634,8,0,8
1695,1695,'my-image',0.0006450153463265634,8,0,8
1696,1696,Context,0.0006450153463265634,8,0,8
1697,1697,ascentOverride,0.0006450153463265634,8,0,8
1698,1698,b2,0.0006450153463265634,8,0,8
1699,1699,btnClose,0.0006450153463265634,8,0,8
1700,1700,buffer,0.0006450153463265634,8,0,8
1701,1701,dataEl,0.0006450153463265634,8,0,8
1702,1702,descentOverride,0.0006450153463265634,8,0,8
1703,1703,evalInContext,0.0006450153463265634,8,0,8
1704,1704,executed,0.0006450153463265634,8,0,8
1705,1705,expectedCount,0.0006450153463265634,8,0,8
1706,1706,filepath,0.0006450153463265634,8,0,8
1707,1707,getPaddingX,0.0006450153463265634,8,0,8
1708,1708,hello,0.0006450153463265634,8,0,8
1709,1709,lineGapOverride,0.0006450153463265634,8,0,8
1710,1710,sizeAdjust,0.0006450153463265634,8,0,8
1711,1711,transitions,0.0006450153463265634,8,0,8
1712,1712,log,0.0006450153463265632,8,0,8
1713,1713,MRPropTypes,0.0006450153463265632,8,0,8
1714,1714,nested,0.0006450153463265632,8,0,8
1715,1715,noop,0.0006450153463265632,8,0,8
1716,1716,toHaveSize,0.0006450153463265632,8,0,8
1717,1717,calledCount,0.000645015346326563,8,0,8
1718,1718,initialRes,0.000645015346326563,8,0,8
1719,1719,originalPadding,0.000645015346326563,8,0,8
1720,1720,Alert,0.0006450153463265628,8,0,8
1721,1721,shallow,0.0006450153463265626,8,0,8
1722,1722,"""action""",0.0006450153463265626,8,0,8
1723,1723,'click',0.0006450153463265626,8,0,8
1724,1724,alertEl,0.0006450153463265626,8,0,8
1725,1725,"""getAttribute""",0.0006450153463265623,8,0,8
1726,1726,'TIMER',0.0006450153463265623,8,0,8
1727,1727,cond,0.0006450153463265623,8,0,8
1728,1728,interpreter,0.0006450153463265623,8,0,8
1729,1729,isFlow,0.0006450153463265623,8,0,8
1730,1730,redirect,0.0006450153463265623,8,0,8
1731,1731,'/',0.000631928426872697,56,32,24
1732,1732,'mouseover',0.0006291628379669562,41,32,9
1733,1733,ReactDOM,0.0005808442120600432,51,32,19
1734,1734,'    </div>',0.0005643429727860468,7,0,7
1735,1735,'TO_TWO',0.0005643429727860468,7,0,7
1736,1736,'aria-expanded',0.0005643429727860468,7,0,7
1737,1737,'document.documentElement.innerHTML',0.0005643429727860468,7,0,7
1738,1738,'href',0.0005643429727860468,7,0,7
1739,1739,'pizza',0.0005643429727860468,7,0,7
1740,1740,'window.__TEST_NO_RELOAD',0.0005643429727860468,7,0,7
1741,1741,Data,0.0005643429727860468,7,0,7
1742,1742,DummyClass,0.0005643429727860468,7,0,7
1743,1743,DummyConfigClass,0.0005643429727860468,7,0,7
1744,1744,ca,0.0005643429727860468,7,0,7
1745,1745,divTest,0.0005643429727860468,7,0,7
1746,1746,errorMachine,0.0005643429727860468,7,0,7
1747,1747,exit,0.0005643429727860468,7,0,7
1748,1748,fixtures,0.0005643429727860468,7,0,7
1749,1749,interface,0.0005643429727860468,7,0,7
1750,1750,of,0.0005643429727860468,7,0,7
1751,1751,readFile,0.0005643429727860468,7,0,7
1752,1752,toContainEqual,0.0005643429727860468,7,0,7
1753,1753,toHaveLength,0.0005643429727860468,7,0,7
1754,1754,404,0.0005643429727860466,7,0,7
1755,1755,bodyTag,0.0005643429727860466,7,0,7
1756,1756,buildId,0.0005643429727860466,7,0,7
1757,1757,contentEl,0.0005643429727860466,7,0,7
1758,1758,htmlTag,0.0005643429727860466,7,0,7
1759,1759,myService,0.0005643429727860466,7,0,7
1760,1760,onBecomeObserved,0.0005643429727860466,7,0,7
1761,1761,onBecomeUnobserved,0.0005643429727860466,7,0,7
1762,1762,payload,0.0005643429727860466,7,0,7
1763,1763,schedule,0.0005643429727860466,7,0,7
1764,1764,"}=""true"">`",0.0005643429727860466,7,0,7
1765,1765,root,0.0005643429727860464,7,0,7
1766,1766,Child,0.0005643429727860464,7,0,7
1767,1767,_config,0.0005643429727860464,7,0,7
1768,1768,profileTriggerEl,0.0005643429727860464,7,0,7
1769,1769,warn,0.0005643429727860464,7,0,7
1770,1770,"""text/css""",0.0005643429727860462,7,0,7
1771,1771,'content-type',0.0005643429727860462,7,0,7
1772,1772,'done.invoke.myService',0.0005643429727860462,7,0,7
1773,1773,devTools,0.0005643429727860462,7,0,7
1774,1774,isSerializableProps,0.0005643429727860462,7,0,7
1775,1775,v,0.0005643429727860462,7,0,7
1776,1776,'baz',0.000564342972786046,7,0,7
1777,1777,btn,0.000564342972786046,7,0,7
1778,1778,changedState,0.000564342972786046,7,0,7
1779,1779,current,0.000564342972786046,7,0,7
1780,1780,exportPath,0.000564342972786046,7,0,7
1781,1781,homeHTML,0.000564342972786046,7,0,7
1782,1782,idle,0.000564342972786046,7,0,7
1783,1783,markdown,0.000564342972786046,7,0,7
1784,1784,swipeEl,0.000564342972786046,7,0,7
1785,1785,d,0.0005584560554037664,44,32,12
1786,1786,parent,0.0005388226211120971,60,32,28
1787,1787,"""name""",0.00048368359520705936,6,0,6
1788,1788,'#random-number',0.00048368359520705936,6,0,6
1789,1789,'a1',0.00048368359520705936,6,0,6
1790,1790,'content',0.00048368359520705936,6,0,6
1791,1791,Simulator,0.00048368359520705936,6,0,6
1792,1792,alias,0.00048368359520705936,6,0,6
1793,1793,evilObj,0.00048368359520705936,6,0,6
1794,1794,f,0.00048368359520705936,6,0,6
1795,1795,matchDom,0.00048368359520705936,6,0,6
1796,1796,matchers,0.00048368359520705936,6,0,6
1797,1797,onReceive,0.00048368359520705936,6,0,6
1798,1798,pagePath,0.00048368359520705936,6,0,6
1799,1799,randomNumber,0.00048368359520705936,6,0,6
1800,1800,startService,0.00048368359520705936,6,0,6
1801,1801,swipe,0.00048368359520705936,6,0,6
1802,1802,tag,0.00048368359520705936,6,0,6
1803,1803,toInclude,0.00048368359520705936,6,0,6
1804,1804,trapElement,0.00048368359520705936,6,0,6
1805,1805,currentPadding,0.00048368359520705915,6,0,6
1806,1806,getElements,0.00048368359520705915,6,0,6
1807,1807,getNextActiveElement,0.00048368359520705915,6,0,6
1808,1808,isDisabled,0.00048368359520705915,6,0,6
1809,1809,"""action.bound""",0.00048368359520705893,6,0,6
1810,1810,_event,0.00048368359520705893,6,0,6
1811,1811,author,0.00048368359520705893,6,0,6
1812,1812,getElement,0.00048368359520705893,6,0,6
1813,1813,increment,0.00048368359520705893,6,0,6
1814,1814,toggleMachine,0.00048368359520705893,6,0,6
1815,1815,userModel,0.00048368359520705893,6,0,6
1816,1816,'srcset',0.0004836835952070587,6,0,6
1817,1817,attribs,0.0004836835952070587,6,0,6
1818,1818,cnt,0.0004836835952070587,6,0,6
1819,1819,getByText,0.0004836835952070587,6,0,6
1820,1820,oneState,0.0004836835952070587,6,0,6
1821,1821,tooltipShown,0.0004836835952070587,6,0,6
1822,1822,ui,0.0004836835952070587,6,0,6
1823,1823,unbound,0.0004836835952070587,6,0,6
1824,1824,"""test""",0.0004836835952070585,6,0,6
1825,1825,'.alert',0.0004836835952070585,6,0,6
1826,1826,'PING',0.0004836835952070585,6,0,6
1827,1827,'disabled',0.0004836835952070585,6,0,6
1828,1828,'done',0.0004836835952070585,6,0,6
1829,1829,'fail',0.0004836835952070585,6,0,6
1830,1830,'inactive',0.0004836835952070585,6,0,6
1831,1831,'second',0.0004836835952070585,6,0,6
1832,1832,'static',0.0004836835952070585,6,0,6
1833,1833,EVENT,0.0004836835952070585,6,0,6
1834,1834,TextRenderer,0.0004836835952070585,6,0,6
1835,1835,expectedElements,0.0004836835952070585,6,0,6
1836,1836,interpret,0.0004836835952070585,6,0,6
1837,1837,keydownEscape,0.0004836835952070585,6,0,6
1838,1838,pageProps,0.0004836835952070585,6,0,6
1839,1839,persistedState,0.0004836835952070585,6,0,6
1840,1840,revalidateData,0.0004836835952070585,6,0,6
1841,1841,spyHide,0.0004836835952070585,6,0,6
1842,1842,val1,0.0004836835952070585,6,0,6
1843,1843,val2,0.0004836835952070585,6,0,6
1844,1844,server,0.0004030372092151003,5,0,5
1845,1845,"""ja""",0.0004030372092151003,5,0,5
1846,1846,"'      <img alt="""">'",0.0004030372092151003,5,0,5
1847,1847,'#nanoid',0.0004030372092151003,5,0,5
1848,1848,'</ul>',0.0004030372092151003,5,0,5
1849,1849,'A2',0.0004030372092151003,5,0,5
1850,1850,'anonymous',0.0004030372092151003,5,0,5
1851,1851,'bla',0.0004030372092151003,5,0,5
1852,1852,'data-next-font',0.0004030372092151003,5,0,5
1853,1853,'location.pathname',0.0004030372092151003,5,0,5
1854,1854,'next.config.js',0.0004030372092151003,5,0,5
1855,1855,32,0.0004030372092151003,5,0,5
1856,1856,C,0.0004030372092151003,5,0,5
1857,1857,Function,0.0004030372092151003,5,0,5
1858,1858,PageProps,0.0004030372092151003,5,0,5
1859,1859,TEST_KEY,0.0004030372092151003,5,0,5
1860,1860,ToolbarButtonRenderer,0.0004030372092151003,5,0,5
1861,1861,_popper,0.0004030372092151003,5,0,5
1862,1862,btnEl,0.0004030372092151003,5,0,5
1863,1863,clickEvent,0.0004030372092151003,5,0,5
1864,1864,dataRouteRegex,0.0004030372092151003,5,0,5
1865,1865,el2,0.0004030372092151003,5,0,5
1866,1866,element2,0.0004030372092151003,5,0,5
1867,1867,flowBound,0.0004030372092151003,5,0,5
1868,1868,getRequests,0.0004030372092151003,5,0,5
1869,1869,h,0.0004030372092151003,5,0,5
1870,1870,id2,0.0004030372092151003,5,0,5
1871,1871,keepAlive,0.0004030372092151003,5,0,5
1872,1872,mapping,0.0004030372092151003,5,0,5
1873,1873,mouseOverEvent,0.0004030372092151003,5,0,5
1874,1874,newNumber,0.0004030372092151003,5,0,5
1875,1875,renameFile,0.0004030372092151003,5,0,5
1876,1876,res4,0.0004030372092151003,5,0,5
1877,1877,runtime,0.0004030372092151003,5,0,5
1878,1878,shownCallback,0.0004030372092151003,5,0,5
1879,1879,stripAnsi,0.0004030372092151003,5,0,5
1880,1880,tabEl,0.0004030372092151003,5,0,5
1881,1881,toBeCalledWith,0.0004030372092151003,5,0,5
1882,1882,typeCheckFail,0.0004030372092151003,5,0,5
1883,1883,"""text/javascript""",0.0004030372092151001,5,0,5
1884,1884,$a,0.0004030372092151001,5,0,5
1885,1885,$icon,0.0004030372092151001,5,0,5
1886,1886,'#time',0.0004030372092151001,5,0,5
1887,1887,'shown.bs.collapse',0.0004030372092151001,5,0,5
1888,1888,TOGGLE,0.0004030372092151001,5,0,5
1889,1889,_getTipElement,0.0004030372092151001,5,0,5
1890,1890,activities,0.0004030372092151001,5,0,5
1891,1891,actor,0.0004030372092151001,5,0,5
1892,1892,checkLink,0.0004030372092151001,5,0,5
1893,1893,clock,0.0004030372092151001,5,0,5
1894,1894,depth,0.0004030372092151001,5,0,5
1895,1895,double,0.0004030372092151001,5,0,5
1896,1896,el1,0.0004030372092151001,5,0,5
1897,1897,expectedStateValues,0.0004030372092151001,5,0,5
1898,1898,getSortedRoutes,0.0004030372092151001,5,0,5
1899,1899,initialTime,0.0004030372092151001,5,0,5
1900,1900,ogImageUrl,0.0004030372092151001,5,0,5
1901,1901,one,0.0004030372092151001,5,0,5
1902,1902,spy2,0.0004030372092151001,5,0,5
1903,1903,stateValues,0.0004030372092151001,5,0,5
1904,1904,'1',0.00040303720921509986,5,0,5
1905,1905,'manual',0.00040303720921509986,5,0,5
1906,1906,React,0.00040303720921509986,5,0,5
1907,1907,boolean,0.00040303720921509986,5,0,5
1908,1908,box,0.00040303720921509986,5,0,5
1909,1909,jest,0.00040303720921509986,5,0,5
1910,1910,toBeUndefined,0.00040303720921509986,5,0,5
1911,1911,"""href""",0.00040303720921509986,5,0,5
1912,1912,"""observable""",0.00040303720921509986,5,0,5
1913,1913,"""rel""",0.00040303720921509986,5,0,5
1914,1914,'#catchall',0.00040303720921509986,5,0,5
1915,1915,'#page-type',0.00040303720921509986,5,0,5
1916,1916,'cache-control',0.00040303720921509986,5,0,5
1917,1917,'first',0.00040303720921509986,5,0,5
1918,1918,'myChild',0.00040303720921509986,5,0,5
1919,1919,'window.history.length',0.00040303720921509986,5,0,5
1920,1920,MachineEvent,0.00040303720921509986,5,0,5
1921,1921,Store,0.00040303720921509986,5,0,5
1922,1922,callbackSpy,0.00040303720921509986,5,0,5
1923,1923,deepEqual,0.00040303720921509986,5,0,5
1924,1924,eventLog,0.00040303720921509986,5,0,5
1925,1925,findByText,0.00040303720921509986,5,0,5
1926,1926,finished,0.00040303720921509986,5,0,5
1927,1927,fireEvent,0.00040303720921509986,5,0,5
1928,1928,globalImports,0.00040303720921509986,5,0,5
1929,1929,hostname,0.00040303720921509986,5,0,5
1930,1930,invokeCounter,0.00040303720921509986,5,0,5
1931,1931,isObservable,0.00040303720921509986,5,0,5
1932,1932,localId,0.00040303720921509986,5,0,5
1933,1933,method,0.00040303720921509986,5,0,5
1934,1934,popoverDisplayed,0.00040303720921509986,5,0,5
1935,1935,process,0.00040303720921509986,5,0,5
1936,1936,section,0.00040303720921509986,5,0,5
1937,1937,simpleState,0.00040303720921509986,5,0,5
1938,1938,spawn,0.00040303720921509986,5,0,5
1939,1939,titleTag,0.00040303720921509986,5,0,5
1940,1940,toMatchObject,0.00040303720921509986,5,0,5
1941,1941,todo,0.00040303720921509986,5,0,5
1942,1942,"""content""",0.00032240381043522476,4,0,4
1943,1943,"""double""",0.00032240381043522476,4,0,4
1944,1944,"""flow.bound""",0.00032240381043522476,4,0,4
1945,1945,"""type""",0.00032240381043522476,4,0,4
1946,1946,'  </li>',0.00032240381043522476,4,0,4
1947,1947,'#page',0.00032240381043522476,4,0,4
1948,1948,'#props',0.00032240381043522476,4,0,4
1949,1949,'.active',0.00032240381043522476,4,0,4
1950,1950,'/something',0.00032240381043522476,4,0,4
1951,1951,'count',0.00032240381043522476,4,0,4
1952,1952,'e',0.00032240381043522476,4,0,4
1953,1953,'go',0.00032240381043522476,4,0,4
1954,1954,'latest',0.00032240381043522476,4,0,4
1955,1955,'render-id',0.00032240381043522476,4,0,4
1956,1956,CACHE_HEADERS,0.00032240381043522476,4,0,4
1957,1957,age,0.00032240381043522476,4,0,4
1958,1958,asPath,0.00032240381043522476,4,0,4
1959,1959,babel,0.00032240381043522476,4,0,4
1960,1960,backdrop,0.00032240381043522476,4,0,4
1961,1961,base,0.00032240381043522476,4,0,4
1962,1962,buttonEl,0.00032240381043522476,4,0,4
1963,1963,calls,0.00032240381043522476,4,0,4
1964,1964,configDir,0.00032240381043522476,4,0,4
1965,1965,custom,0.00032240381043522476,4,0,4
1966,1966,delays,0.00032240381043522476,4,0,4
1967,1967,elementSelector,0.00032240381043522476,4,0,4
1968,1968,execute,0.00032240381043522476,4,0,4
1969,1969,getPaddingAttr,0.00032240381043522476,4,0,4
1970,1970,inc,0.00032240381043522476,4,0,4
1971,1971,initial$,0.00032240381043522476,4,0,4
1972,1972,newRes,0.00032240381043522476,4,0,4
1973,1973,normalizeRegEx,0.00032240381043522476,4,0,4
1974,1974,offset,0.00032240381043522476,4,0,4
1975,1975,oldValue,0.00032240381043522476,4,0,4
1976,1976,scrollBarWidth,0.00032240381043522476,4,0,4
1977,1977,shortestPaths,0.00032240381043522476,4,0,4
1978,1978,store1,0.00032240381043522476,4,0,4
1979,1979,store2,0.00032240381043522476,4,0,4
1980,1980,tabEl1,0.00032240381043522476,4,0,4
1981,1981,tags,0.00032240381043522476,4,0,4
1982,1982,targetSelector,0.00032240381043522476,4,0,4
1983,1983,testElementIsActiveAfterScroll,0.00032240381043522476,4,0,4
1984,1984,testInt,0.00032240381043522476,4,0,4
1985,1985,testString,0.00032240381043522476,4,0,4
1986,1986,toHaveProperty,0.00032240381043522476,4,0,4
1987,1987,trim,0.00032240381043522476,4,0,4
1988,1988,zeroState,0.00032240381043522476,4,0,4
1989,1989,after,0.00032240381043522454,4,0,4
1990,1990,in,0.00032240381043522454,4,0,4
1991,1991,"""stylesheet""",0.00032240381043522454,4,0,4
1992,1992,'collapsed',0.00032240381043522454,4,0,4
1993,1993,'focus',0.00032240381043522454,4,0,4
1994,1994,'foobar',0.00032240381043522454,4,0,4
1995,1995,'sample',0.00032240381043522454,4,0,4
1996,1996,MachineContext,0.00032240381043522454,4,0,4
1997,1997,configResult,0.00032240381043522454,4,0,4
1998,1998,elements,0.00032240381043522454,4,0,4
1999,1999,noscript,0.00032240381043522454,4,0,4
2000,2000,observe,0.00032240381043522454,4,0,4
2001,2001,param,0.00032240381043522454,4,0,4
2002,2002,pathExists,0.00032240381043522454,4,0,4
2003,2003,rootDir,0.00032240381043522454,4,0,4
2004,2004,toggleService,0.00032240381043522454,4,0,4
2005,2005,'#pathname',0.0003224038104352243,4,0,4
2006,2006,'#query',0.0003224038104352243,4,0,4
2007,2007,'hello',0.0003224038104352243,4,0,4
2008,2008,className,0.0003224038104352243,4,0,4
2009,2009,"""flow""",0.0003224038104352243,4,0,4
2010,2010,"""http://localhost/style.css""",0.0003224038104352243,4,0,4
2011,2011,"""observable.ref""",0.0003224038104352243,4,0,4
2012,2012,"""observable.shallow""",0.0003224038104352243,4,0,4
2013,2013,"""parent""",0.0003224038104352243,4,0,4
2014,2014,"""report-end""",0.0003224038104352243,4,0,4
2015,2015,'#__NEXT_DATA__',0.0003224038104352243,4,0,4
2016,2016,'#inc',0.0003224038104352243,4,0,4
2017,2017,'#not-found-component',0.0003224038104352243,4,0,4
2018,2018,'/test.png',0.0003224038104352243,4,0,4
2019,2019,'BAZ',0.0003224038104352243,4,0,4
2020,2020,'DEC',0.0003224038104352243,4,0,4
2021,2021,'POWER',0.0003224038104352243,4,0,4
2022,2022,'RAISED',0.0003224038104352243,4,0,4
2023,2023,'SOME_EVENT',0.0003224038104352243,4,0,4
2024,2024,'UPDATE_AGE',0.0003224038104352243,4,0,4
2025,2025,'UPDATE_NAME',0.0003224038104352243,4,0,4
2026,2026,'bar1',0.0003224038104352243,4,0,4
2027,2027,'counting',0.0003224038104352243,4,0,4
2028,2028,'eager',0.0003224038104352243,4,0,4
2029,2029,'focusin',0.0003224038104352243,4,0,4
2030,2030,'foo-child',0.0003224038104352243,4,0,4
2031,2031,'meta',0.0003224038104352243,4,0,4
2032,2032,'middleware-rewrite',0.0003224038104352243,4,0,4
2033,2033,'next/dist/compiled/@next/react-refresh-utils/dist/loader',0.0003224038104352243,4,0,4
2034,2034,'noscript',0.0003224038104352243,4,0,4
2035,2035,'size-adjust',0.0003224038104352243,4,0,4
2036,2036,'sizes',0.0003224038104352243,4,0,4
2037,2037,/hello.*?world/,0.0003224038104352243,4,0,4
2038,2038,BAR,0.0003224038104352243,4,0,4
2039,2039,Cookie,0.0003224038104352243,4,0,4
2040,2040,Event,0.0003224038104352243,4,0,4
2041,2041,FOO,0.0003224038104352243,4,0,4
2042,2042,Image,0.0003224038104352243,4,0,4
2043,2043,_directionToOrder,0.0003224038104352243,4,0,4
2044,2044,_styleguidist,0.0003224038104352243,4,0,4
2045,2045,`start ${,0.0003224038104352243,4,0,4
2046,2046,`stop ${,0.0003224038104352243,4,0,4
2047,2047,acceptState,0.0003224038104352243,4,0,4
2048,2048,actorRef,0.0003224038104352243,4,0,4
2049,2049,appProps,0.0003224038104352243,4,0,4
2050,2050,arguments,0.0003224038104352243,4,0,4
2051,2051,callbackMachine,0.0003224038104352243,4,0,4
2052,2052,clickSpy,0.0003224038104352243,4,0,4
2053,2053,compiler,0.0003224038104352243,4,0,4
2054,2054,cookie,0.0003224038104352243,4,0,4
2055,2055,createScriptElement,0.0003224038104352243,4,0,4
2056,2056,curUrl,0.0003224038104352243,4,0,4
2057,2057,d1,0.0003224038104352243,4,0,4
2058,2058,d2,0.0003224038104352243,4,0,4
2059,2059,delayExprMachine,0.0003224038104352243,4,0,4
2060,2060,didPartialPrefetch,0.0003224038104352243,4,0,4
2061,2061,dropdownToggle,0.0003224038104352243,4,0,4
2062,2062,dynamicMachine,0.0003224038104352243,4,0,4
2063,2063,effect,0.0003224038104352243,4,0,4
2064,2064,emitPopsStateEvent,0.0003224038104352243,4,0,4
2065,2065,exampleMarkdown,0.0003224038104352243,4,0,4
2066,2066,expectDone,0.0003224038104352243,4,0,4
2067,2067,expectEnd,0.0003224038104352243,4,0,4
2068,2068,experiments,0.0003224038104352243,4,0,4
2069,2069,filteredTags,0.0003224038104352243,4,0,4
2070,2070,fixtureState,0.0003224038104352243,4,0,4
2071,2071,focusInListener,0.0003224038104352243,4,0,4
2072,2072,fooService,0.0003224038104352243,4,0,4
2073,2073,getPathname,0.0003224038104352243,4,0,4
2074,2074,getPrototypeOf,0.0003224038104352243,4,0,4
2075,2075,hotModuleReplacementPlugin,0.0003224038104352243,4,0,4
2076,2076,hrefs,0.0003224038104352243,4,0,4
2077,2077,htmlWebpackPlugin,0.0003224038104352243,4,0,4
2078,2078,idMachine,0.0003224038104352243,4,0,4
2079,2079,insideFocusable,0.0003224038104352243,4,0,4
2080,2080,isFallback,0.0003224038104352243,4,0,4
2081,2081,isNextDeploy,0.0003224038104352243,4,0,4
2082,2082,isObservableObject,0.0003224038104352243,4,0,4
2083,2083,item2,0.0003224038104352243,4,0,4
2084,2084,mainMachine,0.0003224038104352243,4,0,4
2085,2085,multiplier,0.0003224038104352243,4,0,4
2086,2086,notFound,0.0003224038104352243,4,0,4
2087,2087,object,0.0003224038104352243,4,0,4
2088,2088,offState,0.0003224038104352243,4,0,4
2089,2089,overflowY,0.0003224038104352243,4,0,4
2090,2090,popperConfig,0.0003224038104352243,4,0,4
2091,2091,regexp,0.0003224038104352243,4,0,4
2092,2092,relatedTarget,0.0003224038104352243,4,0,4
2093,2093,renderToString,0.0003224038104352243,4,0,4
2094,2094,restoredState,0.0003224038104352243,4,0,4
2095,2095,sameState,0.0003224038104352243,4,0,4
2096,2096,searchTerm,0.0003224038104352243,4,0,4
2097,2097,some,0.0003224038104352243,4,0,4
2098,2098,split,0.0003224038104352243,4,0,4
2099,2099,spyFocus1,0.0003224038104352243,4,0,4
2100,2100,spyFocus2,0.0003224038104352243,4,0,4
2101,2101,spyReportEnd,0.0003224038104352243,4,0,4
2102,2102,spyReportStart,0.0003224038104352243,4,0,4
2103,2103,stderr,0.0003224038104352243,4,0,4
2104,2104,step,0.0003224038104352243,4,0,4
2105,2105,stream,0.0003224038104352243,4,0,4
2106,2106,tab1,0.0003224038104352243,4,0,4
2107,2107,tab2,0.0003224038104352243,4,0,4
2108,2108,tabEl2,0.0003224038104352243,4,0,4
2109,2109,toMatchSnapshot,0.0003224038104352243,4,0,4
2110,2110,v1,0.0003224038104352243,4,0,4
2111,2111,v2,0.0003224038104352243,4,0,4
2112,2112,requestAnimationFrame,0.00025917178589579884,47,32,15
2113,2113,"""""",0.00024178339449309853,3,0,3
2114,2114,'mouseout',0.00024178339449309853,3,0,3
2115,2115,'top',0.00024178339449309853,3,0,3
2116,2116,'window.location.pathname',0.00024178339449309853,3,0,3
2117,2117,Error,0.00024178339449309853,3,0,3
2118,2118,RegExp,0.00024178339449309853,3,0,3
2119,2119,delete,0.00024178339449309853,3,0,3
2120,2120,hasRedbox,0.00024178339449309853,3,0,3
2121,2121,list,0.00024178339449309853,3,0,3
2122,2122,toBeFalsy,0.00024178339449309853,3,0,3
2123,2123,"""Inner description""",0.00024178339449309853,3,0,3
2124,2124,"""Test description""",0.00024178339449309853,3,0,3
2125,2125,"""b""",0.00024178339449309853,3,0,3
2126,2126,"""http://localhost/helmet""",0.00024178339449309853,3,0,3
2127,2127,"""http://localhost/helmet/component""",0.00024178339449309853,3,0,3
2128,2128,"""http://localhost/helmet/innercomponent""",0.00024178339449309853,3,0,3
2129,2129,"""http://localhost/test.js""",0.00024178339449309853,3,0,3
2130,2130,"""utf-8""",0.00024178339449309853,3,0,3
2131,2131,$4,0.00024178339449309853,3,0,3
2132,2132,$appleIcon,0.00024178339449309853,3,0,3
2133,2133,"'  <div class=""item"">'",0.00024178339449309853,3,0,3
2134,2134,'#another',0.00024178339449309853,3,0,3
2135,2135,'#data-force-cache',0.00024178339449309853,3,0,3
2136,2136,'#data-no-cache',0.00024178339449309853,3,0,3
2137,2137,'#data-revalidate-cache',0.00024178339449309853,3,0,3
2138,2138,'#home',0.00024178339449309853,3,0,3
2139,2139,'#myCarousel',0.00024178339449309853,3,0,3
2140,2140,'#now',0.00024178339449309853,3,0,3
2141,2141,'#param',0.00024178339449309853,3,0,3
2142,2142,'#rand',0.00024178339449309853,3,0,3
2143,2143,'#result-page',0.00024178339449309853,3,0,3
2144,2144,'#timestamp',0.00024178339449309853,3,0,3
2145,2145,'#value-1',0.00024178339449309853,3,0,3
2146,2146,'.btn',0.00024178339449309853,3,0,3
2147,2147,'.test',0.00024178339449309853,3,0,3
2148,2148,'.tooltip-inner',0.00024178339449309853,3,0,3
2149,2149,'/variable-revalidate/post-method',0.00024178339449309853,3,0,3
2150,2150,'/variable-revalidate/revalidate-3',0.00024178339449309853,3,0,3
2151,2151,'A1',0.00024178339449309853,3,0,3
2152,2152,'ANOTHER_EVENT',0.00024178339449309853,3,0,3
2153,2153,'Anyone',0.00024178339449309853,3,0,3
2154,2154,'B2',0.00024178339449309853,3,0,3
2155,2155,'COUNT',0.00024178339449309853,3,0,3
2156,2156,'Dashboard/index.fixture.js',0.00024178339449309853,3,0,3
2157,2157,'EV',0.00024178339449309853,3,0,3
2158,2158,'EXISTING.DONE',0.00024178339449309853,3,0,3
2159,2159,"'[href=""/""]'",0.00024178339449309853,3,0,3
2160,2160,'b.b1',0.00024178339449309853,3,0,3
2161,2161,'childActor',0.00024178339449309853,3,0,3
2162,2162,'edge-light',0.00024178339449309853,3,0,3
2163,2163,'en-GB',0.00024178339449309853,3,0,3
2164,2164,'foo.com',0.00024178339449309853,3,0,3
2165,2165,'foo2',0.00024178339449309853,3,0,3
2166,2166,'from-middleware',0.00024178339449309853,3,0,3
2167,2167,'haha',0.00024178339449309853,3,0,3
2168,2168,'hehe',0.00024178339449309853,3,0,3
2169,2169,'keyup',0.00024178339449309853,3,0,3
2170,2170,"'link[rel=""preconnect""]'",0.00024178339449309853,3,0,3
2171,2171,'lol',0.00024178339449309853,3,0,3
2172,2172,'mockRendererId',0.00024178339449309853,3,0,3
2173,2173,'multiFixture',0.00024178339449309853,3,0,3
2174,2174,'off',0.00024178339449309853,3,0,3
2175,2175,'on',0.00024178339449309853,3,0,3
2176,2176,'oops',0.00024178339449309853,3,0,3
2177,2177,'pong',0.00024178339449309853,3,0,3
2178,2178,'post-1',0.00024178339449309853,3,0,3
2179,2179,'preact/compat',0.00024178339449309853,3,0,3
2180,2180,'prop1',0.00024178339449309853,3,0,3
2181,2181,'prop2',0.00024178339449309853,3,0,3
2182,2182,'reset',0.00024178339449309853,3,0,3
2183,2183,'shown.bs.dropdown',0.00024178339449309853,3,0,3
2184,2184,'type',0.00024178339449309853,3,0,3
2185,2185,ActorRefFrom,0.00024178339449309853,3,0,3
2186,2186,Boolean,0.00024178339449309853,3,0,3
2187,2187,Clazz,0.00024178339449309853,3,0,3
2188,2188,E,0.00024178339449309853,3,0,3
2189,2189,EV,0.00024178339449309853,3,0,3
2190,2190,Manipulator,0.00024178339449309853,3,0,3
2191,2191,ScrollBarHelper,0.00024178339449309853,3,0,3
2192,2192,SectionHeadingRenderer,0.00024178339449309853,3,0,3
2193,2193,TabButtonRenderer,0.00024178339449309853,3,0,3
2194,2194,_arg,0.00024178339449309853,3,0,3
2195,2195,`/_next/data/${,0.00024178339449309853,3,0,3
2196,2196,`window.getComputedStyle(document.querySelector('h1')).color`,0.00024178339449309853,3,0,3
2197,2197,actionKey,0.00024178339449309853,3,0,3
2198,2198,actionTypes,0.00024178339449309853,3,0,3
2199,2199,activeState,0.00024178339449309853,3,0,3
2200,2200,addEventSpy,0.00024178339449309853,3,0,3
2201,2201,addedTags,0.00024178339449309853,3,0,3
2202,2202,assertDone,0.00024178339449309853,3,0,3
2203,2203,assignName,0.00024178339449309853,3,0,3
2204,2204,b1,0.00024178339449309853,3,0,3
2205,2205,bubbles,0.00024178339449309853,3,0,3
2206,2206,childActor,0.00024178339449309853,3,0,3
2207,2207,childContent,0.00024178339449309853,3,0,3
2208,2208,childRef,0.00024178339449309853,3,0,3
2209,2209,clearRequests,0.00024178339449309853,3,0,3
2210,2210,cookies,0.00024178339449309853,3,0,3
2211,2211,curRes,0.00024178339449309853,3,0,3
2212,2212,currentState,0.00024178339449309853,3,0,3
2213,2213,dataRes,0.00024178339449309853,3,0,3
2214,2214,defaultWebpackConfig,0.00024178339449309853,3,0,3
2215,2215,destDir,0.00024178339449309853,3,0,3
2216,2216,dir,0.00024178339449309853,3,0,3
2217,2217,doneSpy,0.00024178339449309853,3,0,3
2218,2218,dropupEl,0.00024178339449309853,3,0,3
2219,2219,element1,0.00024178339449309853,3,0,3
2220,2220,empty,0.00024178339449309853,3,0,3
2221,2221,errors,0.00024178339449309853,3,0,3
2222,2222,eventArg,0.00024178339449309853,3,0,3
2223,2223,eventReceived,0.00024178339449309853,3,0,3
2224,2224,exec,0.00024178339449309853,3,0,3
2225,2225,existingMachine,0.00024178339449309853,3,0,3
2226,2226,existingService,0.00024178339449309853,3,0,3
2227,2227,expectedScroll,0.00024178339449309853,3,0,3
2228,2228,expires,0.00024178339449309853,3,0,3
2229,2229,exposeImports,0.00024178339449309853,3,0,3
2230,2230,fakejQueryObject,0.00024178339449309853,3,0,3
2231,2231,firstID,0.00024178339449309853,3,0,3
2232,2232,firstTime,0.00024178339449309853,3,0,3
2233,2233,fixtureSelect,0.00024178339449309853,3,0,3
2234,2234,getDataAttribute,0.00024178339449309853,3,0,3
2235,2235,getItem,0.00024178339449309853,3,0,3
2236,2236,getServerSideProps,0.00024178339449309853,3,0,3
2237,2237,getSnapshot,0.00024178339449309853,3,0,3
2238,2238,grandchild,0.00024178339449309853,3,0,3
2239,2239,hasElementByCssSelector,0.00024178339449309853,3,0,3
2240,2240,host,0.00024178339449309853,3,0,3
2241,2241,html4,0.00024178339449309853,3,0,3
2242,2242,htmlAttributes,0.00024178339449309853,3,0,3
2243,2243,isNextDev,0.00024178339449309853,3,0,3
2244,2244,keyDownEsc,0.00024178339449309853,3,0,3
2245,2245,loadCache,0.00024178339449309853,3,0,3
2246,2246,loading,0.00024178339449309853,3,0,3
2247,2247,maxAge,0.00024178339449309853,3,0,3
2248,2248,media,0.00024178339449309853,3,0,3
2249,2249,mouseOutEvent,0.00024178339449309853,3,0,3
2250,2250,names,0.00024178339449309853,3,0,3
2251,2251,newCode,0.00024178339449309853,3,0,3
2252,2252,newTimestamp,0.00024178339449309853,3,0,3
2253,2253,obsMachine,0.00024178339449309853,3,0,3
2254,2254,onSecondState,0.00024178339449309853,3,0,3
2255,2255,origin,0.00024178339449309853,3,0,3
2256,2256,originalContent,0.00024178339449309853,3,0,3
2257,2257,originalSource,0.00024178339449309853,3,0,3
2258,2258,other,0.00024178339449309853,3,0,3
2259,2259,parentService,0.00024178339449309853,3,0,3
2260,2260,pingMachine,0.00024178339449309853,3,0,3
2261,2261,pongCounter,0.00024178339449309853,3,0,3
2262,2262,public,0.00024178339449309853,3,0,3
2263,2263,redWalkState,0.00024178339449309853,3,0,3
2264,2264,rej,0.00024178339449309853,3,0,3
2265,2265,removeEventSpy,0.00024178339449309853,3,0,3
2266,2266,rendererId,0.00024178339449309853,3,0,3
2267,2267,resolvedState,0.00024178339449309853,3,0,3
2268,2268,router,0.00024178339449309853,3,0,3
2269,2269,routes,0.00024178339449309853,3,0,3
2270,2270,secondID,0.00024178339449309853,3,0,3
2271,2271,secondNavEl,0.00024178339449309853,3,0,3
2272,2272,secondTab,0.00024178339449309853,3,0,3
2273,2273,sendActions,0.00024178339449309853,3,0,3
2274,2274,sendParent,0.00024178339449309853,3,0,3
2275,2275,sep,0.00024178339449309853,3,0,3
2276,2276,seq,0.00024178339449309853,3,0,3
2277,2277,setItem,0.00024178339449309853,3,0,3
2278,2278,shared,0.00024178339449309853,3,0,3
2279,2279,someParentMachine,0.00024178339449309853,3,0,3
2280,2280,spyFocus3,0.00024178339449309853,3,0,3
2281,2281,spyGet,0.00024178339449309853,3,0,3
2282,2282,spyPrevent,0.00024178339449309853,3,0,3
2283,2283,spyReset,0.00024178339449309853,3,0,3
2284,2284,spyStop,0.00024178339449309853,3,0,3
2285,2285,ssg,0.00024178339449309853,3,0,3
2286,2286,ssr,0.00024178339449309853,3,0,3
2287,2287,startMachine,0.00024178339449309853,3,0,3
2288,2288,stop,0.00024178339449309853,3,0,3
2289,2289,stringContaining,0.00024178339449309853,3,0,3
2290,2290,styleSheet,0.00024178339449309853,3,0,3
2291,2291,t1,0.00024178339449309853,3,0,3
2292,2292,tab3,0.00024178339449309853,3,0,3
2293,2293,tempState,0.00024178339449309853,3,0,3
2294,2294,testBool,0.00024178339449309853,3,0,3
2295,2295,timestamp,0.00024178339449309853,3,0,3
2296,2296,titleComponent,0.00024178339449309853,3,0,3
2297,2297,triggerTwo,0.00024178339449309853,3,0,3
2298,2298,two,0.00024178339449309853,3,0,3
2299,2299,uniqOpt,0.00024178339449309853,3,0,3
2300,2300,variable,0.00024178339449309853,3,0,3
2301,2301,warning,0.00024178339449309853,3,0,3
2302,2302,'POST',0.00024178339449309832,3,0,3
2303,2303,display,0.00024178339449309832,3,0,3
2304,2304,history,0.00024178339449309832,3,0,3
2305,2305,isDev,0.00024178339449309832,3,0,3
2306,2306,locale,0.00024178339449309832,3,0,3
2307,2307,querySelectorAll,0.00024178339449309832,3,0,3
2308,2308,"""a""",0.00024178339449309832,3,0,3
2309,2309,"'  <li class=""nav-item"" role=""presentation"">'",0.00024178339449309832,3,0,3
2310,2310,'#app-page',0.00024178339449309832,3,0,3
2311,2311,'#data',0.00024178339449309832,3,0,3
2312,2312,'#data-revalidate-and-fetch-cache',0.00024178339449309832,3,0,3
2313,2313,'#date',0.00024178339449309832,3,0,3
2314,2314,'#error-boundary-message',0.00024178339449309832,3,0,3
2315,2315,'/another',0.00024178339449309832,3,0,3
2316,2316,'/blog/post-1',0.00024178339449309832,3,0,3
2317,2317,'/root',0.00024178339449309832,3,0,3
2318,2318,'400',0.00024178339449309832,3,0,3
2319,2319,'ACTIVATE',0.00024178339449309832,3,0,3
2320,2320,'en-US',0.00024178339449309832,3,0,3
2321,2321,'es',0.00024178339449309832,3,0,3
2322,2322,'false',0.00024178339449309832,3,0,3
2323,2323,'found',0.00024178339449309832,3,0,3
2324,2324,'fr',0.00024178339449309832,3,0,3
2325,2325,'location.search',0.00024178339449309832,3,0,3
2326,2326,'my_name',0.00024178339449309832,3,0,3
2327,2327,'package.json',0.00024178339449309832,3,0,3
2328,2328,'skipTrailingSlashRedirect',0.00024178339449309832,3,0,3
2329,2329,'something',0.00024178339449309832,3,0,3
2330,2330,'updateName',0.00024178339449309832,3,0,3
2331,2331,DummyClass2,0.00024178339449309832,3,0,3
2332,2332,MyClass,0.00024178339449309832,3,0,3
2333,2333,NextResponse,0.00024178339449309832,3,0,3
2334,2334,TContext,0.00024178339449309832,3,0,3
2335,2335,TestContext,0.00024178339449309832,3,0,3
2336,2336,_backdrop,0.00024178339449309832,3,0,3
2337,2337,`JSON.stringify(next.router.query)`,0.00024178339449309832,3,0,3
2338,2338,`next.router.pathname`,0.00024178339449309832,3,0,3
2339,2339,acceptMachineOptions,0.00024178339449309832,3,0,3
2340,2340,actionBound,0.00024178339449309832,3,0,3
2341,2341,addContextDependency,0.00024178339449309832,3,0,3
2342,2342,always,0.00024178339449309832,3,0,3
2343,2343,baz,0.00024178339449309832,3,0,3
2344,2344,captured,0.00024178339449309832,3,0,3
2345,2345,collapse2,0.00024178339449309832,3,0,3
2346,2346,cur$,0.00024178339449309832,3,0,3
2347,2347,curHtml,0.00024178339449309832,3,0,3
2348,2348,dataRoutes,0.00024178339449309832,3,0,3
2349,2349,defaultExample,0.00024178339449309832,3,0,3
2350,2350,differentMachine,0.00024178339449309832,3,0,3
2351,2351,div1,0.00024178339449309832,3,0,3
2352,2352,examplesFile,0.00024178339449309832,3,0,3
2353,2353,existingTag,0.00024178339449309832,3,0,3
2354,2354,expectDropdownToBeOpened,0.00024178339449309832,3,0,3
2355,2355,expectedArgs,0.00024178339449309832,3,0,3
2356,2356,extensions,0.00024178339449309832,3,0,3
2357,2357,fileMatcher,0.00024178339449309832,3,0,3
2358,2358,firstTab,0.00024178339449309832,3,0,3
2359,2359,getElementById,0.00024178339449309832,3,0,3
2360,2360,getMarginX,0.00024178339449309832,3,0,3
2361,2361,handler,0.00024178339449309832,3,0,3
2362,2362,hash,0.00024178339449309832,3,0,3
2363,2363,info,0.00024178339449309832,3,0,3
2364,2364,initialDate,0.00024178339449309832,3,0,3
2365,2365,initialJson,0.00024178339449309832,3,0,3
2366,2366,inside,0.00024178339449309832,3,0,3
2367,2367,keyup,0.00024178339449309832,3,0,3
2368,2368,makeProp,0.00024178339449309832,3,0,3
2369,2369,middleware,0.00024178339449309832,3,0,3
2370,2370,middlewareManifest,0.00024178339449309832,3,0,3
2371,2371,myCollapseEl,0.00024178339449309832,3,0,3
2372,2372,new$,0.00024178339449309832,3,0,3
2373,2373,newJson,0.00024178339449309832,3,0,3
2374,2374,newObj,0.00024178339449309832,3,0,3
2375,2375,nonce,0.00024178339449309832,3,0,3
2376,2376,onMessage,0.00024178339449309832,3,0,3
2377,2377,originalMargin,0.00024178339449309832,3,0,3
2378,2378,pathsToB,0.00024178339449309832,3,0,3
2379,2379,prev$,0.00024178339449309832,3,0,3
2380,2380,prevHtml,0.00024178339449309832,3,0,3
2381,2381,processedWorkerScripts,0.00024178339449309832,3,0,3
2382,2382,promises,0.00024178339449309832,3,0,3
2383,2383,reference,0.00024178339449309832,3,0,3
2384,2384,removedTags,0.00024178339449309832,3,0,3
2385,2385,resetState,0.00024178339449309832,3,0,3
2386,2386,scrollSpyEl,0.00024178339449309832,3,0,3
2387,2387,sequenceMachine,0.00024178339449309832,3,0,3
2388,2388,serverRef,0.00024178339449309832,3,0,3
2389,2389,staticPath,0.00024178339449309832,3,0,3
2390,2390,tabEl3,0.00024178339449309832,3,0,3
2391,2391,testString1,0.00024178339449309832,3,0,3
2392,2392,testedStateValues,0.00024178339449309832,3,0,3
2393,2393,todo2,0.00024178339449309832,3,0,3
2394,2394,trigger2,0.00024178339449309832,3,0,3
2395,2395,updatedState,0.00024178339449309832,3,0,3
2396,2396,objectContaining,0.000161175957017496,2,0,2
2397,2397,"""[0]""",0.000161175957017496,2,0,2
2398,2398,"""action.bound2""",0.000161175957017496,2,0,2
2399,2399,"""observable.ref2""",0.000161175957017496,2,0,2
2400,2400,"""observable.shallow2""",0.000161175957017496,2,0,2
2401,2401,"""x""",0.000161175957017496,2,0,2
2402,2402,'  <li></li>',0.000161175957017496,2,0,2
2403,2403,'#comment-1',0.000161175957017496,2,0,2
2404,2404,'#error-trigger-button',0.000161175957017496,2,0,2
2405,2405,'#hashJ',0.000161175957017496,2,0,2
2406,2406,'#pages-page',0.000161175957017496,2,0,2
2407,2407,'#value',0.000161175957017496,2,0,2
2408,2408,'-canary-',0.000161175957017496,2,0,2
2409,2409,'/blog/post-1?hello=world',0.000161175957017496,2,0,2
2410,2410,'/fallback-true-blog/[slug]',0.000161175957017496,2,0,2
2411,2411,'/ssr-forced',0.000161175957017496,2,0,2
2412,2412,'/variable-config-revalidate/revalidate-3',0.000161175957017496,2,0,2
2413,2413,'?fooH=barI',0.000161175957017496,2,0,2
2414,2414,'BACK',0.000161175957017496,2,0,2
2415,2415,'FAKE',0.000161175957017496,2,0,2
2416,2416,'FORWARD',0.000161175957017496,2,0,2
2417,2417,'H_POWER',0.000161175957017496,2,0,2
2418,2418,'Next.js App',0.000161175957017496,2,0,2
2419,2419,'SUBMIT',0.000161175957017496,2,0,2
2420,2420,"'[href=""/0?timeout=0""]'",0.000161175957017496,2,0,2
2421,2421,"'[href=""/1?timeout=1000""]'",0.000161175957017496,2,0,2
2422,2422,'abc123',0.000161175957017496,2,0,2
2423,2423,'alternate',0.000161175957017496,2,0,2
2424,2424,'className',0.000161175957017496,2,0,2
2425,2425,'code',0.000161175957017496,2,0,2
2426,2426,'ein.js',0.000161175957017496,2,0,2
2427,2427,'even',0.000161175957017496,2,0,2
2428,2428,'example.com',0.000161175957017496,2,0,2
2429,2429,'finished',0.000161175957017496,2,0,2
2430,2430,'foobar.namespace',0.000161175957017496,2,0,2
2431,2431,'foofoo.namespace',0.000161175957017496,2,0,2
2432,2432,'fooz',0.000161175957017496,2,0,2
2433,2433,'index page',0.000161175957017496,2,0,2
2434,2434,'navigation-supported',0.000161175957017496,2,0,2
2435,2435,'primitive',0.000161175957017496,2,0,2
2436,2436,'role',0.000161175957017496,2,0,2
2437,2437,'set-cookie',0.000161175957017496,2,0,2
2438,2438,'title',0.000161175957017496,2,0,2
2439,2439,'utf8',0.000161175957017496,2,0,2
2440,2440,'window.beforeNav',0.000161175957017496,2,0,2
2441,2441,'window.didTransition',0.000161175957017496,2,0,2
2442,2442,'x-nextjs-cache',0.000161175957017496,2,0,2
2443,2443,'xstate.init',0.000161175957017496,2,0,2
2444,2444,/^__className_.{6}$/,0.000161175957017496,2,0,2
2445,2445,/node_modules\/react\/cjs\/react\.production\.min\.js/,0.000161175957017496,2,0,2
2446,2446,/node_modules\/react\/index\.js/,0.000161175957017496,2,0,2
2447,2447,/node_modules\/react\/package\.json/,0.000161175957017496,2,0,2
2448,2448,/webpack-runtime\.js/,0.000161175957017496,2,0,2
2449,2449,12000,0.000161175957017496,2,0,2
2450,2450,BeginEvent,0.000161175957017496,2,0,2
2451,2451,FINISH,0.000161175957017496,2,0,2
2452,2452,Heading,0.000161175957017496,2,0,2
2453,2453,Map,0.000161175957017496,2,0,2
2454,2454,NextURL,0.000161175957017496,2,0,2
2455,2455,Order,0.000161175957017496,2,0,2
2456,2456,Swipe,0.000161175957017496,2,0,2
2457,2457,TIMER,0.000161175957017496,2,0,2
2458,2458,_context,0.000161175957017496,2,0,2
2459,2459,`^/_next/data/${,0.000161175957017496,2,0,2
2460,2460,`^\\/_next\\/data\\/${,0.000161175957017496,2,0,2
2461,2461,acceptLanguage,0.000161175957017496,2,0,2
2462,2462,activeId,0.000161175957017496,2,0,2
2463,2463,amount,0.000161175957017496,2,0,2
2464,2464,appPathsManifest,0.000161175957017496,2,0,2
2465,2465,arrayOrObservableArrayOf,0.000161175957017496,2,0,2
2466,2466,bodyAttributes,0.000161175957017496,2,0,2
2467,2467,choose,0.000161175957017496,2,0,2
2468,2468,collapseOne,0.000161175957017496,2,0,2
2469,2469,collapseTwo,0.000161175957017496,2,0,2
2470,2470,copiedMachine,0.000161175957017496,2,0,2
2471,2471,copy,0.000161175957017496,2,0,2
2472,2472,countBehavior,0.000161175957017496,2,0,2
2473,2473,cwd,0.000161175957017496,2,0,2
2474,2474,dataBody1,0.000161175957017496,2,0,2
2475,2475,dataBody2,0.000161175957017496,2,0,2
2476,2476,dataBody3,0.000161175957017496,2,0,2
2477,2477,dataRoute,0.000161175957017496,2,0,2
2478,2478,destination,0.000161175957017496,2,0,2
2479,2479,disposer,0.000161175957017496,2,0,2
2480,2480,div2,0.000161175957017496,2,0,2
2481,2481,dropdownMenu1,0.000161175957017496,2,0,2
2482,2482,dropdownMenu2,0.000161175957017496,2,0,2
2483,2483,dropdownToggle1,0.000161175957017496,2,0,2
2484,2484,dropdownToggle2,0.000161175957017496,2,0,2
2485,2485,editorConfig,0.000161175957017496,2,0,2
2486,2486,expectedLogCalls,0.000161175957017496,2,0,2
2487,2487,expectedMargin,0.000161175957017496,2,0,2
2488,2488,fallback,0.000161175957017496,2,0,2
2489,2489,fileName,0.000161175957017496,2,0,2
2490,2490,finalMachine,0.000161175957017496,2,0,2
2491,2491,fixedEl,0.000161175957017496,2,0,2
2492,2492,flushMessages,0.000161175957017496,2,0,2
2493,2493,fontStyle,0.000161175957017496,2,0,2
2494,2494,fullname,0.000161175957017496,2,0,2
2495,2495,getCall,0.000161175957017496,2,0,2
2496,2496,getClassNameRegex,0.000161175957017496,2,0,2
2497,2497,greenNode,0.000161175957017496,2,0,2
2498,2498,hasAttribute,0.000161175957017496,2,0,2
2499,2499,hasFile,0.000161175957017496,2,0,2
2500,2500,hasTag,0.000161175957017496,2,0,2
2501,2501,hashRegex,0.000161175957017496,2,0,2
2502,2502,highlightTheme,0.000161175957017496,2,0,2
2503,2503,iframeMock,0.000161175957017496,2,0,2
2504,2504,img,0.000161175957017496,2,0,2
2505,2505,init,0.000161175957017496,2,0,2
2506,2506,initialContext,0.000161175957017496,2,0,2
2507,2507,intervalService,0.000161175957017496,2,0,2
2508,2508,invokeCount,0.000161175957017496,2,0,2
2509,2509,isAppRouterPage,0.000161175957017496,2,0,2
2510,2510,isSelected,0.000161175957017496,2,0,2
2511,2511,item1,0.000161175957017496,2,0,2
2512,2512,lastname,0.000161175957017496,2,0,2
2513,2513,lightFSM,0.000161175957017496,2,0,2
2514,2514,linkTags,0.000161175957017496,2,0,2
2515,2515,metaTags,0.000161175957017496,2,0,2
2516,2516,navEl,0.000161175957017496,2,0,2
2517,2517,newArray,0.000161175957017496,2,0,2
2518,2518,newerRes,0.000161175957017496,2,0,2
2519,2519,notEqual,0.000161175957017496,2,0,2
2520,2520,notTests,0.000161175957017496,2,0,2
2521,2521,onError,0.000161175957017496,2,0,2
2522,2522,orders,0.000161175957017496,2,0,2
2523,2523,outer,0.000161175957017496,2,0,2
2524,2524,p1,0.000161175957017496,2,0,2
2525,2525,pageFile,0.000161175957017496,2,0,2
2526,2526,parents,0.000161175957017496,2,0,2
2527,2527,parsed,0.000161175957017496,2,0,2
2528,2528,pathToB,0.000161175957017496,2,0,2
2529,2529,pongBehavior,0.000161175957017496,2,0,2
2530,2530,promiseRef,0.000161175957017496,2,0,2
2531,2531,protocol,0.000161175957017496,2,0,2
2532,2532,proxy,0.000161175957017496,2,0,2
2533,2533,publicUrl,0.000161175957017496,2,0,2
2534,2534,red,0.000161175957017496,2,0,2
2535,2535,resPages$,0.000161175957017496,2,0,2
2536,2536,routeRegex,0.000161175957017496,2,0,2
2537,2537,search,0.000161175957017496,2,0,2
2538,2538,searchParams,0.000161175957017496,2,0,2
2539,2539,secondHtml,0.000161175957017496,2,0,2
2540,2540,secondTabTrigger,0.000161175957017496,2,0,2
2541,2541,secret,0.000161175957017496,2,0,2
2542,2542,sendBack,0.000161175957017496,2,0,2
2543,2543,sizes,0.000161175957017496,2,0,2
2544,2544,sn,0.000161175957017496,2,0,2
2545,2545,spyKeydown,0.000161175957017496,2,0,2
2546,2546,spySlide,0.000161175957017496,2,0,2
2547,2547,srcDir,0.000161175957017496,2,0,2
2548,2548,stateCount,0.000161175957017496,2,0,2
2549,2549,stateEl,0.000161175957017496,2,0,2
2550,2550,stickyEl,0.000161175957017496,2,0,2
2551,2551,stickyTopEl,0.000161175957017496,2,0,2
2552,2552,stopState,0.000161175957017496,2,0,2
2553,2553,storageKey,0.000161175957017496,2,0,2
2554,2554,stored,0.000161175957017496,2,0,2
2555,2555,styleSheetPadding,0.000161175957017496,2,0,2
2556,2556,stylesheet,0.000161175957017496,2,0,2
2557,2557,suffix,0.000161175957017496,2,0,2
2558,2558,t2,0.000161175957017496,2,0,2
2559,2559,tabEl4,0.000161175957017496,2,0,2
2560,2560,testDir,0.000161175957017496,2,0,2
2561,2561,tests,0.000161175957017496,2,0,2
2562,2562,thirdTag,0.000161175957017496,2,0,2
2563,2563,toJSON,0.000161175957017496,2,0,2
2564,2564,toLowerCase,0.000161175957017496,2,0,2
2565,2565,toThrowError,0.000161175957017496,2,0,2
2566,2566,tooltip2,0.000161175957017496,2,0,2
2567,2567,triggerEl,0.000161175957017496,2,0,2
2568,2568,twitterImageUrl,0.000161175957017496,2,0,2
2569,2569,typeCheckPass,0.000161175957017496,2,0,2
2570,2570,updateExample,0.000161175957017496,2,0,2
2571,2571,waitState,0.000161175957017496,2,0,2
2572,2572,webpackConfig,0.000161175957017496,2,0,2
2573,2573,yellowState,0.000161175957017496,2,0,2
2574,2574,'/0',0.0001611759570174958,2,0,2
2575,2575,'/hello',0.0001611759570174958,2,0,2
2576,2576,'\n',0.0001611759570174958,2,0,2
2577,2577,'blur',0.0001611759570174958,2,0,2
2578,2578,'hidden',0.0001611759570174958,2,0,2
2579,2579,57,0.0001611759570174958,2,0,2
2580,2580,List,0.0001611759570174958,2,0,2
2581,2581,filter,0.0001611759570174958,2,0,2
2582,2582,isVisible,0.0001611759570174958,2,0,2
2583,2583,reset,0.0001611759570174958,2,0,2
2584,2584,}px`,0.0001611759570174958,2,0,2
2585,2585,"""action2""",0.0001611759570174958,2,0,2
2586,2586,"""add""",0.0001611759570174958,2,0,2
2587,2587,"""all""",0.0001611759570174958,2,0,2
2588,2588,"""body tag""",0.0001611759570174958,2,0,2
2589,2589,"""body-tag""",0.0001611759570174958,2,0,2
2590,2590,"""child of """,0.0001611759570174958,2,0,2
2591,2591,"""child of parent""",0.0001611759570174958,2,0,2
2592,2592,"""child""",0.0001611759570174958,2,0,2
2593,2593,"""flow2""",0.0001611759570174958,2,0,2
2594,2594,"""hidden""",0.0001611759570174958,2,0,2
2595,2595,"""html tag""",0.0001611759570174958,2,0,2
2596,2596,"""html-tag""",0.0001611759570174958,2,0,2
2597,2597,"""http://localhost/inner.css""",0.0001611759570174958,2,0,2
2598,2598,"""http://localhost/test2.js""",0.0001611759570174958,2,0,2
2599,2599,"""http://mysite.com/""",0.0001611759570174958,2,0,2
2600,2600,"""lang""",0.0001611759570174958,2,0,2
2601,2601,"""m2""",0.0001611759570174958,2,0,2
2602,2602,"""media""",0.0001611759570174958,2,0,2
2603,2603,"""myClassName""",0.0001611759570174958,2,0,2
2604,2604,"""observable2""",0.0001611759570174958,2,0,2
2605,2605,"""src""",0.0001611759570174958,2,0,2
2606,2606,"""zoem zoem""",0.0001611759570174958,2,0,2
2607,2607,$1,0.0001611759570174958,2,0,2
2608,2608,$3,0.0001611759570174958,2,0,2
2609,2609,$lazy,0.0001611759570174958,2,0,2
2610,2610,"'    <a class=""dropdown-item"" href=""#"">Dropdown item</a>'",0.0001611759570174958,2,0,2
2611,2611,"'  <div class=""dropdown-menu"">'",0.0001611759570174958,2,0,2
2612,2612,'#a-page',0.0001611759570174958,2,0,2
2613,2613,'#anotherTime',0.0001611759570174958,2,0,2
2614,2614,'#as-path',0.0001611759570174958,2,0,2
2615,2615,'#authed',0.0001611759570174958,2,0,2
2616,2616,'#data-auto-cache',0.0001611759570174958,2,0,2
2617,2617,'#data-body1',0.0001611759570174958,2,0,2
2618,2618,'#data-body2',0.0001611759570174958,2,0,2
2619,2619,'#data-body3',0.0001611759570174958,2,0,2
2620,2620,'#fff',0.0001611759570174958,2,0,2
2621,2621,'#from-dashboard',0.0001611759570174958,2,0,2
2622,2622,'#homepage',0.0001611759570174958,2,0,2
2623,2623,'#layout-now',0.0001611759570174958,2,0,2
2624,2624,'#link-to-app',0.0001611759570174958,2,0,2
2625,2625,'#link-to-pages',0.0001611759570174958,2,0,2
2626,2626,'#loading',0.0001611759570174958,2,0,2
2627,2627,'#new',0.0001611759570174958,2,0,2
2628,2628,'#normal-text',0.0001611759570174958,2,0,2
2629,2629,'#override-with-internal-rewrite',0.0001611759570174958,2,0,2
2630,2630,'#page-now',0.0001611759570174958,2,0,2
2631,2631,'#post-1',0.0001611759570174958,2,0,2
2632,2632,'#render-id-456',0.0001611759570174958,2,0,2
2633,2633,'#test',0.0001611759570174958,2,0,2
2634,2634,'.dropdown-menu.show',0.0001611759570174958,2,0,2
2635,2635,'/abc/',0.0001611759570174958,2,0,2
2636,2636,'/another/',0.0001611759570174958,2,0,2
2637,2637,'/api/edge',0.0001611759570174958,2,0,2
2638,2638,'/api/hello',0.0001611759570174958,2,0,2
2639,2639,'/blog/[slug]',0.0001611759570174958,2,0,2
2640,2640,'/fallback-true-blog/first',0.0001611759570174958,2,0,2
2641,2641,'/force-cache',0.0001611759570174958,2,0,2
2642,2642,'/intercepting-routes/feed/photos/1',0.0001611759570174958,2,0,2
2643,2643,'/large-page-data-ssr',0.0001611759570174958,2,0,2
2644,2644,'/middleware/path',0.0001611759570174958,2,0,2
2645,2645,'/path',0.0001611759570174958,2,0,2
2646,2646,'/rewritten-use-pathname',0.0001611759570174958,2,0,2
2647,2647,'/someF/pathG',0.0001611759570174958,2,0,2
2648,2648,'/test',0.0001611759570174958,2,0,2
2649,2649,'/variable-revalidate/authorization',0.0001611759570174958,2,0,2
2650,2650,'/variable-revalidate/cookie',0.0001611759570174958,2,0,2
2651,2651,'/variable-revalidate/encoding',0.0001611759570174958,2,0,2
2652,2652,'/variable-revalidate/revalidate-360-isr',0.0001611759570174958,2,0,2
2653,2653,'1.0.4',0.0001611759570174958,2,0,2
2654,2654,'100',0.0001611759570174958,2,0,2
2655,2655,'89.0.4389.90',0.0001611759570174958,2,0,2
2656,2656,"'<div class=""target""></div>'",0.0001611759570174958,2,0,2
2657,2657,'?',0.0001611759570174958,2,0,2
2658,2658,'A',0.0001611759570174958,2,0,2
2659,2659,'A.A2',0.0001611759570174958,2,0,2
2660,2660,'A4',0.0001611759570174958,2,0,2
2661,2661,'AboutA',0.0001611759570174958,2,0,2
2662,2662,'B4',0.0001611759570174958,2,0,2
2663,2663,'BEGIN',0.0001611759570174958,2,0,2
2664,2664,'Bye Cruel World',0.0001611759570174958,2,0,2
2665,2665,'C2',0.0001611759570174958,2,0,2
2666,2666,'CHANGE',0.0001611759570174958,2,0,2
2667,2667,'Dashboard',0.0001611759570174958,2,0,2
2668,2668,'Dashboard.fixture.js',0.0001611759570174958,2,0,2
2669,2669,'EVENT_WITH_FLAG',0.0001611759570174958,2,0,2
2670,2670,'Escape',0.0001611759570174958,2,0,2
2671,2671,'FINISH',0.0001611759570174958,2,0,2
2672,2672,'Hello World',0.0001611759570174958,2,0,2
2673,2673,'INCREMENT',0.0001611759570174958,2,0,2
2674,2674,'Image',0.0001611759570174958,2,0,2
2675,2675,'PING_CHILD',0.0001611759570174958,2,0,2
2676,2676,'PONG',0.0001611759570174958,2,0,2
2677,2677,'SUCCESS',0.0001611759570174958,2,0,2
2678,2678,'TO_THREE',0.0001611759570174958,2,0,2
2679,2679,'This page could not be found',0.0001611759570174958,2,0,2
2680,2680,'X-From-Middleware',0.0001611759570174958,2,0,2
2681,2681,'YourComponent',0.0001611759570174958,2,0,2
2682,2682,'abc',0.0001611759570174958,2,0,2
2683,2683,'app',0.0001611759570174958,2,0,2
2684,2684,'b1',0.0001611759570174958,2,0,2
2685,2685,'barValue',0.0001611759570174958,2,0,2
2686,2686,'barz',0.0001611759570174958,2,0,2
2687,2687,'bootstrap',0.0001611759570174958,2,0,2
2688,2688,'child got INCREMENT',0.0001611759570174958,2,0,2
2689,2689,'click.bs.scrollspy',0.0001611759570174958,2,0,2
2690,2690,'close',0.0001611759570174958,2,0,2
2691,2691,'custom',0.0001611759570174958,2,0,2
2692,2692,'data-bs-popper',0.0001611759570174958,2,0,2
2693,2693,'data-bs-target',0.0001611759570174958,2,0,2
2694,2694,'data-bs-test',0.0001611759570174958,2,0,2
2695,2695,'data:image/png;base64',0.0001611759570174958,2,0,2
2696,2696,'david',0.0001611759570174958,2,0,2
2697,2697,'different',0.0001611759570174958,2,0,2
2698,2698,'dynamic',0.0001611759570174958,2,0,2
2699,2699,'error.txt',0.0001611759570174958,2,0,2
2700,2700,'failed',0.0001611759570174958,2,0,2
2701,2701,'fallback',0.0001611759570174958,2,0,2
2702,2702,'fooAction',0.0001611759570174958,2,0,2
2703,2703,'hidden.bs.dropdown',0.0001611759570174958,2,0,2
2704,2704,'intermediate',0.0001611759570174958,2,0,2
2705,2705,'js',0.0001611759570174958,2,0,2
2706,2706,'loaded',0.0001611759570174958,2,0,2
2707,2707,'localhost',0.0001611759570174958,2,0,2
2708,2708,'now',0.0001611759570174958,2,0,2
2709,2709,'object',0.0001611759570174958,2,0,2
2710,2710,'parent got INCREMENT',0.0001611759570174958,2,0,2
2711,2711,'pending',0.0001611759570174958,2,0,2
2712,2712,'ponger',0.0001611759570174958,2,0,2
2713,2713,'prev',0.0001611759570174958,2,0,2
2714,2714,'react',0.0001611759570174958,2,0,2
2715,2715,'react-dom$',0.0001611759570174958,2,0,2
2716,2716,'root',0.0001611759570174958,2,0,2
2717,2717,'scroll',0.0001611759570174958,2,0,2
2718,2718,'server/edge-runtime-webpack.js',0.0001611759570174958,2,0,2
2719,2719,'showing',0.0001611759570174958,2,0,2
2720,2720,'shown.bs.tab',0.0001611759570174958,2,0,2
2721,2721,'src/myImports.ts',0.0001611759570174958,2,0,2
2722,2722,'src1',0.0001611759570174958,2,0,2
2723,2723,'start',0.0001611759570174958,2,0,2
2724,2724,'state b',0.0001611759570174958,2,0,2
2725,2725,'stately.ai',0.0001611759570174958,2,0,2
2726,2726,'stop',0.0001611759570174958,2,0,2
2727,2727,'transient',0.0001611759570174958,2,0,2
2728,2728,'ui/Dashboard.fixture.js',0.0001611759570174958,2,0,2
2729,2729,'ui/__fixtures__/Dashboard.js',0.0001611759570174958,2,0,2
2730,2730,'unit-image',0.0001611759570174958,2,0,2
2731,2731,'value',0.0001611759570174958,2,0,2
2732,2732,'variable',0.0001611759570174958,2,0,2
2733,2733,'web',0.0001611759570174958,2,0,2
2734,2734,'window.scrollY',0.0001611759570174958,2,0,2
2735,2735,'x-from-middleware',0.0001611759570174958,2,0,2
2736,2736,'x-nextjs-matched-path',0.0001611759570174958,2,0,2
2737,2737,'yup',0.0001611759570174958,2,0,2
2738,2738,'zwei.js',0.0001611759570174958,2,0,2
2739,2739,/(HIT|STALE)/,0.0001611759570174958,2,0,2
2740,2740,/.+/,0.0001611759570174958,2,0,2
2741,2741,/Welcome Page A/,0.0001611759570174958,2,0,2
2742,2742,/^\[MobX\] Cannot apply/,0.0001611759570174958,2,0,2
2743,2743,101,0.0001611759570174958,2,0,2
2744,2744,Bla,0.0001611759570174958,2,0,2
2745,2745,Blockquote,0.0001611759570174958,2,0,2
2746,2746,CHANGE,0.0001611759570174958,2,0,2
2747,2747,ChildAction,0.0001611759570174958,2,0,2
2748,2748,ChildComputed,0.0001611759570174958,2,0,2
2749,2749,ChildContext,0.0001611759570174958,2,0,2
2750,2750,ChildObservable,0.0001611759570174958,2,0,2
2751,2751,CodeRenderer,0.0001611759570174958,2,0,2
2752,2752,DelayExpMachineEvents,0.0001611759570174958,2,0,2
2753,2753,DelayExprMachineCtx,0.0001611759570174958,2,0,2
2754,2754,INCREMENT,0.0001611759570174958,2,0,2
2755,2755,IsolateButton,0.0001611759570174958,2,0,2
2756,2756,LinkRenderer,0.0001611759570174958,2,0,2
2757,2757,MessageRenderer,0.0001611759570174958,2,0,2
2758,2758,NameRenderer,0.0001611759570174958,2,0,2
2759,2759,ParaRenderer,0.0001611759570174958,2,0,2
2760,2760,PathlineRenderer,0.0001611759570174958,2,0,2
2761,2761,START,0.0001611759570174958,2,0,2
2762,2762,SWITCH,0.0001611759570174958,2,0,2
2763,2763,Section,0.0001611759570174958,2,0,2
2764,2764,Settings,0.0001611759570174958,2,0,2
2765,2765,SimulatedClock,0.0001611759570174958,2,0,2
2766,2766,State,0.0001611759570174958,2,0,2
2767,2767,TEvent,0.0001611759570174958,2,0,2
2768,2768,TO_C,0.0001611759570174958,2,0,2
2769,2769,TO_D,0.0001611759570174958,2,0,2
2770,2770,Tags,0.0001611759570174958,2,0,2
2771,2771,TestClass,0.0001611759570174958,2,0,2
2772,2772,Todo,0.0001611759570174958,2,0,2
2773,2773,UserContext,0.0001611759570174958,2,0,2
2774,2774,UserEvent,0.0001611759570174958,2,0,2
2775,2775,Wrapper,0.0001611759570174958,2,0,2
2776,2776,__filename,0.0001611759570174958,2,0,2
2777,2777,_menu,0.0001611759570174958,2,0,2
2778,2778,_orderToDirection,0.0001611759570174958,2,0,2
2779,2779,_slide,0.0001611759570174958,2,0,2
2780,2780,`/_next/static/${,0.0001611759570174958,2,0,2
2781,2781,`/about`,0.0001611759570174958,2,0,2
2782,2782,`node_modules\\${,0.0001611759570174958,2,0,2
2783,2783,absolutize,0.0001611759570174958,2,0,2
2784,2784,acceptMachine,0.0001611759570174958,2,0,2
2785,2785,acceptMachineContext,0.0001611759570174958,2,0,2
2786,2786,acceptMachineEvent,0.0001611759570174958,2,0,2
2787,2787,acceptTag,0.0001611759570174958,2,0,2
2788,2788,actorStateEl,0.0001611759570174958,2,0,2
2789,2789,addTwo,0.0001611759570174958,2,0,2
2790,2790,attrs,0.0001611759570174958,2,0,2
2791,2791,autorun,0.0001611759570174958,2,0,2
2792,2792,beforeRevalidate,0.0001611759570174958,2,0,2
2793,2793,blurDataURL,0.0001611759570174958,2,0,2
2794,2794,bypassToken,0.0001611759570174958,2,0,2
2795,2795,cCalcs,0.0001611759570174958,2,0,2
2796,2796,changes,0.0001611759570174958,2,0,2
2797,2797,checks,0.0001611759570174958,2,0,2
2798,2798,childContextTypes,0.0001611759570174958,2,0,2
2799,2799,childExitCalled,0.0001611759570174958,2,0,2
2800,2800,chineseTitle,0.0001611759570174958,2,0,2
2801,2801,circularStructure,0.0001611759570174958,2,0,2
2802,2802,cleanTree,0.0001611759570174958,2,0,2
2803,2803,client1,0.0001611759570174958,2,0,2
2804,2804,clientHtml,0.0001611759570174958,2,0,2
2805,2805,clients,0.0001611759570174958,2,0,2
2806,2806,collapse1,0.0001611759570174958,2,0,2
2807,2807,collapseTest1,0.0001611759570174958,2,0,2
2808,2808,completeCb,0.0001611759570174958,2,0,2
2809,2809,componentWrapper,0.0001611759570174958,2,0,2
2810,2810,configScript,0.0001611759570174958,2,0,2
2811,2811,consoleSpy,0.0001611759570174958,2,0,2
2812,2812,contentMissingIdProperty,0.0001611759570174958,2,0,2
2813,2813,contents,0.0001611759570174958,2,0,2
2814,2814,contextDependencies,0.0001611759570174958,2,0,2
2815,2815,countReducer,0.0001611759570174958,2,0,2
2816,2816,countedTo,0.0001611759570174958,2,0,2
2817,2817,createSingleState,0.0001611759570174958,2,0,2
2818,2818,curPage,0.0001611759570174958,2,0,2
2819,2819,curParams,0.0001611759570174958,2,0,2
2820,2820,curRandom,0.0001611759570174958,2,0,2
2821,2821,currentPadding1,0.0001611759570174958,2,0,2
2822,2822,customConfig,0.0001611759570174958,2,0,2
2823,2823,dCalcs,0.0001611759570174958,2,0,2
2824,2824,data1,0.0001611759570174958,2,0,2
2825,2825,data2,0.0001611759570174958,2,0,2
2826,2826,dataBody4,0.0001611759570174958,2,0,2
2827,2827,debug,0.0001611759570174958,2,0,2
2828,2828,deepLinkMessage,0.0001611759570174958,2,0,2
2829,2829,defaultValueOnTouchStart,0.0001611759570174958,2,0,2
2830,2830,delayExprService,0.0001611759570174958,2,0,2
2831,2831,deltaX,0.0001611759570174958,2,0,2
2832,2832,devtool,0.0001611759570174958,2,0,2
2833,2833,didReq,0.0001611759570174958,2,0,2
2834,2834,direction,0.0001611759570174958,2,0,2
2835,2835,dynamicRoutes,0.0001611759570174958,2,0,2
2836,2836,editedContent,0.0001611759570174958,2,0,2
2837,2837,elInstance,0.0001611759570174958,2,0,2
2838,2838,element3,0.0001611759570174958,2,0,2
2839,2839,elementLazy,0.0001611759570174958,2,0,2
2840,2840,elementsByCss,0.0001611759570174958,2,0,2
2841,2841,emit,0.0001611759570174958,2,0,2
2842,2842,encoded,0.0001611759570174958,2,0,2
2843,2843,entryActionCalled,0.0001611759570174958,2,0,2
2844,2844,eventsCount,0.0001611759570174958,2,0,2
2845,2845,examples,0.0001611759570174958,2,0,2
2846,2846,existingRef,0.0001611759570174958,2,0,2
2847,2847,exitCalled,0.0001611759570174958,2,0,2
2848,2848,expectedDone,0.0001611759570174958,2,0,2
2849,2849,expectedOrder,0.0001611759570174958,2,0,2
2850,2850,expectedPadding,0.0001611759570174958,2,0,2
2851,2851,expectedStateValue,0.0001611759570174958,2,0,2
2852,2852,experimental,0.0001611759570174958,2,0,2
2853,2853,failed,0.0001611759570174958,2,0,2
2854,2854,filename,0.0001611759570174958,2,0,2
2855,2855,first_name,0.0001611759570174958,2,0,2
2856,2856,firstname,0.0001611759570174958,2,0,2
2857,2857,fixtureUnselect,0.0001611759570174958,2,0,2
2858,2858,focusInEvent,0.0001611759570174958,2,0,2
2859,2859,fooAction,0.0001611759570174958,2,0,2
2860,2860,formMachine,0.0001611759570174958,2,0,2
2861,2861,getCwdPath,0.0001611759570174958,2,0,2
2862,2862,getMessageContents,0.0001611759570174958,2,0,2
2863,2863,getOffset,0.0001611759570174958,2,0,2
2864,2864,getOverFlow,0.0001611759570174958,2,0,2
2865,2865,getOverFlowAttr,0.0001611759570174958,2,0,2
2866,2866,getPage,0.0001611759570174958,2,0,2
2867,2867,getPathsFromEvents,0.0001611759570174958,2,0,2
2868,2868,getPopperConfig,0.0001611759570174958,2,0,2
2869,2869,getStaticProps,0.0001611759570174958,2,0,2
2870,2870,getWidth,0.0001611759570174958,2,0,2
2871,2871,goFromAnotherToHome,0.0001611759570174958,2,0,2
2872,2872,goFromHomeToAnother,0.0001611759570174958,2,0,2
2873,2873,guards,0.0001611759570174958,2,0,2
2874,2874,headerJson,0.0001611759570174958,2,0,2
2875,2875,hideListener,0.0001611759570174958,2,0,2
2876,2876,hidePreventedSpy,0.0001611759570174958,2,0,2
2877,2877,ids,0.0001611759570174958,2,0,2
2878,2878,iframe,0.0001611759570174958,2,0,2
2879,2879,imageTag,0.0001611759570174958,2,0,2
2880,2880,inactive,0.0001611759570174958,2,0,2
2881,2881,indexPage,0.0001611759570174958,2,0,2
2882,2882,initPageData,0.0001611759570174958,2,0,2
2883,2883,initRes,0.0001611759570174958,2,0,2
2884,2884,initialDelay,0.0001611759570174958,2,0,2
2885,2885,initialRandom,0.0001611759570174958,2,0,2
2886,2886,isComputedProp,0.0001611759570174958,2,0,2
2887,2887,jsonInitialState,0.0001611759570174958,2,0,2
2888,2888,keepAliveTimeout,0.0001611759570174958,2,0,2
2889,2889,keydownTab,0.0001611759570174958,2,0,2
2890,2890,keyupEscape,0.0001611759570174958,2,0,2
2891,2891,last_name,0.0001611759570174958,2,0,2
2892,2892,layoutNow,0.0001611759570174958,2,0,2
2893,2893,li,0.0001611759570174958,2,0,2
2894,2894,link1,0.0001611759570174958,2,0,2
2895,2895,link2,0.0001611759570174958,2,0,2
2896,2896,logAction,0.0001611759570174958,2,0,2
2897,2897,logMachine,0.0001611759570174958,2,0,2
2898,2898,m2,0.0001611759570174958,2,0,2
2899,2899,machineInvokeMachine,0.0001611759570174958,2,0,2
2900,2900,makeAutoObservable,0.0001611759570174958,2,0,2
2901,2901,manifestPath,0.0001611759570174958,2,0,2
2902,2902,matchHtml,0.0001611759570174958,2,0,2
2903,2903,middlewarePath,0.0001611759570174958,2,0,2
2904,2904,mouseDown,0.0001611759570174958,2,0,2
2905,2905,myDelay,0.0001611759570174958,2,0,2
2906,2906,nameEl,0.0001611759570174958,2,0,2
2907,2907,newData,0.0001611759570174958,2,0,2
2908,2908,newLoadingNumber,0.0001611759570174958,2,0,2
2909,2909,newPageData,0.0001611759570174958,2,0,2
2910,2910,newerHtml,0.0001611759570174958,2,0,2
2911,2911,nextEvents,0.0001611759570174958,2,0,2
2912,2912,nextTime,0.0001611759570174958,2,0,2
2913,2913,none,0.0001611759570174958,2,0,2
2914,2914,nothing,0.0001611759570174958,2,0,2
2915,2915,numbers,0.0001611759570174958,2,0,2
2916,2916,objWithArr,0.0001611759570174958,2,0,2
2917,2917,off,0.0001611759570174958,2,0,2
2918,2918,offSpy,0.0001611759570174958,2,0,2
2919,2919,offcanvasEl,0.0001611759570174958,2,0,2
2920,2920,offsetTop,0.0001611759570174958,2,0,2
2921,2921,onChangeClientState,0.0001611759570174958,2,0,2
2922,2922,onScrollStop,0.0001611759570174958,2,0,2
2923,2923,onSpy,0.0001611759570174958,2,0,2
2924,2924,oneListener,0.0001611759570174958,2,0,2
2925,2925,origPkgJson,0.0001611759570174958,2,0,2
2926,2926,originalOverFlow,0.0001611759570174958,2,0,2
2927,2927,outputAfterFetch,0.0001611759570174958,2,0,2
2928,2928,outputBeforeFetch,0.0001611759570174958,2,0,2
2929,2929,outside,0.0001611759570174958,2,0,2
2930,2930,outsideFocusable,0.0001611759570174958,2,0,2
2931,2931,pageBundle,0.0001611759570174958,2,0,2
2932,2932,pageExtensions,0.0001611759570174958,2,0,2
2933,2933,pageNow,0.0001611759570174958,2,0,2
2934,2934,parentKeyHandler,0.0001611759570174958,2,0,2
2935,2935,pg,0.0001611759570174958,2,0,2
2936,2936,ping,0.0001611759570174958,2,0,2
2937,2937,pingService,0.0001611759570174958,2,0,2
2938,2938,pkgJson,0.0001611759570174958,2,0,2
2939,2939,placeholder,0.0001611759570174958,2,0,2
2940,2940,plugin,0.0001611759570174958,2,0,2
2941,2941,policies,0.0001611759570174958,2,0,2
2942,2942,policy,0.0001611759570174958,2,0,2
2943,2943,popper,0.0001611759570174958,2,0,2
2944,2944,postRendererRequest,0.0001611759570174958,2,0,2
2945,2945,predictableActionArguments,0.0001611759570174958,2,0,2
2946,2946,preview,0.0001611759570174958,2,0,2
2947,2947,price,0.0001611759570174958,2,0,2
2948,2948,promiseBehavior,0.0001611759570174958,2,0,2
2949,2949,randomLoadingNumber,0.0001611759570174958,2,0,2
2950,2950,rawBody,0.0001611759570174958,2,0,2
2951,2951,readExportFile,0.0001611759570174958,2,0,2
2952,2952,receivedEvent,0.0001611759570174958,2,0,2
2953,2953,rects,0.0001611759570174958,2,0,2
2954,2954,redState,0.0001611759570174958,2,0,2
2955,2955,redWaitState,0.0001611759570174958,2,0,2
2956,2956,rejectPromise,0.0001611759570174958,2,0,2
2957,2957,rendererReadyRes,0.0001611759570174958,2,0,2
2958,2958,required,0.0001611759570174958,2,0,2
2959,2959,resData,0.0001611759570174958,2,0,2
2960,2960,resPage,0.0001611759570174958,2,0,2
2961,2961,resizeEvent,0.0001611759570174958,2,0,2
2962,2962,rootEl,0.0001611759570174958,2,0,2
2963,2963,routesManifest,0.0001611759570174958,2,0,2
2964,2964,running,0.0001611759570174958,2,0,2
2965,2965,sanitizeHtml,0.0001611759570174958,2,0,2
2966,2966,second$,0.0001611759570174958,2,0,2
2967,2967,secondDate,0.0001611759570174958,2,0,2
2968,2968,secondItemEl,0.0001611759570174958,2,0,2
2969,2969,secondRes,0.0001611759570174958,2,0,2
2970,2970,selectFixtureReq,0.0001611759570174958,2,0,2
2971,2971,selectorInstance,0.0001611759570174958,2,0,2
2972,2972,sendOtherButton,0.0001611759570174958,2,0,2
2973,2973,sendUpperButton,0.0001611759570174958,2,0,2
2974,2974,setAttribute,0.0001611759570174958,2,0,2
2975,2975,shouldMatch,0.0001611759570174958,2,0,2
2976,2976,shouldNotAppear,0.0001611759570174958,2,0,2
2977,2977,snapTime,0.0001611759570174958,2,0,2
2978,2978,snippetScript,0.0001611759570174958,2,0,2
2979,2979,someValue,0.0001611759570174958,2,0,2
2980,2980,spy1,0.0001611759570174958,2,0,2
2981,2981,spy3,0.0001611759570174958,2,0,2
2982,2982,spy4,0.0001611759570174958,2,0,2
2983,2983,spyDeactivate,0.0001611759570174958,2,0,2
2984,2984,spyEnable,0.0001611759570174958,2,0,2
2985,2985,spyFocus4,0.0001611759570174958,2,0,2
2986,2986,spyOff,0.0001611759570174958,2,0,2
2987,2987,spyShow1,0.0001611759570174958,2,0,2
2988,2988,spyShow2,0.0001611759570174958,2,0,2
2989,2989,spyTrigger,0.0001611759570174958,2,0,2
2990,2990,ssrMessage,0.0001611759570174958,2,0,2
2991,2991,ssrPagesReactVersions,0.0001611759570174958,2,0,2
2992,2992,state$,0.0001611759570174958,2,0,2
2993,2993,state2,0.0001611759570174958,2,0,2
2994,2994,state3,0.0001611759570174958,2,0,2
2995,2995,stateFromConfig,0.0001611759570174958,2,0,2
2996,2996,stateMachine,0.0001611759570174958,2,0,2
2997,2997,stopSpy,0.0001611759570174958,2,0,2
2998,2998,stopped,0.0001611759570174958,2,0,2
2999,2999,strProp,0.0001611759570174958,2,0,2
3000,3000,stylesCarousel,0.0001611759570174958,2,0,2
3001,3001,subscribed,0.0001611759570174958,2,0,2
3002,3002,succeeded,0.0001611759570174958,2,0,2
3003,3003,tab4,0.0001611759570174958,2,0,2
3004,3004,testInt2,0.0001611759570174958,2,0,2
3005,3005,text1,0.0001611759570174958,2,0,2
3006,3006,textb,0.0001611759570174958,2,0,2
3007,3007,threeState,0.0001611759570174958,2,0,2
3008,3008,times,0.0001611759570174958,2,0,2
3009,3009,toBuild,0.0001611759570174958,2,0,2
3010,3010,toggleModel,0.0001611759570174958,2,0,2
3011,3011,triggerDisabled,0.0001611759570174958,2,0,2
3012,3012,triggerDropdownFirst,0.0001611759570174958,2,0,2
3013,3013,triggerDropdownLast,0.0001611759570174958,2,0,2
3014,3014,triggerDropdownList,0.0001611759570174958,2,0,2
3015,3015,triggerList,0.0001611759570174958,2,0,2
3016,3016,uiPath,0.0001611759570174958,2,0,2
3017,3017,unknown,0.0001611759570174958,2,0,2
3018,3018,urlPropPage,0.0001611759570174958,2,0,2
3019,3019,validate,0.0001611759570174958,2,0,2
3020,3020,validateURL,0.0001611759570174958,2,0,2
3021,3021,value2,0.0001611759570174958,2,0,2
3022,3022,versionMachine,0.0001611759570174958,2,0,2
3023,3023,void,0.0001611759570174958,2,0,2
3024,3024,wakMachine,0.0001611759570174958,2,0,2
3025,3025,walkState,0.0001611759570174958,2,0,2
3026,3026,wasm,0.0001611759570174958,2,0,2
3027,3027,wordMachine,0.0001611759570174958,2,0,2
3028,3028,writeFileSync,0.0001611759570174958,2,0,2
3029,3029,wss,0.0001611759570174958,2,0,2
3030,3030,yield,0.0001611759570174958,2,0,2
3031,3031,}/_devMiddlewareManifest.json?foo=1`,0.0001611759570174958,2,0,2
3032,3032,}/hello`,0.0001611759570174958,2,0,2
3033,3033,}/other-page`,0.0001611759570174958,2,0,2
3034,3034,"
					",8.058149364163249e-05,1,0,1
3035,3035,"""bar""",8.058149364163249e-05,1,0,1
3036,3036,'#params',8.058149364163249e-05,1,0,1
3037,3037,'100px',8.058149364163249e-05,1,0,1
3038,3038,'ArrowUp',8.058149364163249e-05,1,0,1
3039,3039,'Closed',8.058149364163249e-05,1,0,1
3040,3040,'auto',8.058149364163249e-05,1,0,1
3041,3041,'button',8.058149364163249e-05,1,0,1
3042,3042,'data',8.058149364163249e-05,1,0,1
3043,3043,'name',8.058149364163249e-05,1,0,1
3044,3044,'no',8.058149364163249e-05,1,0,1
3045,3045,'none',8.058149364163249e-05,1,0,1
3046,3046,'number',8.058149364163249e-05,1,0,1
3047,3047,'span',8.058149364163249e-05,1,0,1
3048,3048,'string',8.058149364163249e-05,1,0,1
3049,3049,/This page could not be found/,8.058149364163249e-05,1,0,1
3050,3050,210,8.058149364163249e-05,1,0,1
3051,3051,app,8.058149364163249e-05,1,0,1
3052,3052,auto,8.058149364163249e-05,1,0,1
3053,3053,behavior,8.058149364163249e-05,1,0,1
3054,3054,columns,8.058149364163249e-05,1,0,1
3055,3055,contain,8.058149364163249e-05,1,0,1
3056,3056,d3,8.058149364163249e-05,1,0,1
3057,3057,deltaY,8.058149364163249e-05,1,0,1
3058,3058,formData,8.058149364163249e-05,1,0,1
3059,3059,getTitle,8.058149364163249e-05,1,0,1
3060,3060,inner,8.058149364163249e-05,1,0,1
3061,3061,message2,8.058149364163249e-05,1,0,1
3062,3062,onChange,8.058149364163249e-05,1,0,1
3063,3063,parentNode,8.058149364163249e-05,1,0,1
3064,3064,r,8.058149364163249e-05,1,0,1
3065,3065,refresh,8.058149364163249e-05,1,0,1
3066,3066,remove,8.058149364163249e-05,1,0,1
3067,3067,round,8.058149364163249e-05,1,0,1
3068,3068,rows,8.058149364163249e-05,1,0,1
3069,3069,runTests,8.058149364163249e-05,1,0,1
3070,3070,schema,8.058149364163249e-05,1,0,1
3071,3071,skip,8.058149364163249e-05,1,0,1
3072,3072,throw,8.058149364163249e-05,1,0,1
3073,3073,uid,8.058149364163249e-05,1,0,1
3074,3074,}/${,8.058149364163249e-05,1,0,1
3075,3075,"
						",8.058149364163249e-05,1,0,1
3076,3076,"""--""",8.058149364163249e-05,1,0,1
3077,3077,"""Duplicate description""",8.058149364163249e-05,1,0,1
3078,3078,"""Fallback""",8.058149364163249e-05,1,0,1
3079,3079,"""Fancy title""",8.058149364163249e-05,1,0,1
3080,3080,"""Inner duplicate description""",8.058149364163249e-05,1,0,1
3081,3081,"""Invalid prop `testProp[0]` of type `number` supplied to """,8.058149364163249e-05,1,0,1
3082,3082,"""Something to do""",8.058149364163249e-05,1,0,1
3083,3083,"""Test Description""",8.058149364163249e-05,1,0,1
3084,3084,"""Test name itemprop""",8.058149364163249e-05,1,0,1
3085,3085,"""TestObject""",8.058149364163249e-05,1,0,1
3086,3086,"""[mobx.trace] 'x.fooIsGreaterThan5' is invalidated due to a change in: 'x.foo'""",8.058149364163249e-05,1,0,1
3087,3087,"""`testComponent`, expected `mobx.ObservableArray`.""",8.058149364163249e-05,1,0,1
3088,3088,"""`testComponent`, expected `mobx.ObservableObject`.""",8.058149364163249e-05,1,0,1
3089,3089,"""`testComponent`, expected `string`.""",8.058149364163249e-05,1,0,1
3090,3090,"""ain't any""",8.058149364163249e-05,1,0,1
3091,3091,"""amp""",8.058149364163249e-05,1,0,1
3092,3092,"""application/ld+json""",8.058149364163249e-05,1,0,1
3093,3093,"""array""",8.058149364163249e-05,1,0,1
3094,3094,"""blue""",8.058149364163249e-05,1,0,1
3095,3095,"""bound""",8.058149364163249e-05,1,0,1
3096,3096,"""cb observed""",8.058149364163249e-05,1,0,1
3097,3097,"""cb unobserved""",8.058149364163249e-05,1,0,1
3098,3098,"""computedVal""",8.058149364163249e-05,1,0,1
3099,3099,"""content-type""",8.058149364163249e-05,1,0,1
3100,3100,"""ctx""",8.058149364163249e-05,1,0,1
3101,3101,"""en""",8.058149364163249e-05,1,0,1
3102,3102,"""flowBound""",8.058149364163249e-05,1,0,1
3103,3103,"""html""",8.058149364163249e-05,1,0,1
3104,3104,"""http://localhost/helmet/newest""",8.058149364163249e-05,1,0,1
3105,3105,"""http://mysite.com/public""",8.058149364163249e-05,1,0,1
3106,3106,"""initial""",8.058149364163249e-05,1,0,1
3107,3107,"""itemprop""",8.058149364163249e-05,1,0,1
3108,3108,"""items""",8.058149364163249e-05,1,0,1
3109,3109,"""linkTags""",8.058149364163249e-05,1,0,1
3110,3110,"""m""",8.058149364163249e-05,1,0,1
3111,3111,"""m1""",8.058149364163249e-05,1,0,1
3112,3112,"""metaTags""",8.058149364163249e-05,1,0,1
3113,3113,"""nested""",8.058149364163249e-05,1,0,1
3114,3114,"""new string value""",8.058149364163249e-05,1,0,1
3115,3115,"""new symbol value""",8.058149364163249e-05,1,0,1
3116,3116,"""new""",8.058149364163249e-05,1,0,1
3117,3117,"""observing first""",8.058149364163249e-05,1,0,1
3118,3118,"""observing""",8.058149364163249e-05,1,0,1
3119,3119,"""original string value""",8.058149364163249e-05,1,0,1
3120,3120,"""original symbol value""",8.058149364163249e-05,1,0,1
3121,3121,"""price""",8.058149364163249e-05,1,0,1
3122,3122,"""prop""",8.058149364163249e-05,1,0,1
3123,3123,"""recalculating""",8.058149364163249e-05,1,0,1
3124,3124,"""selected""",8.058149364163249e-05,1,0,1
3125,3125,"""test that this isn't any""",8.058149364163249e-05,1,0,1
3126,3126,"""test,meta,tags""",8.058149364163249e-05,1,0,1
3127,3127,"""text/html""",8.058149364163249e-05,1,0,1
3128,3128,"""toComponent""",8.058149364163249e-05,1,0,1
3129,3129,"""toString""",8.058149364163249e-05,1,0,1
3130,3130,"""total""",8.058149364163249e-05,1,0,1
3131,3131,"""unbound""",8.058149364163249e-05,1,0,1
3132,3132,"""unobserving""",8.058149364163249e-05,1,0,1
3133,3133,"""unselected""",8.058149364163249e-05,1,0,1
3134,3134,$deep,8.058149364163249e-05,1,0,1
3135,3135,$dynamic,8.058149364163249e-05,1,0,1
3136,3136,$dynamicIcon,8.058149364163249e-05,1,0,1
3137,3137,$initial,8.058149364163249e-05,1,0,1
3138,3138,$inner,8.058149364163249e-05,1,0,1
3139,3139,$new,8.058149364163249e-05,1,0,1
3140,3140,$revalidated,8.058149364163249e-05,1,0,1
3141,3141,$second,8.058149364163249e-05,1,0,1
3142,3142,'            <div>content</div>',8.058149364163249e-05,1,0,1
3143,3143,'          </div>',8.058149364163249e-05,1,0,1
3144,3144,"'          <div class=""accordion-header"">'",8.058149364163249e-05,1,0,1
3145,3145,'        </div>',8.058149364163249e-05,1,0,1
3146,3146,"'        <div class=""accordion-item"">'",8.058149364163249e-05,1,0,1
3147,3147,'      </div>',8.058149364163249e-05,1,0,1
3148,3148,"'      <a class=""dropdown-item"" href=""#dropdown1"" id=""dropdown1-tab"" data-bs-toggle=""tab"">@fat</a>'",8.058149364163249e-05,1,0,1
3149,3149,"'      <button class=""btn-close"" aria-label=""Close""></button>'",8.058149364163249e-05,1,0,1
3150,3150,"'      <div class=""item"">'",8.058149364163249e-05,1,0,1
3151,3151,'    </a>',8.058149364163249e-05,1,0,1
3152,3152,'    </li>',8.058149364163249e-05,1,0,1
3153,3153,"'    <a class=""dropdown-item"" href=""#"">Secondary link</a>'",8.058149364163249e-05,1,0,1
3154,3154,"'    <a class=""nav-link dropdown-toggle"" data-bs-toggle=""dropdown"" href=""#"">Dropdown</a>'",8.058149364163249e-05,1,0,1
3155,3155,"'    <div class=""col-lg-6"">'",8.058149364163249e-05,1,0,1
3156,3156,"'    <div class=""dropdown-menu"">'",8.058149364163249e-05,1,0,1
3157,3157,"'    <li class=""nav-item"">'",8.058149364163249e-05,1,0,1
3158,3158,"'  <li class=""nav-item active""><a class=""nav-link"" href=""#home"" data-bs-toggle=""tab"">Home</a></li>'",8.058149364163249e-05,1,0,1
3159,3159,"'  <li class=""nav-item dropdown"">'",8.058149364163249e-05,1,0,1
3160,3160,'#Dashboard',8.058149364163249e-05,1,0,1
3161,3161,'#a-1',8.058149364163249e-05,1,0,1
3162,3162,'#abc',8.058149364163249e-05,1,0,1
3163,3163,'#about',8.058149364163249e-05,1,0,1
3164,3164,'#api-docs',8.058149364163249e-05,1,0,1
3165,3165,'#app-text',8.058149364163249e-05,1,0,1
3166,3166,'#bar',8.058149364163249e-05,1,0,1
3167,3167,'#bar.qux.quux',8.058149364163249e-05,1,0,1
3168,3168,'#blog',8.058149364163249e-05,1,0,1
3169,3169,'#children',8.058149364163249e-05,1,0,1
3170,3170,'#cookie-result',8.058149364163249e-05,1,0,1
3171,3171,'#count',8.058149364163249e-05,1,0,1
3172,3172,'#css-text-dynamic-no-ssr-client',8.058149364163249e-05,1,0,1
3173,3173,'#dashboard-layout',8.058149364163249e-05,1,0,1
3174,3174,'#dashboard-page',8.058149364163249e-05,1,0,1
3175,3175,'#data-body4',8.058149364163249e-05,1,0,1
3176,3176,'#deploy',8.058149364163249e-05,1,0,1
3177,3177,'#div-100-2',8.058149364163249e-05,1,0,1
3178,3178,'#draft-mode',8.058149364163249e-05,1,0,1
3179,3179,'#dynamic',8.058149364163249e-05,1,0,1
3180,3180,'#error-boundary-digest',8.058149364163249e-05,1,0,1
3181,3181,'#hashlink',8.058149364163249e-05,1,0,1
3182,3182,'#hit',8.058149364163249e-05,1,0,1
3183,3183,'#increment',8.058149364163249e-05,1,0,1
3184,3184,'#initial-query',8.058149364163249e-05,1,0,1
3185,3185,'#input',8.058149364163249e-05,1,0,1
3186,3186,'#li-100-2',8.058149364163249e-05,1,0,1
3187,3187,'#link-to-h1-hash-only',8.058149364163249e-05,1,0,1
3188,3188,'#main',8.058149364163249e-05,1,0,1
3189,3189,'#message-1',8.058149364163249e-05,1,0,1
3190,3190,'#message-2',8.058149364163249e-05,1,0,1
3191,3191,'#modal',8.058149364163249e-05,1,0,1
3192,3192,'#next_id',8.058149364163249e-05,1,0,1
3193,3193,'#page-data2',8.058149364163249e-05,1,0,1
3194,3194,'#page-title',8.058149364163249e-05,1,0,1
3195,3195,'#parallel-layout',8.058149364163249e-05,1,0,1
3196,3196,'#param-id',8.058149364163249e-05,1,0,1
3197,3197,'#performance-now',8.058149364163249e-05,1,0,1
3198,3198,'#prefetch-false-page-result',8.058149364163249e-05,1,0,1
3199,3199,'#profile',8.058149364163249e-05,1,0,1
3200,3200,'#prop',8.058149364163249e-05,1,0,1
3201,3201,'#random-data',8.058149364163249e-05,1,0,1
3202,3202,'#react',8.058149364163249e-05,1,0,1
3203,3203,'#react-dom',8.058149364163249e-05,1,0,1
3204,3204,'#react-dom-server',8.058149364163249e-05,1,0,1
3205,3205,'#root-a',8.058149364163249e-05,1,0,1
3206,3206,'#root-b',8.058149364163249e-05,1,0,1
3207,3207,'#router',8.058149364163249e-05,1,0,1
3208,3208,'#search-params',8.058149364163249e-05,1,0,1
3209,3209,'#slot-content',8.058149364163249e-05,1,0,1
3210,3210,'#slow',8.058149364163249e-05,1,0,1
3211,3211,'#slug',8.058149364163249e-05,1,0,1
3212,3212,'#static-page',8.058149364163249e-05,1,0,1
3213,3213,'#to-another',8.058149364163249e-05,1,0,1
3214,3214,'#to-another-with-slash',8.058149364163249e-05,1,0,1
3215,3215,'#to-catchall',8.058149364163249e-05,1,0,1
3216,3216,'#to-dynamic',8.058149364163249e-05,1,0,1
3217,3217,'#to-other-page',8.058149364163249e-05,1,0,1
3218,3218,'#to-rewritten-ssg',8.058149364163249e-05,1,0,1
3219,3219,'#to-static-page',8.058149364163249e-05,1,0,1
3220,3220,'#tooltipEl',8.058149364163249e-05,1,0,1
3221,3221,'#tooltipWithTitle',8.058149364163249e-05,1,0,1
3222,3222,'*.example.com',8.058149364163249e-05,1,0,1
3223,3223,'--other --inspect-port=0.0.0.0:1234 --additional',8.058149364163249e-05,1,0,1
3224,3224,'.*?\\.vercel\\.app',8.058149364163249e-05,1,0,1
3225,3225,'..',8.058149364163249e-05,1,0,1
3226,3226,'./app/foo.js',8.058149364163249e-05,1,0,1
3227,3227,'./app/page.js',8.058149364163249e-05,1,0,1
3228,3228,'./foo',8.058149364163249e-05,1,0,1
3229,3229,'./instrumentation.js',8.058149364163249e-05,1,0,1
3230,3230,'./instrumentation.js.bak',8.058149364163249e-05,1,0,1
3231,3231,'./src/instrumentation.js',8.058149364163249e-05,1,0,1
3232,3232,'./src/instrumentation.js.bak',8.058149364163249e-05,1,0,1
3233,3233,'./src1',8.058149364163249e-05,1,0,1
3234,3234,'./test/components/Button/Button.js',8.058149364163249e-05,1,0,1
3235,3235,'.bogus',8.058149364163249e-05,1,0,1
3236,3236,'.content',8.058149364163249e-05,1,0,1
3237,3237,'.inner',8.058149364163249e-05,1,0,1
3238,3238,'.modal',8.058149364163249e-05,1,0,1
3239,3239,'.modal-backdrop',8.058149364163249e-05,1,0,1
3240,3240,'.nav > div',8.058149364163249e-05,1,0,1
3241,3241,'.nav-link',8.058149364163249e-05,1,0,1
3242,3242,'.next',8.058149364163249e-05,1,0,1
3243,3243,'.next/server/pages',8.058149364163249e-05,1,0,1
3244,3244,'.scss',8.058149364163249e-05,1,0,1
3245,3245,'.toast',8.058149364163249e-05,1,0,1
3246,3246,'/* ~ */',8.058149364163249e-05,1,0,1
3247,3247,'/1',8.058149364163249e-05,1,0,1
3248,3248,'/2',8.058149364163249e-05,1,0,1
3249,3249,'/[...one]',8.058149364163249e-05,1,0,1
3250,3250,'/[[...all]]',8.058149364163249e-05,1,0,1
3251,3251,'/[[...one]]',8.058149364163249e-05,1,0,1
3252,3252,'/[param]',8.058149364163249e-05,1,0,1
3253,3253,'/_next/data/missing-id/hello.json',8.058149364163249e-05,1,0,1
3254,3254,'/_next/static/media/c287665b44f047d4-s.p.woff2',8.058149364163249e-05,1,0,1
3255,3255,'/abc',8.058149364163249e-05,1,0,1
3256,3256,'/about',8.058149364163249e-05,1,0,1
3257,3257,'/act123/**',8.058149364163249e-05,1,0,1
3258,3258,'/another-destination',8.058149364163249e-05,1,0,1
3259,3259,'/api/dynamic',8.058149364163249e-05,1,0,1
3260,3260,'/api/hello.json',8.058149364163249e-05,1,0,1
3261,3261,'/api/manual-revalidate',8.058149364163249e-05,1,0,1
3262,3262,'/api/switch-in-dev',8.058149364163249e-05,1,0,1
3263,3263,'/app-react',8.058149364163249e-05,1,0,1
3264,3264,'/assertion/page',8.058149364163249e-05,1,0,1
3265,3265,'/async/not-found',8.058149364163249e-05,1,0,1
3266,3266,'/bar',8.058149364163249e-05,1,0,1
3267,3267,'/basic/endpoint/nested',8.058149364163249e-05,1,0,1
3268,3268,'/blocking-fallback-once/404-on-manual-revalidate',8.058149364163249e-05,1,0,1
3269,3269,'/blocking-fallback-once/test-manual-1',8.058149364163249e-05,1,0,1
3270,3270,'/blocking-fallback-some/asf',8.058149364163249e-05,1,0,1
3271,3271,'/blocking-fallback-some/b',8.058149364163249e-05,1,0,1
3272,3272,'/blocking-fallback/test-errors-2',8.058149364163249e-05,1,0,1
3273,3273,'/blocking-fallback/test-if-generated-1',8.058149364163249e-05,1,0,1
3274,3274,'/blocking-fallback/test-if-generated-2',8.058149364163249e-05,1,0,1
3275,3275,'/blocking-fallback/test-manual-1',8.058149364163249e-05,1,0,1
3276,3276,'/blog-post-1',8.058149364163249e-05,1,0,1
3277,3277,'/blog-post-2',8.058149364163249e-05,1,0,1
3278,3278,'/blog-post-3',8.058149364163249e-05,1,0,1
3279,3279,'/blog/[author]',8.058149364163249e-05,1,0,1
3280,3280,'/blog/[author]/[slug]',8.058149364163249e-05,1,0,1
3281,3281,'/blog/post-321',8.058149364163249e-05,1,0,1
3282,3282,'/blog/tim?message=hello-world',8.058149364163249e-05,1,0,1
3283,3283,'/catchall-explicit/first',8.058149364163249e-05,1,0,1
3284,3284,'/catchall-explicit/test-manual-1',8.058149364163249e-05,1,0,1
3285,3285,'/client',8.058149364163249e-05,1,0,1
3286,3286,'/client-component-route',8.058149364163249e-05,1,0,1
3287,3287,'/client/edge',8.058149364163249e-05,1,0,1
3288,3288,'/config-rewrite-to-dynamic-static/post-2',8.058149364163249e-05,1,0,1
3289,3289,'/default-cache',8.058149364163249e-05,1,0,1
3290,3290,'/dynamic/[slug]',8.058149364163249e-05,1,0,1
3291,3291,'/dynamic/first',8.058149364163249e-05,1,0,1
3292,3292,'/edge/basic',8.058149364163249e-05,1,0,1
3293,3293,'/en',8.058149364163249e-05,1,0,1
3294,3294,'/example',8.058149364163249e-05,1,0,1
3295,3295,'/external-imports/client',8.058149364163249e-05,1,0,1
3296,3296,'/favicon.ico',8.058149364163249e-05,1,0,1
3297,3297,'/fetch-no-cache',8.058149364163249e-05,1,0,1
3298,3298,'/force-no-store',8.058149364163249e-05,1,0,1
3299,3299,'/force-static',8.058149364163249e-05,1,0,1
3300,3300,'/force-static/[slug]',8.058149364163249e-05,1,0,1
3301,3301,'/force-static/first',8.058149364163249e-05,1,0,1
3302,3302,'/force-static/random',8.058149364163249e-05,1,0,1
3303,3303,'/gen-params-dynamic-revalidate/[slug]',8.058149364163249e-05,1,0,1
3304,3304,'/gen-params-dynamic-revalidate/one',8.058149364163249e-05,1,0,1
3305,3305,'/gen-params-dynamic/one',8.058149364163249e-05,1,0,1
3306,3306,'/gssp',8.058149364163249e-05,1,0,1
3307,3307,'/has-match-1',8.058149364163249e-05,1,0,1
3308,3308,'/has-match-2',8.058149364163249e-05,1,0,1
3309,3309,'/has-match-3',8.058149364163249e-05,1,0,1
3310,3310,'/has-match-4',8.058149364163249e-05,1,0,1
3311,3311,'/has-match-5',8.058149364163249e-05,1,0,1
3312,3312,'/hooks/use-pathname',8.058149364163249e-05,1,0,1
3313,3313,'/hooks/use-pathname/[slug]',8.058149364163249e-05,1,0,1
3314,3314,'/hooks/use-pathname/slug',8.058149364163249e-05,1,0,1
3315,3315,'/hooks/use-search-params',8.058149364163249e-05,1,0,1
3316,3316,'/hooks/use-search-params/force-static',8.058149364163249e-05,1,0,1
3317,3317,'/hooks/use-search-params/with-suspense',8.058149364163249e-05,1,0,1
3318,3318,'/intercepting-parallel-modal/photo/2',8.058149364163249e-05,1,0,1
3319,3319,'/intercepting-routes-dynamic-catchall/photos/catchall/123',8.058149364163249e-05,1,0,1
3320,3320,'/intercepting-routes-dynamic-catchall/photos/optional-catchall/123',8.058149364163249e-05,1,0,1
3321,3321,'/intercepting-routes-dynamic/photos/next/123',8.058149364163249e-05,1,0,1
3322,3322,'/legacy/no-ssr',8.058149364163249e-05,1,0,1
3323,3323,'/metadata-base/unset/icon/100',8.058149364163249e-05,1,0,1
3324,3324,'/metadata-base/unset/sitemap.xml/0',8.058149364163249e-05,1,0,1
3325,3325,'/middleware/another-path',8.058149364163249e-05,1,0,1
3326,3326,'/missing',8.058149364163249e-05,1,0,1
3327,3327,'/missing-match-1',8.058149364163249e-05,1,0,1
3328,3328,'/missing-match-2',8.058149364163249e-05,1,0,1
3329,3329,'/next-api/link',8.058149364163249e-05,1,0,1
3330,3330,'/pages-react',8.058149364163249e-05,1,0,1
3331,3331,'/param-1',8.058149364163249e-05,1,0,1
3332,3332,'/partial-gen-params-no-additional-lang/[lang]/[slug]',8.058149364163249e-05,1,0,1
3333,3333,'/partial-gen-params-no-additional-slug/[lang]/[slug]',8.058149364163249e-05,1,0,1
3334,3334,'/path/',8.058149364163249e-05,1,0,1
3335,3335,'/path/to/foo/examples/file',8.058149364163249e-05,1,0,1
3336,3336,'/posts',8.058149364163249e-05,1,0,1
3337,3337,'/posts/[id]',8.058149364163249e-05,1,0,1
3338,3338,'/posts/[id]/[foo]/bar',8.058149364163249e-05,1,0,1
3339,3339,'/posts/[id]/baz/[foo]/bar',8.058149364163249e-05,1,0,1
3340,3340,'/posts/[id]/foo',8.058149364163249e-05,1,0,1
3341,3341,'/preview',8.058149364163249e-05,1,0,1
3342,3342,'/report-web-vitals',8.058149364163249e-05,1,0,1
3343,3343,'/rewrite-to-static',8.058149364163249e-05,1,0,1
3344,3344,'/root/redirect-with-basepath',8.058149364163249e-05,1,0,1
3345,3345,'/route-handler/post',8.058149364163249e-05,1,0,1
3346,3346,'/route-handler/revalidate-360-isr',8.058149364163249e-05,1,0,1
3347,3347,'/route-handler/static-cookies',8.058149364163249e-05,1,0,1
3348,3348,'/routes',8.058149364163249e-05,1,0,1
3349,3349,'/slow-page-no-loading',8.058149364163249e-05,1,0,1
3350,3350,'/some',8.058149364163249e-05,1,0,1
3351,3351,'/some/path?param=blah',8.058149364163249e-05,1,0,1
3352,3352,'/someF/pathG?fooH=barI#hashJ',8.058149364163249e-05,1,0,1
3353,3353,'/something?hello=world',8.058149364163249e-05,1,0,1
3354,3354,'/somewhere/else',8.058149364163249e-05,1,0,1
3355,3355,'/somewhere/else/',8.058149364163249e-05,1,0,1
3356,3356,'/ssg-draft-mode/[[...route]]',8.058149364163249e-05,1,0,1
3357,3357,'/ssg-draft-mode/test-1',8.058149364163249e-05,1,0,1
3358,3358,'/static',8.058149364163249e-05,1,0,1
3359,3359,'/static-ssg/[slug]',8.058149364163249e-05,1,0,1
3360,3360,'/static?param=1',8.058149364163249e-05,1,0,1
3361,3361,'/sub',8.058149364163249e-05,1,0,1
3362,3362,'/sub/[[...all]]',8.058149364163249e-05,1,0,1
3363,3363,'/switch-in-dev',8.058149364163249e-05,1,0,1
3364,3364,'/test2',8.058149364163249e-05,1,0,1
3365,3365,'/to-ssg',8.058149364163249e-05,1,0,1
3366,3366,'/to-ssg/',8.058149364163249e-05,1,0,1
3367,3367,'/variable-revalidate-edge/body',8.058149364163249e-05,1,0,1
3368,3368,'/variable-revalidate-edge/encoding',8.058149364163249e-05,1,0,1
3369,3369,'/variable-revalidate-edge/post-method',8.058149364163249e-05,1,0,1
3370,3370,'/variable-revalidate-edge/post-method-request',8.058149364163249e-05,1,0,1
3371,3371,'/variable-revalidate-edge/revalidate-3',8.058149364163249e-05,1,0,1
3372,3372,'/variable-revalidate/headers-instance',8.058149364163249e-05,1,0,1
3373,3373,'/variable-revalidate/status-code',8.058149364163249e-05,1,0,1
3374,3374,'/various-exports',8.058149364163249e-05,1,0,1
3375,3375,'0',8.058149364163249e-05,1,0,1
3376,3376,'100vw',8.058149364163249e-05,1,0,1
3377,3377,'114',8.058149364163249e-05,1,0,1
3378,3378,'123',8.058149364163249e-05,1,0,1
3379,3379,'1600',8.058149364163249e-05,1,0,1
3380,3380,'1800',8.058149364163249e-05,1,0,1
3381,3381,'321',8.058149364163249e-05,1,0,1
3382,3382,'48x48',8.058149364163249e-05,1,0,1
3383,3383,'50vw',8.058149364163249e-05,1,0,1
3384,3384,'600',8.058149364163249e-05,1,0,1
3385,3385,'800',8.058149364163249e-05,1,0,1
3386,3386,':',8.058149364163249e-05,1,0,1
3387,3387,'</ol>',8.058149364163249e-05,1,0,1
3388,3388,"'<button class=""btn""></button>'",8.058149364163249e-05,1,0,1
3389,3389,"'<div class=""test""></div>'",8.058149364163249e-05,1,0,1
3390,3390,'<h1>Hello Markdown!</h1>',8.058149364163249e-05,1,0,1
3391,3391,'?hello=world',8.058149364163249e-05,1,0,1
3392,3392,'About',8.058149364163249e-05,1,0,1
3393,3393,'B0',8.058149364163249e-05,1,0,1
3394,3394,'B1',8.058149364163249e-05,1,0,1
3395,3395,'B1C2D3E4F5G6H7I8J9K0LaMbNcOdPeQf',8.058149364163249e-05,1,0,1
3396,3396,'B_ACTIVITY',8.058149364163249e-05,1,0,1
3397,3397,'Bootstrap',8.058149364163249e-05,1,0,1
3398,3398,'Button.fixture.js',8.058149364163249e-05,1,0,1
3399,3399,'Button/index.fixture.js',8.058149364163249e-05,1,0,1
3400,3400,'C',8.058149364163249e-05,1,0,1
3401,3401,'C4',8.058149364163249e-05,1,0,1
3402,3402,'CALLBACK',8.058149364163249e-05,1,0,1
3403,3403,'CD1E2F3G4H5I6J7K8L9M0NaObPcQdReS',8.058149364163249e-05,1,0,1
3404,3404,'CIRCULAR',8.058149364163249e-05,1,0,1
3405,3405,'Content-Type',8.058149364163249e-05,1,0,1
3406,3406,'Counter',8.058149364163249e-05,1,0,1
3407,3407,'CounterButton',8.058149364163249e-05,1,0,1
3408,3408,'Custom Panel',8.058149364163249e-05,1,0,1
3409,3409,'CustomDisplayName',8.058149364163249e-05,1,0,1
3410,3410,'DEF1G2H3I4J5K6L7M8N9O0PaQbRcSdTe',8.058149364163249e-05,1,0,1
3411,3411,'DEPLOY',8.058149364163249e-05,1,0,1
3412,3412,'DOUBLE',8.058149364163249e-05,1,0,1
3413,3413,"'DROPDOWN: Option ""reference"" provided type ""object"" without a required ""getBoundingClientRect"" method.'",8.058149364163249e-05,1,0,1
3414,3414,'Dashboard/Dashboard.fixture.js',8.058149364163249e-05,1,0,1
3415,3415,'Dashboard/Settings.fixture.js',8.058149364163249e-05,1,0,1
3416,3416,'Dashboard/Settings/index.fixture.js',8.058149364163249e-05,1,0,1
3417,3417,'David',8.058149364163249e-05,1,0,1
3418,3418,'EMERGENCY',8.058149364163249e-05,1,0,1
3419,3419,'EVENT_WITHOUT_FLAG',8.058149364163249e-05,1,0,1
3420,3420,'EXIT_A',8.058149364163249e-05,1,0,1
3421,3421,'EXIT_B',8.058149364163249e-05,1,0,1
3422,3422,'EXIT_C',8.058149364163249e-05,1,0,1
3423,3423,'EXIT_D',8.058149364163249e-05,1,0,1
3424,3424,'EXTERNAL_EVENT',8.058149364163249e-05,1,0,1
3425,3425,'Example Domain',8.058149364163249e-05,1,0,1
3426,3426,'FGHI1J2K3L4M5N6O7P8Q9R0SaTbUcVdW',8.058149364163249e-05,1,0,1
3427,3427,'Foo',8.058149364163249e-05,1,0,1
3428,3428,'FooBar',8.058149364163249e-05,1,0,1
3429,3429,'GOTO_FOOBAZ',8.058149364163249e-05,1,0,1
3430,3430,'HIJK1L2M3N4O5P6Q7R8S9T0UaVbWcXdY',8.058149364163249e-05,1,0,1
3431,3431,'HIT',8.058149364163249e-05,1,0,1
3432,3432,"'Hello, magnificent world.'",8.058149364163249e-05,1,0,1
3433,3433,"'Hello, world!'",8.058149364163249e-05,1,0,1
3434,3434,'Hidden',8.058149364163249e-05,1,0,1
3435,3435,'ImageResponse',8.058149364163249e-05,1,0,1
3436,3436,'JKLM1N2O3P4Q5R6S7T8U9V0WaXbYcZdA',8.058149364163249e-05,1,0,1
3437,3437,'KNOCK_KNOCK',8.058149364163249e-05,1,0,1
3438,3438,'LOG',8.058149364163249e-05,1,0,1
3439,3439,'Location',8.058149364163249e-05,1,0,1
3440,3440,'MACHINE_EVENT',8.058149364163249e-05,1,0,1
3441,3441,'MY_EVENT',8.058149364163249e-05,1,0,1
3442,3442,'Mars',8.058149364163249e-05,1,0,1
3443,3443,'My custom alt',8.058149364163249e-05,1,0,1
3444,3444,'My custom description',8.058149364163249e-05,1,0,1
3445,3445,'My custom title',8.058149364163249e-05,1,0,1
3446,3446,'My page',8.058149364163249e-05,1,0,1
3447,3447,'NOTHING',8.058149364163249e-05,1,0,1
3448,3448,'Next-Router-State-Tree',8.058149364163249e-05,1,0,1
3449,3449,'No lint errors found.',8.058149364163249e-05,1,0,1
3450,3450,'Not good',8.058149364163249e-05,1,0,1
3451,3451,'ODD',8.058149364163249e-05,1,0,1
3452,3452,'OFF',8.058149364163249e-05,1,0,1
3453,3453,'ON',8.058149364163249e-05,1,0,1
3454,3454,'Opened',8.058149364163249e-05,1,0,1
3455,3455,'PED_STOP',8.058149364163249e-05,1,0,1
3456,3456,'PREV',8.058149364163249e-05,1,0,1
3457,3457,'Page that would break',8.058149364163249e-05,1,0,1
3458,3458,'Pizza',8.058149364163249e-05,1,0,1
3459,3459,'Popover content',8.058149364163249e-05,1,0,1
3460,3460,'Post: a',8.058149364163249e-05,1,0,1
3461,3461,'Props Panel',8.058149364163249e-05,1,0,1
3462,3462,'RAISED_EVENT',8.058149364163249e-05,1,0,1
3463,3463,'RECEIVED',8.058149364163249e-05,1,0,1
3464,3464,'ROUTE',8.058149364163249e-05,1,0,1
3465,3465,'SAMPLE',8.058149364163249e-05,1,0,1
3466,3466,'SAVE',8.058149364163249e-05,1,0,1
3467,3467,'SOMETHING',8.058149364163249e-05,1,0,1
3468,3468,'STATE_OFF',8.058149364163249e-05,1,0,1
3469,3469,'STOPCHILD',8.058149364163249e-05,1,0,1
3470,3470,'Some beautiful content :)',8.058149364163249e-05,1,0,1
3471,3471,'Style guide',8.058149364163249e-05,1,0,1
3472,3472,'TEST',8.058149364163249e-05,1,0,1
3473,3473,'TOGGLE',8.058149364163249e-05,1,0,1
3474,3474,'TO_TWO_MAYBE',8.058149364163249e-05,1,0,1
3475,3475,'Tab',8.058149364163249e-05,1,0,1
3476,3476,'Template 0',8.058149364163249e-05,1,0,1
3477,3477,'Template 1',8.058149364163249e-05,1,0,1
3478,3478,'Template',8.058149364163249e-05,1,0,1
3479,3479,"'This is ""quoted"" text and & and \'.'",8.058149364163249e-05,1,0,1
3480,3480,'This is a test',8.058149364163249e-05,1,0,1
3481,3481,'Title which does not require content',8.058149364163249e-05,1,0,1
3482,3482,'UA',8.058149364163249e-05,1,0,1
3483,3483,'UPDATE',8.058149364163249e-05,1,0,1
3484,3484,'UPDATE_BAZ',8.058149364163249e-05,1,0,1
3485,3485,'UglifyJsPlugin',8.058149364163249e-05,1,0,1
3486,3486,'WelcomeMessage',8.058149364163249e-05,1,0,1
3487,3487,'X',8.058149364163249e-05,1,0,1
3488,3488,'[chunkhash',8.058149364163249e-05,1,0,1
3489,3489,"'[data-bs-toggle=""button""]'",8.058149364163249e-05,1,0,1
3490,3490,"'[data-bs-toggle=""dropdown""]'",8.058149364163249e-05,1,0,1
3491,3491,'[data-go-back]',8.058149364163249e-05,1,0,1
3492,3492,'[data-next-page]',8.058149364163249e-05,1,0,1
3493,3493,'[data-next-shallow-replace]',8.058149364163249e-05,1,0,1
3494,3494,"'[href=""#home""]'",8.058149364163249e-05,1,0,1
3495,3495,"'[href=""/1""]'",8.058149364163249e-05,1,0,1
3496,3496,"'[href=""/2""]'",8.058149364163249e-05,1,0,1
3497,3497,"'[href=""/parallel-catchall/bar""]'",8.058149364163249e-05,1,0,1
3498,3498,'__fixtures__/Dashboard.js',8.058149364163249e-05,1,0,1
3499,3499,'__jsxfixtures__',8.058149364163249e-05,1,0,1
3500,3500,'__next_preview_data',8.058149364163249e-05,1,0,1
3501,3501,'__prerender_bypass',8.058149364163249e-05,1,0,1
3502,3502,'a nice image',8.058149364163249e-05,1,0,1
3503,3503,'a.b',8.058149364163249e-05,1,0,1
3504,3504,'a2 entered',8.058149364163249e-05,1,0,1
3505,3505,'a2 exited',8.058149364163249e-05,1,0,1
3506,3506,'abcde',8.058149364163249e-05,1,0,1
3507,3507,'absent',8.058149364163249e-05,1,0,1
3508,3508,'an',8.058149364163249e-05,1,0,1
3509,3509,'another page',8.058149364163249e-05,1,0,1
3510,3510,'any',8.058149364163249e-05,1,0,1
3511,3511,'app/icons/static/icon.png',8.058149364163249e-05,1,0,1
3512,3512,'app/icons/static/icon2.png',8.058149364163249e-05,1,0,1
3513,3513,'app/invalid/[slug]/page.js',8.058149364163249e-05,1,0,1
3514,3514,'app/object/page.js',8.058149364163249e-05,1,0,1
3515,3515,'app/page-with-loading/page.js',8.058149364163249e-05,1,0,1
3516,3516,'apple-touch-startup-image',8.058149364163249e-05,1,0,1
3517,3517,'application/json',8.058149364163249e-05,1,0,1
3518,3518,'application/rss+xml',8.058149364163249e-05,1,0,1
3519,3519,'aria-current',8.058149364163249e-05,1,0,1
3520,3520,'aria-hidden',8.058149364163249e-05,1,0,1
3521,3521,'aria-labelledby',8.058149364163249e-05,1,0,1
3522,3522,'aria-modal',8.058149364163249e-05,1,0,1
3523,3523,'aria-pressed',8.058149364163249e-05,1,0,1
3524,3524,'aria-selected',8.058149364163249e-05,1,0,1
3525,3525,'assign',8.058149364163249e-05,1,0,1
3526,3526,'assignPassword',8.058149364163249e-05,1,0,1
3527,3527,'auth-server',8.058149364163249e-05,1,0,1
3528,3528,'bad_request',8.058149364163249e-05,1,0,1
3529,3529,'bar action',8.058149364163249e-05,1,0,1
3530,3530,'bar exit action',8.058149364163249e-05,1,0,1
3531,3531,'bar2',8.058149364163249e-05,1,0,1
3532,3532,'barAction',8.058149364163249e-05,1,0,1
3533,3533,'barKey',8.058149364163249e-05,1,0,1
3534,3534,'bazAction',8.058149364163249e-05,1,0,1
3535,3535,'bottom',8.058149364163249e-05,1,0,1
3536,3536,'bs',8.058149364163249e-05,1,0,1
3537,3537,'bs-tooltip-auto',8.058149364163249e-05,1,0,1
3538,3538,'bs.namespace',8.058149364163249e-05,1,0,1
3539,3539,'bullets',8.058149364163249e-05,1,0,1
3540,3540,'burger',8.058149364163249e-05,1,0,1
3541,3541,'c1',8.058149364163249e-05,1,0,1
3542,3542,'callback_child',8.058149364163249e-05,1,0,1
3543,3543,'chunks',8.058149364163249e-05,1,0,1
3544,3544,'classes',8.058149364163249e-05,1,0,1
3545,3545,'click.namespace',8.058149364163249e-05,1,0,1
3546,3546,'client',8.058149364163249e-05,1,0,1
3547,3547,'closed',8.058149364163249e-05,1,0,1
3548,3548,'components/Button.js',8.058149364163249e-05,1,0,1
3549,3549,'controls',8.058149364163249e-05,1,0,1
3550,3550,'crosswalkLight',8.058149364163249e-05,1,0,1
3551,3551,'custom-class',8.058149364163249e-05,1,0,1
3552,3552,'custom-id',8.058149364163249e-05,1,0,1
3553,3553,'d1',8.058149364163249e-05,1,0,1
3554,3554,'d4',8.058149364163249e-05,1,0,1
3555,3555,"'da, en, en-GB'",8.058149364163249e-05,1,0,1
3556,3556,'da-DK',8.058149364163249e-05,1,0,1
3557,3557,'dashboard/Dashboard.fixture.js',8.058149364163249e-05,1,0,1
3558,3558,'data-bs-no-jquery',8.058149364163249e-05,1,0,1
3559,3559,"'data-foo=""bar""'",8.058149364163249e-05,1,0,1
3560,3560,'data-popper-placement',8.058149364163249e-05,1,0,1
3561,3561,'deep',8.058149364163249e-05,1,0,1
3562,3562,'default',8.058149364163249e-05,1,0,1
3563,3563,'default-export-arrow.client',8.058149364163249e-05,1,0,1
3564,3564,'definedAction',8.058149364163249e-05,1,0,1
3565,3565,'dist',8.058149364163249e-05,1,0,1
3566,3566,'div.my-collapse',8.058149364163249e-05,1,0,1
3567,3567,'document.body.textContent',8.058149364163249e-05,1,0,1
3568,3568,'document.documentElement.scrollTop',8.058149364163249e-05,1,0,1
3569,3569,'done.invoke.invocation',8.058149364163249e-05,1,0,1
3570,3570,'dynamic page',8.058149364163249e-05,1,0,1
3571,3571,'eleven',8.058149364163249e-05,1,0,1
3572,3572,"'en, da'",8.058149364163249e-05,1,0,1
3573,3573,'en-gb',8.058149364163249e-05,1,0,1
3574,3574,'end',8.058149364163249e-05,1,0,1
3575,3575,'enter_B',8.058149364163249e-05,1,0,1
3576,3576,'enter_inner',8.058149364163249e-05,1,0,1
3577,3577,'enter_p1',8.058149364163249e-05,1,0,1
3578,3578,'entered one',8.058149364163249e-05,1,0,1
3579,3579,'entered three',8.058149364163249e-05,1,0,1
3580,3580,'entered two',8.058149364163249e-05,1,0,1
3581,3581,'entryAction',8.058149364163249e-05,1,0,1
3582,3582,'err',8.058149364163249e-05,1,0,1
3583,3583,'error',8.058149364163249e-05,1,0,1
3584,3584,'evenAction',8.058149364163249e-05,1,0,1
3585,3585,'example\\.com',8.058149364163249e-05,1,0,1
3586,3586,'existing',8.058149364163249e-05,1,0,1
3587,3587,'exit_A',8.058149364163249e-05,1,0,1
3588,3588,'f',8.058149364163249e-05,1,0,1
3589,3589,'fade',8.058149364163249e-05,1,0,1
3590,3590,'fetched',8.058149364163249e-05,1,0,1
3591,3591,'file',8.058149364163249e-05,1,0,1
3592,3592,'file1',8.058149364163249e-05,1,0,1
3593,3593,'file2',8.058149364163249e-05,1,0,1
3594,3594,'first-post',8.058149364163249e-05,1,0,1
3595,3595,'first/post',8.058149364163249e-05,1,0,1
3596,3596,'folder1',8.058149364163249e-05,1,0,1
3597,3597,'fonts/index.js',8.058149364163249e-05,1,0,1
3598,3598,'foo action',8.058149364163249e-05,1,0,1
3599,3599,'foo exit action',8.058149364163249e-05,1,0,1
3600,3600,'foo transition action',8.058149364163249e-05,1,0,1
3601,3601,"'foo""bar'",8.058149364163249e-05,1,0,1
3602,3602,'foo-id',8.058149364163249e-05,1,0,1
3603,3603,'foo.js',8.058149364163249e-05,1,0,1
3604,3604,'foo1',8.058149364163249e-05,1,0,1
3605,3605,'foobaz',8.058149364163249e-05,1,0,1
3606,3606,'go to dashboard',8.058149364163249e-05,1,0,1
3607,3607,'greet',8.058149364163249e-05,1,0,1
3608,3608,'gssp',8.058149364163249e-05,1,0,1
3609,3609,'hello from app/client-component-route',8.058149364163249e-05,1,0,1
3610,3610,'hello from app/dynamic-pages-route-app-overlap/app-dir/page',8.058149364163249e-05,1,0,1
3611,3611,'hello from new page',8.058149364163249e-05,1,0,1
3612,3612,'hello from slow page',8.058149364163249e-05,1,0,1
3613,3613,'hello from',8.058149364163249e-05,1,0,1
3614,3614,'hello world',8.058149364163249e-05,1,0,1
3615,3615,'hello!',8.058149364163249e-05,1,0,1
3616,3616,'hidden.bs.collapse',8.058149364163249e-05,1,0,1
3617,3617,'hiding',8.058149364163249e-05,1,0,1
3618,3618,'hmr!',8.058149364163249e-05,1,0,1
3619,3619,'http',8.058149364163249e-05,1,0,1
3620,3620,'http://example.com:3210/someA/pathB',8.058149364163249e-05,1,0,1
3621,3621,'http://example.com:3210/someA/pathB?fooC=barD#hashE',8.058149364163249e-05,1,0,1
3622,3622,'http://foo.com/about?param1=value1',8.058149364163249e-05,1,0,1
3623,3623,'http://localhost.com/root/example',8.058149364163249e-05,1,0,1
3624,3624,'http://localhost:3000/_next/static/development/_devMiddlewareManifest.json',8.058149364163249e-05,1,0,1
3625,3625,'http://n',8.058149364163249e-05,1,0,1
3626,3626,'https://example.com/image.png',8.058149364163249e-05,1,0,1
3627,3627,'https://example.com/image2.png',8.058149364163249e-05,1,0,1
3628,3628,'https://example.com/path/to/file',8.058149364163249e-05,1,0,1
3629,3629,'https://example.com/path/to?param1=value1#this-is-fragment',8.058149364163249e-05,1,0,1
3630,3630,'https://foo.com/example',8.058149364163249e-05,1,0,1
3631,3631,'https://foo.com/root/bar',8.058149364163249e-05,1,0,1
3632,3632,'https://next-data-api-endpoint.vercel.app/api/random?a1',8.058149364163249e-05,1,0,1
3633,3633,'https://vercel.com',8.058149364163249e-05,1,0,1
3634,3634,'iad1',8.058149364163249e-05,1,0,1
3635,3635,'icon.png',8.058149364163249e-05,1,0,1
3636,3636,'id',8.058149364163249e-05,1,0,1
3637,3637,'image/jpeg',8.058149364163249e-05,1,0,1
3638,3638,'img',8.058149364163249e-05,1,0,1
3639,3639,'increment',8.058149364163249e-05,1,0,1
3640,3640,'init',8.058149364163249e-05,1,0,1
3641,3641,'inline',8.058149364163249e-05,1,0,1
3642,3642,'invalidValue',8.058149364163249e-05,1,0,1
3643,3643,'invariant: invalid relative URL',8.058149364163249e-05,1,0,1
3644,3644,'invokeId',8.058149364163249e-05,1,0,1
3645,3645,'invokeSrc',8.058149364163249e-05,1,0,1
3646,3646,'item1 is focused',8.058149364163249e-05,1,0,1
3647,3647,'jsxfixture',8.058149364163249e-05,1,0,1
3648,3648,'jumping',8.058149364163249e-05,1,0,1
3649,3649,'large number',8.058149364163249e-05,1,0,1
3650,3650,'li',8.058149364163249e-05,1,0,1
3651,3651,'light',8.058149364163249e-05,1,0,1
3652,3652,'light.green',8.058149364163249e-05,1,0,1
3653,3653,'light.yellow',8.058149364163249e-05,1,0,1
3654,3654,"'link[rel=""icon""]'",8.058149364163249e-05,1,0,1
3655,3655,'linkfolder',8.058149364163249e-05,1,0,1
3656,3656,'loading',8.058149364163249e-05,1,0,1
3657,3657,'localhost.com',8.058149364163249e-05,1,0,1
3658,3658,'loves writing tests （╯°□°）╯︵ ┻━┻',8.058149364163249e-05,1,0,1
3659,3659,'machineChild',8.058149364163249e-05,1,0,1
3660,3660,'main catchall',8.058149364163249e-05,1,0,1
3661,3661,'map',8.058149364163249e-05,1,0,1
3662,3662,"'meta[property=""og:image""]'",8.058149364163249e-05,1,0,1
3663,3663,'middleware.js',8.058149364163249e-05,1,0,1
3664,3664,'mockRendererId1',8.058149364163249e-05,1,0,1
3665,3665,'mockRendererId2',8.058149364163249e-05,1,0,1
3666,3666,'morning',8.058149364163249e-05,1,0,1
3667,3667,'mouseenter',8.058149364163249e-05,1,0,1
3668,3668,'mouseleave',8.058149364163249e-05,1,0,1
3669,3669,'my-export-path',8.058149364163249e-05,1,0,1
3670,3670,'my-service',8.058149364163249e-05,1,0,1
3671,3671,'myId',8.058149364163249e-05,1,0,1
3672,3672,'myTag',8.058149364163249e-05,1,0,1
3673,3673,'named.client',8.058149364163249e-05,1,0,1
3674,3674,'navigator',8.058149364163249e-05,1,0,1
3675,3675,'new-request',8.058149364163249e-05,1,0,1
3676,3676,'next.router.asPath',8.058149364163249e-05,1,0,1
3677,3677,"'next.router.isReady ? ""yes"": ""no""'",8.058149364163249e-05,1,0,1
3678,3678,"'next.router.isReady ? ""yup"": ""nope""'",8.058149364163249e-05,1,0,1
3679,3679,'next.router.pathname',8.058149364163249e-05,1,0,1
3680,3680,'next.router.query.param',8.058149364163249e-05,1,0,1
3681,3681,'nine',8.058149364163249e-05,1,0,1
3682,3682,"'no-cache, no-store'",8.058149364163249e-05,1,0,1
3683,3683,'nothing',8.058149364163249e-05,1,0,1
3684,3684,'nxtPp',8.058149364163249e-05,1,0,1
3685,3685,'nxtPpost',8.058149364163249e-05,1,0,1
3686,3686,'nxtPslug',8.058149364163249e-05,1,0,1
3687,3687,'observableChild',8.058149364163249e-05,1,0,1
3688,3688,'odd',8.058149364163249e-05,1,0,1
3689,3689,'oddAction',8.058149364163249e-05,1,0,1
3690,3690,'opacity',8.058149364163249e-05,1,0,1
3691,3691,'open',8.058149364163249e-05,1,0,1
3692,3692,'order',8.058149364163249e-05,1,0,1
3693,3693,'overview',8.058149364163249e-05,1,0,1
3694,3694,'page-with-title',8.058149364163249e-05,1,0,1
3695,3695,'page.js.nft.json',8.058149364163249e-05,1,0,1
3696,3696,'pages/_document.js',8.058149364163249e-05,1,0,1
3697,3697,'pages/api/switch-in-dev.js',8.058149364163249e-05,1,0,1
3698,3698,'pages/index.js',8.058149364163249e-05,1,0,1
3699,3699,'pages/switch-in-dev.js',8.058149364163249e-05,1,0,1
3700,3700,'parallel layout',8.058149364163249e-05,1,0,1
3701,3701,'parallel',8.058149364163249e-05,1,0,1
3702,3702,'param-1',8.058149364163249e-05,1,0,1
3703,3703,'path',8.058149364163249e-05,1,0,1
3704,3704,'pingpong',8.058149364163249e-05,1,0,1
3705,3705,'post-2',8.058149364163249e-05,1,0,1
3706,3706,'post-3',8.058149364163249e-05,1,0,1
3707,3707,'present',8.058149364163249e-05,1,0,1
3708,3708,"'private, no-cache, no-store, max-age=0, must-revalidate'",8.058149364163249e-05,1,0,1
3709,3709,'production',8.058149364163249e-05,1,0,1
3710,3710,'promiseChild',8.058149364163249e-05,1,0,1
3711,3711,'prop3',8.058149364163249e-05,1,0,1
3712,3712,'prop4',8.058149364163249e-05,1,0,1
3713,3713,"'public, immutable, no-transform, max-age=31536000'",8.058149364163249e-05,1,0,1
3714,3714,"'public, max-age=3600'",8.058149364163249e-05,1,0,1
3715,3715,'pushBaz',8.058149364163249e-05,1,0,1
3716,3716,'query',8.058149364163249e-05,1,0,1
3717,3717,'quo',8.058149364163249e-05,1,0,1
3718,3718,'rawr',8.058149364163249e-05,1,0,1
3719,3719,'react-cosmos-plugin-boolean-input',8.058149364163249e-05,1,0,1
3720,3720,'react-cosmos-plugin-open-fixture',8.058149364163249e-05,1,0,1
3721,3721,'react-cosmos-plugin-vite',8.058149364163249e-05,1,0,1
3722,3722,'react-cosmos-plugin-webpack',8.058149364163249e-05,1,0,1
3723,3723,'react-dom',8.058149364163249e-05,1,0,1
3724,3724,'red.walk',8.058149364163249e-05,1,0,1
3725,3725,'referenced',8.058149364163249e-05,1,0,1
3726,3726,'refresh',8.058149364163249e-05,1,0,1
3727,3727,"'rel=""canonical""'",8.058149364163249e-05,1,0,1
3728,3728,'request',8.058149364163249e-05,1,0,1
3729,3729,'retry',8.058149364163249e-05,1,0,1
3730,3730,'root not found page',8.058149364163249e-05,1,0,1
3731,3731,'routeChangeStart',8.058149364163249e-05,1,0,1
3732,3732,'safe',8.058149364163249e-05,1,0,1
3733,3733,'same',8.058149364163249e-05,1,0,1
3734,3734,'sample1',8.058149364163249e-05,1,0,1
3735,3735,'sample2',8.058149364163249e-05,1,0,1
3736,3736,'seb',8.058149364163249e-05,1,0,1
3737,3737,'second state',8.058149364163249e-05,1,0,1
3738,3738,'selectFixture',8.058149364163249e-05,1,0,1
3739,3739,'self is not defined',8.058149364163249e-05,1,0,1
3740,3740,'server',8.058149364163249e-05,1,0,1
3741,3741,'setFixtureState',8.058149364163249e-05,1,0,1
3742,3742,'sfo1',8.058149364163249e-05,1,0,1
3743,3743,'shared/__fixtures__/Button.js',8.058149364163249e-05,1,0,1
3744,3744,'shown.bs.tooltip',8.058149364163249e-05,1,0,1
3745,3745,'single',8.058149364163249e-05,1,0,1
3746,3746,'six',8.058149364163249e-05,1,0,1
3747,3747,'slid.bs.carousel',8.058149364163249e-05,1,0,1
3748,3748,'slide.bs.carousel',8.058149364163249e-05,1,0,1
3749,3749,'slot catchall',8.058149364163249e-05,1,0,1
3750,3750,'small number',8.058149364163249e-05,1,0,1
3751,3751,'snow',8.058149364163249e-05,1,0,1
3752,3752,'some error',8.058149364163249e-05,1,0,1
3753,3753,'some-id',8.058149364163249e-05,1,0,1
3754,3754,'some-key',8.058149364163249e-05,1,0,1
3755,3755,'someSrc',8.058149364163249e-05,1,0,1
3756,3756,'somesessionid',8.058149364163249e-05,1,0,1
3757,3757,'source-map',8.058149364163249e-05,1,0,1
3758,3758,'src/Button.fixture.js',8.058149364163249e-05,1,0,1
3759,3759,'src/Counter.fixture.tsx',8.058149364163249e-05,1,0,1
3760,3760,'src/CounterButton.fixture.tsx',8.058149364163249e-05,1,0,1
3761,3761,'src/Dashboard.fixture.js',8.058149364163249e-05,1,0,1
3762,3762,'src/WelcomeMessage/WelcomeMessage.fixture.tsx',8.058149364163249e-05,1,0,1
3763,3763,'src/__fixtures__/controls/Custom Panel.tsx',8.058149364163249e-05,1,0,1
3764,3764,'src/__fixtures__/controls/Props Panel.tsx',8.058149364163249e-05,1,0,1
3765,3765,'src/admin/Dashboard/index.fixture.ts',8.058149364163249e-05,1,0,1
3766,3766,'src/ui/admin/Dashboard.fixture.js',8.058149364163249e-05,1,0,1
3767,3767,'src2',8.058149364163249e-05,1,0,1
3768,3768,'st b.b1',8.058149364163249e-05,1,0,1
3769,3769,'standing',8.058149364163249e-05,1,0,1
3770,3770,'state b.b1',8.058149364163249e-05,1,0,1
3771,3771,'stats',8.058149364163249e-05,1,0,1
3772,3772,'str',8.058149364163249e-05,1,0,1
3773,3773,'styleguide/components/StyleGuide',8.058149364163249e-05,1,0,1
3774,3774,'styleguide/components/Wrapper',8.058149364163249e-05,1,0,1
3775,3775,'subdir/cosmos.config.json',8.058149364163249e-05,1,0,1
3776,3776,'swapped from',8.058149364163249e-05,1,0,1
3777,3777,'tabpanel',8.058149364163249e-05,1,0,1
3778,3778,'target',8.058149364163249e-05,1,0,1
3779,3779,'test error',8.058149364163249e-05,1,0,1
3780,3780,'test.png',8.058149364163249e-05,1,0,1
3781,3781,'testMethod',8.058149364163249e-05,1,0,1
3782,3782,'testing meta',8.058149364163249e-05,1,0,1
3783,3783,'thanks',8.058149364163249e-05,1,0,1
3784,3784,'the secret',8.058149364163249e-05,1,0,1
3785,3785,'theTag',8.058149364163249e-05,1,0,1
3786,3786,'third',8.058149364163249e-05,1,0,1
3787,3787,'timeout',8.058149364163249e-05,1,0,1
3788,3788,'timer',8.058149364163249e-05,1,0,1
3789,3789,'to',8.058149364163249e-05,1,0,1
3790,3790,'todo.add',8.058149364163249e-05,1,0,1
3791,3791,'toggle',8.058149364163249e-05,1,0,1
3792,3792,'tomato',8.058149364163249e-05,1,0,1
3793,3793,'ui.js',8.058149364163249e-05,1,0,1
3794,3794,'ui/Button.fixture.js',8.058149364163249e-05,1,0,1
3795,3795,'ui/Dashboard/Dashboard.fixture.js',8.058149364163249e-05,1,0,1
3796,3796,'ui/__fixtures__/shared/Button.js',8.058149364163249e-05,1,0,1
3797,3797,'ui/shared/Button.fixture.js',8.058149364163249e-05,1,0,1
3798,3798,'undefinedAction',8.058149364163249e-05,1,0,1
3799,3799,'unsaved',8.058149364163249e-05,1,0,1
3800,3800,'unselectFixture',8.058149364163249e-05,1,0,1
3801,3801,'update',8.058149364163249e-05,1,0,1
3802,3802,'updateAge',8.058149364163249e-05,1,0,1
3803,3803,'user-agent',8.058149364163249e-05,1,0,1
3804,3804,'vier.js',8.058149364163249e-05,1,0,1
3805,3805,'wait',8.058149364163249e-05,1,0,1
3806,3806,'walk',8.058149364163249e-05,1,0,1
3807,3807,'walking',8.058149364163249e-05,1,0,1
3808,3808,'window.__TEST_NO_RELOAD = true',8.058149364163249e-05,1,0,1
3809,3809,'window._test',8.058149364163249e-05,1,0,1
3810,3810,'window.location.hash',8.058149364163249e-05,1,0,1
3811,3811,'window.pageYOffset',8.058149364163249e-05,1,0,1
3812,3812,'x-next-cache-tags',8.058149364163249e-05,1,0,1
3813,3813,'x-nextjs-data',8.058149364163249e-05,1,0,1
3814,3814,'x-nextjs-rewrite',8.058149364163249e-05,1,0,1
3815,3815,'xyz',8.058149364163249e-05,1,0,1
3816,3816,"'{""category"":""books"",""id"":""hello-world""}'",8.058149364163249e-05,1,0,1
3817,3817,"'{""url"":""https://www.example.com""}'",8.058149364163249e-05,1,0,1
3818,3818,"/""slug"":""first""/",8.058149364163249e-05,1,0,1
3819,3819,/Comment:.*?comment-2/,8.058149364163249e-05,1,0,1
3820,3820,/Increment/,8.058149364163249e-05,1,0,1
3821,3821,/Post:.*?pewpew/,8.058149364163249e-05,1,0,1
3822,3822,/Post:.*?post-2/,8.058149364163249e-05,1,0,1
3823,3823,/Returned by Edge API Route .+\/api\/edge/,8.058149364163249e-05,1,0,1
3824,3824,"/Warning: data for page ""\/large-page-data-ssr"" is 256 kB which exceeds the threshold of 128 kB, this amount of data can reduce performance/",8.058149364163249e-05,1,0,1
3825,3825,/\/world.txt/,8.058149364163249e-05,1,0,1
3826,3826,"/^'__Open_Sans_.{6}', '__Open_Sans_Fallback_.{6}'$/",8.058149364163249e-05,1,0,1
3827,3827,/^Cannot redefine property/,8.058149364163249e-05,1,0,1
3828,3828,"/^__Open_Sans_.{6}, __Open_Sans_Fallback_.{6}$/",8.058149364163249e-05,1,0,1
3829,3829,"/^__Open_Sans_.{6}, system-ui, Arial$/",8.058149364163249e-05,1,0,1
3830,3830,/^__variable_.{6}$/,8.058149364163249e-05,1,0,1
3831,3831,/a slow page/,8.058149364163249e-05,1,0,1
3832,3832,/chunks\/.*?\.js/,8.058149364163249e-05,1,0,1
3833,3833,/comment-3/,8.058149364163249e-05,1,0,1
3834,3834,/first/,8.058149364163249e-05,1,0,1
3835,3835,/http:\/\/localhost:\d+/,8.058149364163249e-05,1,0,1
3836,3836,/https:\/\/[\w-]+.vercel.app/,8.058149364163249e-05,1,0,1
3837,3837,/node_modules\/@firebase\/firestore\/.*?\.js/,8.058149364163249e-05,1,0,1
3838,3838,/node_modules\/next/,8.058149364163249e-05,1,0,1
3839,3839,/pewpewdata/,8.058149364163249e-05,1,0,1
3840,3840,/post-2/,8.058149364163249e-05,1,0,1
3841,3841,/second/,8.058149364163249e-05,1,0,1
3842,3842,1337,8.058149364163249e-05,1,0,1
3843,3843,14,8.058149364163249e-05,1,0,1
3844,3844,1500,8.058149364163249e-05,1,0,1
3845,3845,1814,8.058149364163249e-05,1,0,1
3846,3846,201,8.058149364163249e-05,1,0,1
3847,3847,307,8.058149364163249e-05,1,0,1
3848,3848,30_000,8.058149364163249e-05,1,0,1
3849,3849,420,8.058149364163249e-05,1,0,1
3850,3850,60,8.058149364163249e-05,1,0,1
3851,3851,79,8.058149364163249e-05,1,0,1
3852,3852,8989,8.058149364163249e-05,1,0,1
3853,3853,AbortController,8.058149364163249e-05,1,0,1
3854,3854,AgeUpdateEvent,8.058149364163249e-05,1,0,1
3855,3855,Asd,8.058149364163249e-05,1,0,1
3856,3856,BarEvent,8.058149364163249e-05,1,0,1
3857,3857,BarResolvePlugin,8.058149364163249e-05,1,0,1
3858,3858,BaseClass,8.058149364163249e-05,1,0,1
3859,3859,Box,8.058149364163249e-05,1,0,1
3860,3860,Buffer,8.058149364163249e-05,1,0,1
3861,3861,CLOSE,8.058149364163249e-05,1,0,1
3862,3862,COUNTDOWN,8.058149364163249e-05,1,0,1
3863,3863,CUSTOM_CACHE_HANDLER,8.058149364163249e-05,1,0,1
3864,3864,CallbackEvent,8.058149364163249e-05,1,0,1
3865,3865,Card,8.058149364163249e-05,1,0,1
3866,3866,ChangePassword,8.058149364163249e-05,1,0,1
3867,3867,ChildActionBound,8.058149364163249e-05,1,0,1
3868,3868,ChildEvent,8.058149364163249e-05,1,0,1
3869,3869,ChildFlow,8.058149364163249e-05,1,0,1
3870,3870,ChildFlowBound,8.058149364163249e-05,1,0,1
3871,3871,ColumnsRenderer,8.058149364163249e-05,1,0,1
3872,3872,ComponentOne,8.058149364163249e-05,1,0,1
3873,3873,ComponentTwo,8.058149364163249e-05,1,0,1
3874,3874,ComponentsRenderer,8.058149364163249e-05,1,0,1
3875,3875,CountCtx,8.058149364163249e-05,1,0,1
3876,3876,CountEvents,8.058149364163249e-05,1,0,1
3877,3877,DEPLOY,8.058149364163249e-05,1,0,1
3878,3878,DOCS_TAB_USAGE,8.058149364163249e-05,1,0,1
3879,3879,DeepObject,8.058149364163249e-05,1,0,1
3880,3880,DefaultAllowlist,8.058149364163249e-05,1,0,1
3881,3881,ESC,8.058149364163249e-05,1,0,1
3882,3882,FORWARD_DEC,8.058149364163249e-05,1,0,1
3883,3883,FooEvent,8.058149364163249e-05,1,0,1
3884,3884,FooResolvePlugin,8.058149364163249e-05,1,0,1
3885,3885,Foobar,8.058149364163249e-05,1,0,1
3886,3886,FormContext,8.058149364163249e-05,1,0,1
3887,3887,FormEvent,8.058149364163249e-05,1,0,1
3888,3888,FunctionalComponent,8.058149364163249e-05,1,0,1
3889,3889,GOTO_FOOBAZ,8.058149364163249e-05,1,0,1
3890,3890,GO_TO_A,8.058149364163249e-05,1,0,1
3891,3891,Game,8.058149364163249e-05,1,0,1
3892,3892,INACTIVATE,8.058149364163249e-05,1,0,1
3893,3893,INT1,8.058149364163249e-05,1,0,1
3894,3894,INT2,8.058149364163249e-05,1,0,1
3895,3895,ImmerUpdateEvent,8.058149364163249e-05,1,0,1
3896,3896,InitEvent,8.058149364163249e-05,1,0,1
3897,3897,InterpreterEvent,8.058149364163249e-05,1,0,1
3898,3898,ItemsStore,8.058149364163249e-05,1,0,1
3899,3899,LONG,8.058149364163249e-05,1,0,1
3900,3900,LazyInitializedList,8.058149364163249e-05,1,0,1
3901,3901,LogoRenderer,8.058149364163249e-05,1,0,1
3902,3902,MachineTypestate,8.058149364163249e-05,1,0,1
3903,3903,MainMachineCtx,8.058149364163249e-05,1,0,1
3904,3904,MarkdownHeading,8.058149364163249e-05,1,0,1
3905,3905,Menu,8.058149364163249e-05,1,0,1
3906,3906,ModuleScopePlugin,8.058149364163249e-05,1,0,1
3907,3907,MouseEvent,8.058149364163249e-05,1,0,1
3908,3908,MyContext,8.058149364163249e-05,1,0,1
3909,3909,NEXT_RSC_UNION_QUERY,8.058149364163249e-05,1,0,1
3910,3910,NODE_ENV,8.058149364163249e-05,1,0,1
3911,3911,NONE,8.058149364163249e-05,1,0,1
3912,3912,NameUpdateEvent,8.058149364163249e-05,1,0,1
3913,3913,NextRequest,8.058149364163249e-05,1,0,1
3914,3914,ObservableMapLimitedSize,8.058149364163249e-05,1,0,1
3915,3915,ObservableSetLimitedSize,8.058149364163249e-05,1,0,1
3916,3916,PHASE_DEVELOPMENT_SERVER,8.058149364163249e-05,1,0,1
3917,3917,PROXY_PORT,8.058149364163249e-05,1,0,1
3918,3918,Pages,8.058149364163249e-05,1,0,1
3919,3919,Person,8.058149364163249e-05,1,0,1
3920,3920,Pre,8.058149364163249e-05,1,0,1
3921,3921,PromiseExecutor,8.058149364163249e-05,1,0,1
3922,3922,PromiseLike,8.058149364163249e-05,1,0,1
3923,3923,RSC,8.058149364163249e-05,1,0,1
3924,3924,ReactComponent,8.058149364163249e-05,1,0,1
3925,3925,Record,8.058149364163249e-05,1,0,1
3926,3926,SAMPLE,8.058149364163249e-05,1,0,1
3927,3927,SERVER_PORT,8.058149364163249e-05,1,0,1
3928,3928,STOPPED,8.058149364163249e-05,1,0,1
3929,3929,SectionHeading,8.058149364163249e-05,1,0,1
3930,3930,SectionsRenderer,8.058149364163249e-05,1,0,1
3931,3931,SignInContext,8.058149364163249e-05,1,0,1
3932,3932,SomeClass,8.058149364163249e-05,1,0,1
3933,3933,StyleGuideRenderer,8.058149364163249e-05,1,0,1
3934,3934,StyledSectionsRenderer,8.058149364163249e-05,1,0,1
3935,3935,SubClass,8.058149364163249e-05,1,0,1
3936,3936,Symbol,8.058149364163249e-05,1,0,1
3937,3937,SyncMachineContext,8.058149364163249e-05,1,0,1
3938,3938,T,8.058149364163249e-05,1,0,1
3939,3939,TOGGLE_BOLD,8.058149364163249e-05,1,0,1
3940,3940,Table,8.058149364163249e-05,1,0,1
3941,3941,TableBody,8.058149364163249e-05,1,0,1
3942,3942,TableCell,8.058149364163249e-05,1,0,1
3943,3943,TableHead,8.058149364163249e-05,1,0,1
3944,3944,TableRow,8.058149364163249e-05,1,0,1
3945,3945,Test Title,8.058149364163249e-05,1,0,1
3946,3946,TestState,8.058149364163249e-05,1,0,1
3947,3947,The heading,8.058149364163249e-05,1,0,1
3948,3948,Time,8.058149364163249e-05,1,0,1
3949,3949,ToggleEvents,8.058149364163249e-05,1,0,1
3950,3950,TypeError,8.058149364163249e-05,1,0,1
3951,3951,TypeRenderer,8.058149364163249e-05,1,0,1
3952,3952,Typestates,8.058149364163249e-05,1,0,1
3953,3953,UNKNOWN_KEY,8.058149364163249e-05,1,0,1
3954,3954,UPDATE,8.058149364163249e-05,1,0,1
3955,3955,UglifyJsPlugin,8.058149364163249e-05,1,0,1
3956,3956,User,8.058149364163249e-05,1,0,1
3957,3957,UserModelEvent,8.058149364163249e-05,1,0,1
3958,3958,UserModelEventSubset,8.058149364163249e-05,1,0,1
3959,3959,WebSocket,8.058149364163249e-05,1,0,1
3960,3960,Window,8.058149364163249e-05,1,0,1
3961,3961,WrappedComponent,8.058149364163249e-05,1,0,1
3962,3962,X,8.058149364163249e-05,1,0,1
3963,3963,__fixtures__,8.058149364163249e-05,1,0,1
3964,3964,__spy__,8.058149364163249e-05,1,0,1
3965,3965,_env,8.058149364163249e-05,1,0,1
3966,3966,_focustrap,8.058149364163249e-05,1,0,1
3967,3967,_isActive,8.058149364163249e-05,1,0,1
3968,3968,_isAppended,8.058149364163249e-05,1,0,1
3969,3969,_isEnabled,8.058149364163249e-05,1,0,1
3970,3970,_isTransitioning,8.058149364163249e-05,1,0,1
3971,3971,_sessionid,8.058149364163249e-05,1,0,1
3972,3972,_swipeHelper,8.058149364163249e-05,1,0,1
3973,3973,_templateFactory,8.058149364163249e-05,1,0,1
3974,3974,_val,8.058149364163249e-05,1,0,1
3975,3975,"`
        ""[MobX] Cannot convert 'TestObject' into observable object:
        The target is already observable of different type.
        Extending builtins is not supported.""
    `",8.058149364163249e-05,1,0,1
3976,3976,"`
        [
          document.querySelector('#react').innerText,
          document.querySelector('#react-dom').innerText,
          document.querySelector('#react-dom-server').innerText,
        ]
      `",8.058149364163249e-05,1,0,1
3977,3977,"`
      ""Error serializing \`.toplevel\` returned from \`test\` in \\""/\\"".
      Reason: \`function\` cannot be serialized as JSON. Please only return JSON serializable data types.""
    `",8.058149364163249e-05,1,0,1
3978,3978,"`
      ""Error serializing props returned from \`test\` in \\""/\\"".
      Reason: Props must be returned as a plain object from test: \`{ props: { ... } }\` (received: \`[object Function]\`).""
    `",8.058149364163249e-05,1,0,1
3979,3979,"`""${",8.058149364163249e-05,1,0,1
3980,3980,"`""Optional route parameters are not yet supported (\\""[[blog]]\\"").""`",8.058149364163249e-05,1,0,1
3981,3981,"`""Segment names may not start or end with extra brackets ('[...id').""`",8.058149364163249e-05,1,0,1
3982,3982,"`""Segment names may not start or end with extra brackets ('id]').""`",8.058149364163249e-05,1,0,1
3983,3983,"`""You cannot define a route with the same specificity as a optional catch-all route (\\""/\\"" and \\""/[[...all]]\\"").""`",8.058149364163249e-05,1,0,1
3984,3984,"`""You cannot define a route with the same specificity as a optional catch-all route (\\""/sub\\"" and \\""/sub[[...all]]\\"").""`",8.058149364163249e-05,1,0,1
3985,3985,`/api/${,8.058149364163249e-05,1,0,1
3986,3986,`/blog/${,8.058149364163249e-05,1,0,1
3987,3987,`/force-dynamic-prerender/${,8.058149364163249e-05,1,0,1
3988,3988,`/rewrite-to-afterfiles-rewrite`,8.058149364163249e-05,1,0,1
3989,3989,`/rewrite-to-beforefiles-rewrite`,8.058149364163249e-05,1,0,1
3990,3990,`/to-blog/${,8.058149364163249e-05,1,0,1
3991,3991,"`<meta name=""description"" content=""Test description"" data-react-helmet=""true"">`",8.058149364163249e-05,1,0,1
3992,3992,"`You can not use getStaticProps or getStaticPaths with getServerSideProps. To use SSG, please remove getServerSideProps`",8.058149364163249e-05,1,0,1
3993,3993,`You should not access 'res' after getServerSideProps resolves`,8.058149364163249e-05,1,0,1
3994,3994,`[mobx] Computed value 'a.y' is being read outside a reactive context. Doing a full recompute.`,8.058149364163249e-05,1,0,1
3995,3995,"`a[href=""/nested-navigation/${",8.058149364163249e-05,1,0,1
3996,3996,`another-${,8.058149364163249e-05,1,0,1
3997,3997,`const a = () => <>hello</>;`,8.058149364163249e-05,1,0,1
3998,3998,`document.cookie.match(/test-cookie=(\\d+)/)?.[1]`,8.058149364163249e-05,1,0,1
3999,3999,`getStaticProps test-if-generated-1`,8.058149364163249e-05,1,0,1
4000,4000,`http://localhost:${,8.058149364163249e-05,1,0,1
4001,4001,`https:\\/\\/(${,8.058149364163249e-05,1,0,1
4002,4002,`plugin-${,8.058149364163249e-05,1,0,1
4003,4003,`window.getComputedStyle(document.querySelector('#sass-server-layout')).color`,8.058149364163249e-05,1,0,1
4004,4004,`window.getComputedStyle(document.querySelector('#scss-server-layout')).color`,8.058149364163249e-05,1,0,1
4005,4005,`window.getComputedStyle(document.querySelector('body')).backgroundColor`,8.058149364163249e-05,1,0,1
4006,4006,`ws://localhost:${,8.058149364163249e-05,1,0,1
4007,4007,"`{""slug"":""foo"",""id"":""bar""}`",8.058149364163249e-05,1,0,1
4008,4008,a1,8.058149364163249e-05,1,0,1
4009,4009,a2,8.058149364163249e-05,1,0,1
4010,4010,aActive,8.058149364163249e-05,1,0,1
4011,4011,aFunction,8.058149364163249e-05,1,0,1
4012,4012,abort,8.058149364163249e-05,1,0,1
4013,4013,aboutAppPagePath,8.058149364163249e-05,1,0,1
4014,4014,absImport,8.058149364163249e-05,1,0,1
4015,4015,absoluteFilePath,8.058149364163249e-05,1,0,1
4016,4016,acc,8.058149364163249e-05,1,0,1
4017,4017,acceptEvent,8.058149364163249e-05,1,0,1
4018,4018,acceptInterpreterEvent,8.058149364163249e-05,1,0,1
4019,4019,acceptUserModelEvent,8.058149364163249e-05,1,0,1
4020,4020,acceptUserModelEventSubset,8.058149364163249e-05,1,0,1
4021,4021,actionCalled,8.058149364163249e-05,1,0,1
4022,4022,actionComputed,8.058149364163249e-05,1,0,1
4023,4023,actionMachine,8.058149364163249e-05,1,0,1
4024,4024,actionName,8.058149364163249e-05,1,0,1
4025,4025,actionProp,8.058149364163249e-05,1,0,1
4026,4026,actionService,8.058149364163249e-05,1,0,1
4027,4027,actionSymbol,8.058149364163249e-05,1,0,1
4028,4028,actionsCount,8.058149364163249e-05,1,0,1
4029,4029,activeListName,8.058149364163249e-05,1,0,1
4030,4030,activeTabPane,8.058149364163249e-05,1,0,1
4031,4031,activityActive,8.058149364163249e-05,1,0,1
4032,4032,activityState,8.058149364163249e-05,1,0,1
4033,4033,actorStopped,8.058149364163249e-05,1,0,1
4034,4034,actualForReturn,8.058149364163249e-05,1,0,1
4035,4035,actualForReturns,8.058149364163249e-05,1,0,1
4036,4036,actualState,8.058149364163249e-05,1,0,1
4037,4037,addSize,8.058149364163249e-05,1,0,1
4038,4038,ageUpdater,8.058149364163249e-05,1,0,1
4039,4039,alertByElement,8.058149364163249e-05,1,0,1
4040,4040,alertBySelector,8.058149364163249e-05,1,0,1
4041,4041,allArgs,8.058149364163249e-05,1,0,1
4042,4042,allStateNodeOrders,8.058149364163249e-05,1,0,1
4043,4043,analysis,8.058149364163249e-05,1,0,1
4044,4044,anchor,8.058149364163249e-05,1,0,1
4045,4045,anonMachine,8.058149364163249e-05,1,0,1
4046,4046,anotherBtn,8.058149364163249e-05,1,0,1
4047,4047,anotherMachine,8.058149364163249e-05,1,0,1
4048,4048,apiRes,8.058149364163249e-05,1,0,1
4049,4049,appBuildManifest,8.058149364163249e-05,1,0,1
4050,4050,appHtml,8.058149364163249e-05,1,0,1
4051,4051,appPath,8.058149364163249e-05,1,0,1
4052,4052,append,8.058149364163249e-05,1,0,1
4053,4053,appleTouchIconUrls,8.058149364163249e-05,1,0,1
4054,4054,ar,8.058149364163249e-05,1,0,1
4055,4055,argv,8.058149364163249e-05,1,0,1
4056,4056,arrayOrObservableArray,8.058149364163249e-05,1,0,1
4057,4057,article,8.058149364163249e-05,1,0,1
4058,4058,asd,8.058149364163249e-05,1,0,1
4059,4059,assetPrefix,8.058149364163249e-05,1,0,1
4060,4060,assetsDir,8.058149364163249e-05,1,0,1
4061,4061,assignEventLog,8.058149364163249e-05,1,0,1
4062,4062,assignMachine,8.058149364163249e-05,1,0,1
4063,4063,asyncWithDoneMachine,8.058149364163249e-05,1,0,1
4064,4064,attachShadow,8.058149364163249e-05,1,0,1
4065,4065,authClientMachine,8.058149364163249e-05,1,0,1
4066,4066,authMachine,8.058149364163249e-05,1,0,1
4067,4067,authServerMachine,8.058149364163249e-05,1,0,1
4068,4068,autoForward,8.058149364163249e-05,1,0,1
4069,4069,autoruns,8.058149364163249e-05,1,0,1
4070,4070,b3,8.058149364163249e-05,1,0,1
4071,4071,b4,8.058149364163249e-05,1,0,1
4072,4072,bState,8.058149364163249e-05,1,0,1
4073,4073,backSequenceMachine,8.058149364163249e-05,1,0,1
4074,4074,backdropSpy,8.058149364163249e-05,1,0,1
4075,4075,barDelay,8.058149364163249e-05,1,0,1
4076,4076,barState,8.058149364163249e-05,1,0,1
4077,4077,baseComponent,8.058149364163249e-05,1,0,1
4078,4078,baseInstance,8.058149364163249e-05,1,0,1
4079,4079,baseTag,8.058149364163249e-05,1,0,1
4080,4080,baseTitle,8.058149364163249e-05,1,0,1
4081,4081,bazUpdater,8.058149364163249e-05,1,0,1
4082,4082,big$,8.058149364163249e-05,1,0,1
4083,4083,bigOgUrl,8.058149364163249e-05,1,0,1
4084,4084,binary,8.058149364163249e-05,1,0,1
4085,4085,blink,8.058149364163249e-05,1,0,1
4086,4086,blue,8.058149364163249e-05,1,0,1
4087,4087,bogusSetting,8.058149364163249e-05,1,0,1
4088,4088,bold,8.058149364163249e-05,1,0,1
4089,4089,bool,8.058149364163249e-05,1,0,1
4090,4090,bool2,8.058149364163249e-05,1,0,1
4091,4091,boolProp,8.058149364163249e-05,1,0,1
4092,4092,boxedSum,8.058149364163249e-05,1,0,1
4093,4093,break,8.058149364163249e-05,1,0,1
4094,4094,brokenMachine,8.058149364163249e-05,1,0,1
4095,4095,browserAppReactVersions,8.058149364163249e-05,1,0,1
4096,4096,browserClientText,8.058149364163249e-05,1,0,1
4097,4097,browserEdgePagesReactVersions,8.058149364163249e-05,1,0,1
4098,4098,browserLogs,8.058149364163249e-05,1,0,1
4099,4099,browserOnIndexPage,8.058149364163249e-05,1,0,1
4100,4100,browserPagesReactVersions,8.058149364163249e-05,1,0,1
4101,4101,btnCloseEl,8.058149364163249e-05,1,0,1
4102,4102,btnDropdown1,8.058149364163249e-05,1,0,1
4103,4103,btnDropdown2,8.058149364163249e-05,1,0,1
4104,4104,btnTestParent,8.058149364163249e-05,1,0,1
4105,4105,bufferBig,8.058149364163249e-05,1,0,1
4106,4106,bufferSmall,8.058149364163249e-05,1,0,1
4107,4107,buildErrorMsg,8.058149364163249e-05,1,0,1
4108,4108,buttonByElement,8.058149364163249e-05,1,0,1
4109,4109,buttonBySelector,8.058149364163249e-05,1,0,1
4110,4110,cacheHeader,8.058149364163249e-05,1,0,1
4111,4111,callCount,8.058149364163249e-05,1,0,1
4112,4112,callInitialState,8.058149364163249e-05,1,0,1
4113,4113,callOrder,8.058149364163249e-05,1,0,1
4114,4114,callbackService,8.058149364163249e-05,1,0,1
4115,4115,called1,8.058149364163249e-05,1,0,1
4116,4116,called2,8.058149364163249e-05,1,0,1
4117,4117,calledCallback1,8.058149364163249e-05,1,0,1
4118,4118,calledCallback2,8.058149364163249e-05,1,0,1
4119,4119,canUseDOM,8.058149364163249e-05,1,0,1
4120,4120,cancel,8.058149364163249e-05,1,0,1
4121,4121,canonicalUrl,8.058149364163249e-05,1,0,1
4122,4122,card1,8.058149364163249e-05,1,0,1
4123,4123,card2,8.058149364163249e-05,1,0,1
4124,4124,carousel2,8.058149364163249e-05,1,0,1
4125,4125,carouselByElement,8.058149364163249e-05,1,0,1
4126,4126,carouselBySelector,8.058149364163249e-05,1,0,1
4127,4127,case,8.058149364163249e-05,1,0,1
4128,4128,category,8.058149364163249e-05,1,0,1
4129,4129,changeList,8.058149364163249e-05,1,0,1
4130,4130,changeOrigin,8.058149364163249e-05,1,0,1
4131,4131,changePassword,8.058149364163249e-05,1,0,1
4132,4132,charSet,8.058149364163249e-05,1,0,1
4133,4133,checkUrl,8.058149364163249e-05,1,0,1
4134,4134,checkUrlPath,8.058149364163249e-05,1,0,1
4135,4135,childBtn1,8.058149364163249e-05,1,0,1
4136,4136,childBtn2,8.058149364163249e-05,1,0,1
4137,4137,childCollapseEl1,8.058149364163249e-05,1,0,1
4138,4138,childCollapseEl2,8.058149364163249e-05,1,0,1
4139,4139,childElement,8.058149364163249e-05,1,0,1
4140,4140,childOrigin,8.058149364163249e-05,1,0,1
4141,4141,childThings,8.058149364163249e-05,1,0,1
4142,4142,chunk,8.058149364163249e-05,1,0,1
4143,4143,circle,8.058149364163249e-05,1,0,1
4144,4144,cleanedOutput,8.058149364163249e-05,1,0,1
4145,4145,clickListener,8.058149364163249e-05,1,0,1
4146,4146,client2,8.058149364163249e-05,1,0,1
4147,4147,clientContent,8.058149364163249e-05,1,0,1
4148,4148,clientModulesNames,8.058149364163249e-05,1,0,1
4149,4149,clientReferenceManifest,8.058149364163249e-05,1,0,1
4150,4150,clone,8.058149364163249e-05,1,0,1
4151,4151,closeEl,8.058149364163249e-05,1,0,1
4152,4152,closedPaths,8.058149364163249e-05,1,0,1
4153,4153,collapseByElement,8.058149364163249e-05,1,0,1
4154,4154,collapseBySelector,8.058149364163249e-05,1,0,1
4155,4155,collapseEl1,8.058149364163249e-05,1,0,1
4156,4156,collapseEl2,8.058149364163249e-05,1,0,1
4157,4157,collapseList,8.058149364163249e-05,1,0,1
4158,4158,collapseOneEl,8.058149364163249e-05,1,0,1
4159,4159,collapseOneOne,8.058149364163249e-05,1,0,1
4160,4160,collapseOneTwo,8.058149364163249e-05,1,0,1
4161,4161,collapseTwoEl,8.058149364163249e-05,1,0,1
4162,4162,collapseTwoOne,8.058149364163249e-05,1,0,1
4163,4163,collapseTwoTwo,8.058149364163249e-05,1,0,1
4164,4164,collapsedElements,8.058149364163249e-05,1,0,1
4165,4165,complete,8.058149364163249e-05,1,0,1
4166,4166,componentPath,8.058149364163249e-05,1,0,1
4167,4167,composerMachine,8.058149364163249e-05,1,0,1
4168,4168,computed2,8.058149364163249e-05,1,0,1
4169,4169,computedSymbol,8.058149364163249e-05,1,0,1
4170,4170,computedVal,8.058149364163249e-05,1,0,1
4171,4171,configMachine,8.058149364163249e-05,1,0,1
4172,4172,configs,8.058149364163249e-05,1,0,1
4173,4173,configure,8.058149364163249e-05,1,0,1
4174,4174,conflicts,8.058149364163249e-05,1,0,1
4175,4175,consoleWarn,8.058149364163249e-05,1,0,1
4176,4176,containClientContent,8.058149364163249e-05,1,0,1
4177,4177,containFrameworkChunk,8.058149364163249e-05,1,0,1
4178,4178,containerEl,8.058149364163249e-05,1,0,1
4179,4179,contentType,8.058149364163249e-05,1,0,1
4180,4180,controller1,8.058149364163249e-05,1,0,1
4181,4181,controller2,8.058149364163249e-05,1,0,1
4182,4182,controller3,8.058149364163249e-05,1,0,1
4183,4183,cookieArray,8.058149364163249e-05,1,0,1
4184,4184,cookieHeader,8.058149364163249e-05,1,0,1
4185,4185,cookieName,8.058149364163249e-05,1,0,1
4186,4186,countBtn,8.058149364163249e-05,1,0,1
4187,4187,countButton,8.058149364163249e-05,1,0,1
4188,4188,countContext,8.058149364163249e-05,1,0,1
4189,4189,countEvents,8.058149364163249e-05,1,0,1
4190,4190,countObject,8.058149364163249e-05,1,0,1
4191,4191,createChild,8.058149364163249e-05,1,0,1
4192,4192,createEmptyObservable,8.058149364163249e-05,1,0,1
4193,4193,createMachineWithExtras,8.058149364163249e-05,1,0,1
4194,4194,createMyMachine,8.058149364163249e-05,1,0,1
4195,4195,createParent,8.058149364163249e-05,1,0,1
4196,4196,createPromise,8.058149364163249e-05,1,0,1
4197,4197,createProxy,8.058149364163249e-05,1,0,1
4198,4198,createThenable,8.058149364163249e-05,1,0,1
4199,4199,createUpdater,8.058149364163249e-05,1,0,1
4200,4200,crosswalk1,8.058149364163249e-05,1,0,1
4201,4201,crosswalk2,8.058149364163249e-05,1,0,1
4202,4202,cssBlue,8.058149364163249e-05,1,0,1
4203,4203,cssText,8.058149364163249e-05,1,0,1
4204,4204,cssText1,8.058149364163249e-05,1,0,1
4205,4205,cssText2,8.058149364163249e-05,1,0,1
4206,4206,cur,8.058149364163249e-05,1,0,1
4207,4207,curDate,8.058149364163249e-05,1,0,1
4208,4208,curManifest,8.058149364163249e-05,1,0,1
4209,4209,curNextConfig,8.058149364163249e-05,1,0,1
4210,4210,curRandomData,8.058149364163249e-05,1,0,1
4211,4211,curScroll,8.058149364163249e-05,1,0,1
4212,4212,currentMargin,8.058149364163249e-05,1,0,1
4213,4213,currentPadding2,8.058149364163249e-05,1,0,1
4214,4214,currentStates,8.058149364163249e-05,1,0,1
4215,4215,currentTarget,8.058149364163249e-05,1,0,1
4216,4216,currentTestCookie,8.058149364163249e-05,1,0,1
4217,4217,currentTime,8.058149364163249e-05,1,0,1
4218,4218,currentTimestamp,8.058149364163249e-05,1,0,1
4219,4219,customDuration,8.058149364163249e-05,1,0,1
4220,4220,cycle,8.058149364163249e-05,1,0,1
4221,4221,dashboardState,8.058149364163249e-05,1,0,1
4222,4222,dataStr,8.058149364163249e-05,1,0,1
4223,4223,deepEnhancer,8.058149364163249e-05,1,0,1
4224,4224,deepFlatParallelMachine,8.058149364163249e-05,1,0,1
4225,4225,deepO,8.058149364163249e-05,1,0,1
4226,4226,deepObj,8.058149364163249e-05,1,0,1
4227,4227,deepState,8.058149364163249e-05,1,0,1
4228,4228,default,8.058149364163249e-05,1,0,1
4229,4229,defaultDelay,8.058149364163249e-05,1,0,1
4230,4230,defaultViewportTag,8.058149364163249e-05,1,0,1
4231,4231,deferMachine,8.058149364163249e-05,1,0,1
4232,4232,deferService,8.058149364163249e-05,1,0,1
4233,4233,defineProperty,8.058149364163249e-05,1,0,1
4234,4234,delayedMachine,8.058149364163249e-05,1,0,1
4235,4235,delayedService,8.058149364163249e-05,1,0,1
4236,4236,delegateEnterSpy,8.058149364163249e-05,1,0,1
4237,4237,delegateLeaveSpy,8.058149364163249e-05,1,0,1
4238,4238,delegatedClickListener,8.058149364163249e-05,1,0,1
4239,4239,dependencies,8.058149364163249e-05,1,0,1
4240,4240,deprecated,8.058149364163249e-05,1,0,1
4241,4241,devMiddlewareManifest,8.058149364163249e-05,1,0,1
4242,4242,dfs,8.058149364163249e-05,1,0,1
4243,4243,dialogEl,8.058149364163249e-05,1,0,1
4244,4244,digraph,8.058149364163249e-05,1,0,1
4245,4245,dispatchSpy,8.058149364163249e-05,1,0,1
4246,4246,disposeAutorun,8.058149364163249e-05,1,0,1
4247,4247,divEl,8.058149364163249e-05,1,0,1
4248,4248,divId,8.058149364163249e-05,1,0,1
4249,4249,dive,8.058149364163249e-05,1,0,1
4250,4250,doSomething,8.058149364163249e-05,1,0,1
4251,4251,docblock,8.058149364163249e-05,1,0,1
4252,4252,docs,8.058149364163249e-05,1,0,1
4253,4253,dollarTitle,8.058149364163249e-05,1,0,1
4254,4254,doneSubMachine,8.058149364163249e-05,1,0,1
4255,4255,doneTest,8.058149364163249e-05,1,0,1
4256,4256,draftRes,8.058149364163249e-05,1,0,1
4257,4257,dropItems,8.058149364163249e-05,1,0,1
4258,4258,dropdown1,8.058149364163249e-05,1,0,1
4259,4259,dropdown2,8.058149364163249e-05,1,0,1
4260,4260,dropdownByElement,8.058149364163249e-05,1,0,1
4261,4261,dropdownBySelector,8.058149364163249e-05,1,0,1
4262,4262,dropdownElem,8.058149364163249e-05,1,0,1
4263,4263,dropdownParent,8.058149364163249e-05,1,0,1
4264,4264,dropendEl,8.058149364163249e-05,1,0,1
4265,4265,dropstartEl,8.058149364163249e-05,1,0,1
4266,4266,dynamicIconHref,8.058149364163249e-05,1,0,1
4267,4267,dynamicIconRes,8.058149364163249e-05,1,0,1
4268,4268,dynamicModal,8.058149364163249e-05,1,0,1
4269,4269,dynamicRouteUrl,8.058149364163249e-05,1,0,1
4270,4270,edgeRoute,8.058149364163249e-05,1,0,1
4271,4271,edit,8.058149364163249e-05,1,0,1
4272,4272,elapsed,8.058149364163249e-05,1,0,1
4273,4273,elem,8.058149364163249e-05,1,0,1
4274,4274,emitted,8.058149364163249e-05,1,0,1
4275,4275,endTest,8.058149364163249e-05,1,0,1
4276,4276,endTime,8.058149364163249e-05,1,0,1
4277,4277,endpoint,8.058149364163249e-05,1,0,1
4278,4278,endsWith,8.058149364163249e-05,1,0,1
4279,4279,enforceActions,8.058149364163249e-05,1,0,1
4280,4280,enhancer,8.058149364163249e-05,1,0,1
4281,4281,enterSpy,8.058149364163249e-05,1,0,1
4282,4282,entries,8.058149364163249e-05,1,0,1
4283,4283,entryActionsCount,8.058149364163249e-05,1,0,1
4284,4284,entryCalled,8.058149364163249e-05,1,0,1
4285,4285,equivMachine,8.058149364163249e-05,1,0,1
4286,4286,errOverlayContent,8.058149364163249e-05,1,0,1
4287,4287,errorHandlersCalled,8.058149364163249e-05,1,0,1
4288,4288,errorMessage,8.058149364163249e-05,1,0,1
4289,4289,errorMsg,8.058149364163249e-05,1,0,1
4290,4290,escapeRegex,8.058149364163249e-05,1,0,1
4291,4291,escapeStringRegexp,8.058149364163249e-05,1,0,1
4292,4292,escapedBuildId,8.058149364163249e-05,1,0,1
4293,4293,euro,8.058149364163249e-05,1,0,1
4294,4294,evenCounts,8.058149364163249e-05,1,0,1
4295,4295,eveningState,8.058149364163249e-05,1,0,1
4296,4296,eventListenerSpy,8.058149364163249e-05,1,0,1
4297,4297,eventType,8.058149364163249e-05,1,0,1
4298,4298,eventTypes,8.058149364163249e-05,1,0,1
4299,4299,execDone,8.058149364163249e-05,1,0,1
4300,4300,executedActions,8.058149364163249e-05,1,0,1
4301,4301,executedAssigns,8.058149364163249e-05,1,0,1
4302,4302,executor,8.058149364163249e-05,1,0,1
4303,4303,exist,8.058149364163249e-05,1,0,1
4304,4304,exitActions,8.058149364163249e-05,1,0,1
4305,4305,expectToBeCloseToArray,8.058149364163249e-05,1,0,1
4306,4306,expectedAmpHtmlUrl,8.058149364163249e-05,1,0,1
4307,4307,expectedFinalCount,8.058149364163249e-05,1,0,1
4308,4308,expectedFixtureState,8.058149364163249e-05,1,0,1
4309,4309,expectedPadding2,8.058149364163249e-05,1,0,1
4310,4310,expectedType,8.058149364163249e-05,1,0,1
4311,4311,expectedWarnings,8.058149364163249e-05,1,0,1
4312,4312,failState,8.058149364163249e-05,1,0,1
4313,4313,fakejQuery,8.058149364163249e-05,1,0,1
4314,4314,fallbackName,8.058149364163249e-05,1,0,1
4315,4315,falseSyncOptions,8.058149364163249e-05,1,0,1
4316,4316,faultyExample,8.058149364163249e-05,1,0,1
4317,4317,favIcon,8.058149364163249e-05,1,0,1
4318,4318,faviconFileBuffer,8.058149364163249e-05,1,0,1
4319,4319,faviconResponse,8.058149364163249e-05,1,0,1
4320,4320,feedbackMachine,8.058149364163249e-05,1,0,1
4321,4321,fetchResponse,8.058149364163249e-05,1,0,1
4322,4322,fetchSitemap,8.058149364163249e-05,1,0,1
4323,4323,fetcherMachine,8.058149364163249e-05,1,0,1
4324,4324,fetches,8.058149364163249e-05,1,0,1
4325,4325,filePath1,8.058149364163249e-05,1,0,1
4326,4326,filePath2,8.058149364163249e-05,1,0,1
4327,4327,fileTrace,8.058149364163249e-05,1,0,1
4328,4328,findPort,8.058149364163249e-05,1,0,1
4329,4329,findShadowRoot,8.058149364163249e-05,1,0,1
4330,4330,firaCodeRegex,8.058149364163249e-05,1,0,1
4331,4331,firstCallback,8.058149364163249e-05,1,0,1
4332,4332,firstCardSelected,8.058149364163249e-05,1,0,1
4333,4333,firstDropItem,8.058149364163249e-05,1,0,1
4334,4334,firstDropdownEl,8.058149364163249e-05,1,0,1
4335,4335,firstElement,8.058149364163249e-05,1,0,1
4336,4336,firstIndicator,8.058149364163249e-05,1,0,1
4337,4337,firstItem,8.058149364163249e-05,1,0,1
4338,4338,firstLevel,8.058149364163249e-05,1,0,1
4339,4339,firstLiLinkEl,8.058149364163249e-05,1,0,1
4340,4340,firstLoadJS,8.058149364163249e-05,1,0,1
4341,4341,firstMessage,8.058149364163249e-05,1,0,1
4342,4342,firstRenderID,8.058149364163249e-05,1,0,1
4343,4343,firstResult,8.058149364163249e-05,1,0,1
4344,4344,firstTest,8.058149364163249e-05,1,0,1
4345,4345,fixedEl2,8.058149364163249e-05,1,0,1
4346,4346,fixtureFileSuffix,8.058149364163249e-05,1,0,1
4347,4347,fixtureReselect,8.058149364163249e-05,1,0,1
4348,4348,fixturesDir,8.058149364163249e-05,1,0,1
4349,4349,fixures,8.058149364163249e-05,1,0,1
4350,4350,flag,8.058149364163249e-05,1,0,1
4351,4351,flatParallelMachine,8.058149364163249e-05,1,0,1
4352,4352,fn0,8.058149364163249e-05,1,0,1
4353,4353,fnProp,8.058149364163249e-05,1,0,1
4354,4354,following,8.058149364163249e-05,1,0,1
4355,4355,font1Content,8.058149364163249e-05,1,0,1
4356,4356,fontWeight,8.058149364163249e-05,1,0,1
4357,4357,foo1,8.058149364163249e-05,1,0,1
4358,4358,foo2,8.058149364163249e-05,1,0,1
4359,4359,fooAgain,8.058149364163249e-05,1,0,1
4360,4360,fooIsGreaterThan5,8.058149364163249e-05,1,0,1
4361,4361,fooStateNode,8.058149364163249e-05,1,0,1
4362,4362,found,8.058149364163249e-05,1,0,1
4363,4363,foundErrors,8.058149364163249e-05,1,0,1
4364,4364,fromEntries,8.058149364163249e-05,1,0,1
4365,4365,fromMiddleware,8.058149364163249e-05,1,0,1
4366,4366,fromState,8.058149364163249e-05,1,0,1
4367,4367,fsCache,8.058149364163249e-05,1,0,1
4368,4368,fullLog,8.058149364163249e-05,1,0,1
4369,4369,fullName,8.058149364163249e-05,1,0,1
4370,4370,functionBar,8.058149364163249e-05,1,0,1
4371,4371,functionFoo,8.058149364163249e-05,1,0,1
4372,4372,functionGuard,8.058149364163249e-05,1,0,1
4373,4373,functionRoutes,8.058149364163249e-05,1,0,1
4374,4374,functions,8.058149364163249e-05,1,0,1
4375,4375,functionsConfigManifest,8.058149364163249e-05,1,0,1
4376,4376,game,8.058149364163249e-05,1,0,1
4377,4377,gestures,8.058149364163249e-05,1,0,1
4378,4378,getActiveId,8.058149364163249e-05,1,0,1
4379,4379,getAlert,8.058149364163249e-05,1,0,1
4380,4380,getBrowserBodyText,8.058149364163249e-05,1,0,1
4381,4381,getComponentPathLine,8.058149364163249e-05,1,0,1
4382,4382,getComputedCss,8.058149364163249e-05,1,0,1
4383,4383,getDebugName,8.058149364163249e-05,1,0,1
4384,4384,getDisplayName,8.058149364163249e-05,1,0,1
4385,4385,getElementsByTagName,8.058149364163249e-05,1,0,1
4386,4386,getMachineShortestPaths,8.058149364163249e-05,1,0,1
4387,4387,getMachineSimplePaths,8.058149364163249e-05,1,0,1
4388,4388,getMarginAttr,8.058149364163249e-05,1,0,1
4389,4389,getNameFromFilePath,8.058149364163249e-05,1,0,1
4390,4390,getOwnPropertySymbols,8.058149364163249e-05,1,0,1
4391,4391,getProps,8.058149364163249e-05,1,0,1
4392,4392,getProxyTarget,8.058149364163249e-05,1,0,1
4393,4393,getRedboxHeader,8.058149364163249e-05,1,0,1
4394,4394,getRequires,8.058149364163249e-05,1,0,1
4395,4395,getRouterMethods,8.058149364163249e-05,1,0,1
4396,4396,getRule,8.058149364163249e-05,1,0,1
4397,4397,getRuleNameFromRulePath,8.058149364163249e-05,1,0,1
4398,4398,getSetCookieHeaders,8.058149364163249e-05,1,0,1
4399,4399,getStateNodeByPath,8.058149364163249e-05,1,0,1
4400,4400,getTransitionDurationFromElement,8.058149364163249e-05,1,0,1
4401,4401,getUID,8.058149364163249e-05,1,0,1
4402,4402,globalsCount,8.058149364163249e-05,1,0,1
4403,4403,goToLinkingPage,8.058149364163249e-05,1,0,1
4404,4404,gotData,8.058149364163249e-05,1,0,1
4405,4405,gotEvent,8.058149364163249e-05,1,0,1
4406,4406,gotFallback,8.058149364163249e-05,1,0,1
4407,4407,gotInlinedData,8.058149364163249e-05,1,0,1
4408,4408,greenState,8.058149364163249e-05,1,0,1
4409,4409,greet,8.058149364163249e-05,1,0,1
4410,4410,greetingMachine,8.058149364163249e-05,1,0,1
4411,4411,halfFirst,8.058149364163249e-05,1,0,1
4412,4412,handleArrowDown,8.058149364163249e-05,1,0,1
4413,4413,handleArrowUp,8.058149364163249e-05,1,0,1
4414,4414,handlerCollapseOne,8.058149364163249e-05,1,0,1
4415,4415,handlerNestedCollapseOne,8.058149364163249e-05,1,0,1
4416,4416,hasAudienceHome,8.058149364163249e-05,1,0,1
4417,4417,hasDemographics,8.058149364163249e-05,1,0,1
4418,4418,hasFlightRequest,8.058149364163249e-05,1,0,1
4419,4419,hasHome,8.058149364163249e-05,1,0,1
4420,4420,hasImpressions,8.058149364163249e-05,1,0,1
4421,4421,hasMarginAttr,8.058149364163249e-05,1,0,1
4422,4422,hasMatch,8.058149364163249e-05,1,0,1
4423,4423,hasNextInternalQuery,8.058149364163249e-05,1,0,1
4424,4424,hasPaddingAttr,8.058149364163249e-05,1,0,1
4425,4425,hasParam,8.058149364163249e-05,1,0,1
4426,4426,hasRootNotFoundFlight,8.058149364163249e-05,1,0,1
4427,4427,hasSubscribers,8.058149364163249e-05,1,0,1
4428,4428,hasViewDuration,8.058149364163249e-05,1,0,1
4429,4429,hasViewsHome,8.058149364163249e-05,1,0,1
4430,4430,header,8.058149364163249e-05,1,0,1
4431,4431,hiddenState,8.058149364163249e-05,1,0,1
4432,4432,hideCallback,8.058149364163249e-05,1,0,1
4433,4433,hideCalled,8.058149364163249e-05,1,0,1
4434,4434,hideEventTriggered,8.058149364163249e-05,1,0,1
4435,4435,hideFunction,8.058149364163249e-05,1,0,1
4436,4436,hideSpy,8.058149364163249e-05,1,0,1
4437,4437,hitCount,8.058149364163249e-05,1,0,1
4438,4438,hour,8.058149364163249e-05,1,0,1
4439,4439,html$,8.058149364163249e-05,1,0,1
4440,4440,htmlUnsafe,8.058149364163249e-05,1,0,1
4441,4441,http,8.058149364163249e-05,1,0,1
4442,4442,httpOnly,8.058149364163249e-05,1,0,1
4443,4443,httpProxy,8.058149364163249e-05,1,0,1
4444,4444,httpUrl,8.058149364163249e-05,1,0,1
4445,4445,httpsUrl,8.058149364163249e-05,1,0,1
4446,4446,hydratedContent,8.058149364163249e-05,1,0,1
4447,4447,i18n,8.058149364163249e-05,1,0,1
4448,4448,iconFilePath,8.058149364163249e-05,1,0,1
4449,4449,iconHtml,8.058149364163249e-05,1,0,1
4450,4450,iconSvg,8.058149364163249e-05,1,0,1
4451,4451,iconUrls,8.058149364163249e-05,1,0,1
4452,4452,identity,8.058149364163249e-05,1,0,1
4453,4453,ignorePath,8.058149364163249e-05,1,0,1
4454,4454,imageBuffer,8.058149364163249e-05,1,0,1
4455,4455,imageSize,8.058149364163249e-05,1,0,1
4456,4456,inactiveState,8.058149364163249e-05,1,0,1
4457,4457,incButton,8.058149364163249e-05,1,0,1
4458,4458,incorrectGeneratedStaticFolder,8.058149364163249e-05,1,0,1
4459,4459,incrementEl,8.058149364163249e-05,1,0,1
4460,4460,indexUrl,8.058149364163249e-05,1,0,1
4461,4461,individualCookie,8.058149364163249e-05,1,0,1
4462,4462,individualCookieParams,8.058149364163249e-05,1,0,1
4463,4463,inertState,8.058149364163249e-05,1,0,1
4464,4464,initData,8.058149364163249e-05,1,0,1
4465,4465,initLayoutData,8.058149364163249e-05,1,0,1
4466,4466,initialHeaders,8.058149364163249e-05,1,0,1
4467,4467,initialProps,8.058149364163249e-05,1,0,1
4468,4468,initialRandomData,8.058149364163249e-05,1,0,1
4469,4469,initialRevalidateSeconds,8.058149364163249e-05,1,0,1
4470,4470,initialText,8.058149364163249e-05,1,0,1
4471,4471,inlineFlightContents,8.058149364163249e-05,1,0,1
4472,4472,inlineStylePadding,8.058149364163249e-05,1,0,1
4473,4473,insertedFunc,8.058149364163249e-05,1,0,1
4474,4474,inspectedService,8.058149364163249e-05,1,0,1
4475,4475,integrity,8.058149364163249e-05,1,0,1
4476,4476,internalQueries,8.058149364163249e-05,1,0,1
4477,4477,interval$,8.058149364163249e-05,1,0,1
4478,4478,invalidMachine,8.058149364163249e-05,1,0,1
4479,4479,invalidMachineConfig,8.058149364163249e-05,1,0,1
4480,4480,invalidParams,8.058149364163249e-05,1,0,1
4481,4481,invalidRes,8.058149364163249e-05,1,0,1
4482,4482,invalidRobotsResponse,8.058149364163249e-05,1,0,1
4483,4483,invalidSitemapResponse,8.058149364163249e-05,1,0,1
4484,4484,invalidState,8.058149364163249e-05,1,0,1
4485,4485,invalidUrls,8.058149364163249e-05,1,0,1
4486,4486,invokeDisposeCount,8.058149364163249e-05,1,0,1
4487,4487,invokeMachine,8.058149364163249e-05,1,0,1
4488,4488,invoked,8.058149364163249e-05,1,0,1
4489,4489,isBypass,8.058149364163249e-05,1,0,1
4490,4490,isCachingHeader,8.058149364163249e-05,1,0,1
4491,4491,isDeploy,8.058149364163249e-05,1,0,1
4492,4492,isEdge,8.058149364163249e-05,1,0,1
4493,4493,isElement,8.058149364163249e-05,1,0,1
4494,4494,isEnabled,8.058149364163249e-05,1,0,1
4495,4495,isEqualNode,8.058149364163249e-05,1,0,1
4496,4496,isFirstTime,8.058149364163249e-05,1,0,1
4497,4497,isMatchWrong,8.058149364163249e-05,1,0,1
4498,4498,isMetadataFile,8.058149364163249e-05,1,0,1
4499,4499,isModeDeploy,8.058149364163249e-05,1,0,1
4500,4500,isStatic,8.058149364163249e-05,1,0,1
4501,4501,isTraced,8.058149364163249e-05,1,0,1
4502,4502,isWrong,8.058149364163249e-05,1,0,1
4503,4503,italics,8.058149364163249e-05,1,0,1
4504,4504,itif,8.058149364163249e-05,1,0,1
4505,4505,jQuery,8.058149364163249e-05,1,0,1
4506,4506,jQueryInterface,8.058149364163249e-05,1,0,1
4507,4507,jestWorkerId,8.058149364163249e-05,1,0,1
4508,4508,jsonBarState,8.058149364163249e-05,1,0,1
4509,4509,jsonState,8.058149364163249e-05,1,0,1
4510,4510,keydownArrowDown,8.058149364163249e-05,1,0,1
4511,4511,keydownArrowUp,8.058149364163249e-05,1,0,1
4512,4512,keydownEvent,8.058149364163249e-05,1,0,1
4513,4513,keyof,8.058149364163249e-05,1,0,1
4514,4514,kind,8.058149364163249e-05,1,0,1
4515,4515,langFetchSlug,8.058149364163249e-05,1,0,1
4516,4516,langSlug,8.058149364163249e-05,1,0,1
4517,4517,lastItem,8.058149364163249e-05,1,0,1
4518,4518,layoutNowRevalidated,8.058149364163249e-05,1,0,1
4519,4519,layoutNowSecond,8.058149364163249e-05,1,0,1
4520,4520,lazy,8.058149364163249e-05,1,0,1
4521,4521,lazyItems,8.058149364163249e-05,1,0,1
4522,4522,leaveSpy,8.058149364163249e-05,1,0,1
4523,4523,letterMachine,8.058149364163249e-05,1,0,1
4524,4524,level,8.058149364163249e-05,1,0,1
4525,4525,liEl,8.058149364163249e-05,1,0,1
4526,4526,liList,8.058149364163249e-05,1,0,1
4527,4527,limitSize,8.058149364163249e-05,1,0,1
4528,4528,linkComponent,8.058149364163249e-05,1,0,1
4529,4529,linkEl,8.058149364163249e-05,1,0,1
4530,4530,linkText,8.058149364163249e-05,1,0,1
4531,4531,linterConfigWithCustomDirectory,8.058149364163249e-05,1,0,1
4532,4532,listEl,8.058149364163249e-05,1,0,1
4533,4533,listName,8.058149364163249e-05,1,0,1
4534,4534,listener,8.058149364163249e-05,1,0,1
4535,4535,literalTest,8.058149364163249e-05,1,0,1
4536,4536,loadEvent,8.058149364163249e-05,1,0,1
4537,4537,loadPage,8.058149364163249e-05,1,0,1
4538,4538,loadingState,8.058149364163249e-05,1,0,1
4539,4539,localFontRegex,8.058149364163249e-05,1,0,1
4540,4540,localWindowMock,8.058149364163249e-05,1,0,1
4541,4541,m1,8.058149364163249e-05,1,0,1
4542,4542,machine2,8.058149364163249e-05,1,0,1
4543,4543,machineJSON,8.058149364163249e-05,1,0,1
4544,4544,machineObject,8.058149364163249e-05,1,0,1
4545,4545,machineRef,8.058149364163249e-05,1,0,1
4546,4546,machineStateEl,8.058149364163249e-05,1,0,1
4547,4547,main,8.058149364163249e-05,1,0,1
4548,4548,manipulated,8.058149364163249e-05,1,0,1
4549,4549,matchAll,8.058149364163249e-05,1,0,1
4550,4550,matchState,8.058149364163249e-05,1,0,1
4551,4551,maxWidth,8.058149364163249e-05,1,0,1
4552,4552,maybe,8.058149364163249e-05,1,0,1
4553,4553,message1,8.058149364163249e-05,1,0,1
4554,4554,message2Again,8.058149364163249e-05,1,0,1
4555,4555,messageHandler,8.058149364163249e-05,1,0,1
4556,4556,messages,8.058149364163249e-05,1,0,1
4557,4557,metaComponent,8.058149364163249e-05,1,0,1
4558,4558,middlewareBundle,8.058149364163249e-05,1,0,1
4559,4559,minute,8.058149364163249e-05,1,0,1
4560,4560,mockRendererReady,8.058149364163249e-05,1,0,1
4561,4561,mockSwipeGesture,8.058149364163249e-05,1,0,1
4562,4562,modal1,8.058149364163249e-05,1,0,1
4563,4563,modal2,8.058149364163249e-05,1,0,1
4564,4564,modalBody,8.058149364163249e-05,1,0,1
4565,4565,modalByElement,8.058149364163249e-05,1,0,1
4566,4566,modalBySelector,8.058149364163249e-05,1,0,1
4567,4567,modalEl1,8.058149364163249e-05,1,0,1
4568,4568,modalEl2,8.058149364163249e-05,1,0,1
4569,4569,modules,8.058149364163249e-05,1,0,1
4570,4570,money,8.058149364163249e-05,1,0,1
4571,4571,morningState,8.058149364163249e-05,1,0,1
4572,4572,moveMouse,8.058149364163249e-05,1,0,1
4573,4573,moveMouseToChildEvent,8.058149364163249e-05,1,0,1
4574,4574,myDefaultAllowList,8.058149364163249e-05,1,0,1
4575,4575,myGuard,8.058149364163249e-05,1,0,1
4576,4576,myInvocation,8.058149364163249e-05,1,0,1
4577,4577,mySanitize,8.058149364163249e-05,1,0,1
4578,4578,n,8.058149364163249e-05,1,0,1
4579,4579,nameUpdater,8.058149364163249e-05,1,0,1
4580,4580,namedDataRouteRegex,8.058149364163249e-05,1,0,1
4581,4581,naturallyInertState,8.058149364163249e-05,1,0,1
4582,4582,nav1,8.058149364163249e-05,1,0,1
4583,4583,nav2,8.058149364163249e-05,1,0,1
4584,4584,negativeHeight,8.058149364163249e-05,1,0,1
4585,4585,nestedCollapseOne,8.058149364163249e-05,1,0,1
4586,4586,nestedFinalMachine,8.058149364163249e-05,1,0,1
4587,4587,nestedTrigger,8.058149364163249e-05,1,0,1
4588,4588,nestedTriggerEl,8.058149364163249e-05,1,0,1
4589,4589,network,8.058149364163249e-05,1,0,1
4590,4590,newCount,8.058149364163249e-05,1,0,1
4591,4591,newHitCount,8.058149364163249e-05,1,0,1
4592,4592,newKey,8.058149364163249e-05,1,0,1
4593,4593,newLayoutData,8.058149364163249e-05,1,0,1
4594,4594,newResponse,8.058149364163249e-05,1,0,1
4595,4595,newSearchParams,8.058149364163249e-05,1,0,1
4596,4596,newSearchTerm,8.058149364163249e-05,1,0,1
4597,4597,newState,8.058149364163249e-05,1,0,1
4598,4598,newTestCookie,8.058149364163249e-05,1,0,1
4599,4599,newText,8.058149364163249e-05,1,0,1
4600,4600,nextBtnEl,8.058149364163249e-05,1,0,1
4601,4601,nextConfig,8.058149364163249e-05,1,0,1
4602,4602,nextEvent,8.058149364163249e-05,1,0,1
4603,4603,nextSpy,8.058149364163249e-05,1,0,1
4604,4604,noEventsMachine,8.058149364163249e-05,1,0,1
4605,4605,noIDMachine,8.058149364163249e-05,1,0,1
4606,4606,noIndexTag,8.058149364163249e-05,1,0,1
4607,4607,noReload,8.058149364163249e-05,1,0,1
4608,4608,noStateNodeIDMachine,8.058149364163249e-05,1,0,1
4609,4609,nonSerializableData,8.058149364163249e-05,1,0,1
4610,4610,noscriptComponent,8.058149364163249e-05,1,0,1
4611,4611,noscriptImg,8.058149364163249e-05,1,0,1
4612,4612,noscriptInnerHTML,8.058149364163249e-05,1,0,1
4613,4613,nullActorMachine,8.058149364163249e-05,1,0,1
4614,4614,num1,8.058149364163249e-05,1,0,1
4615,4615,num2,8.058149364163249e-05,1,0,1
4616,4616,num5,8.058149364163249e-05,1,0,1
4617,4617,numProp,8.058149364163249e-05,1,0,1
4618,4618,numn1,8.058149364163249e-05,1,0,1
4619,4619,nxtPp,8.058149364163249e-05,1,0,1
4620,4620,nxtPpost,8.058149364163249e-05,1,0,1
4621,4621,nxtPslug,8.058149364163249e-05,1,0,1
4622,4622,oMap,8.058149364163249e-05,1,0,1
4623,4623,objectData,8.058149364163249e-05,1,0,1
4624,4624,objectGuard,8.058149364163249e-05,1,0,1
4625,4625,objectOrObservableObject,8.058149364163249e-05,1,0,1
4626,4626,observableArray,8.058149364163249e-05,1,0,1
4627,4627,observableArrayOf,8.058149364163249e-05,1,0,1
4628,4628,observableObject,8.058149364163249e-05,1,0,1
4629,4629,observableRef,8.058149364163249e-05,1,0,1
4630,4630,observableService,8.058149364163249e-05,1,0,1
4631,4631,observableSymbol,8.058149364163249e-05,1,0,1
4632,4632,oddCounts,8.058149364163249e-05,1,0,1
4633,4633,offcanvas1,8.058149364163249e-05,1,0,1
4634,4634,offcanvas2,8.058149364163249e-05,1,0,1
4635,4635,offcanvasEl1,8.058149364163249e-05,1,0,1
4636,4636,offcanvasEl2,8.058149364163249e-05,1,0,1
4637,4637,ogHtml,8.058149364163249e-05,1,0,1
4638,4638,ogImage,8.058149364163249e-05,1,0,1
4639,4639,ogImageHref,8.058149364163249e-05,1,0,1
4640,4640,ogImageUrlInstance,8.058149364163249e-05,1,0,1
4641,4641,ogImageUrlPattern,8.058149364163249e-05,1,0,1
4642,4642,ogImages,8.058149364163249e-05,1,0,1
4643,4643,ogUrl,8.058149364163249e-05,1,0,1
4644,4644,onClick,8.058149364163249e-05,1,0,1
4645,4645,onClose,8.058149364163249e-05,1,0,1
4646,4646,onDOMContentLoaded,8.058149364163249e-05,1,0,1
4647,4647,onDemandEntries,8.058149364163249e-05,1,0,1
4648,4648,onEntry,8.058149364163249e-05,1,0,1
4649,4649,onEntryCalled,8.058149364163249e-05,1,0,1
4650,4650,onExitCalled,8.058149364163249e-05,1,0,1
4651,4651,onOpen,8.058149364163249e-05,1,0,1
4652,4652,onSearchTermChange,8.058149364163249e-05,1,0,1
4653,4653,onSlid,8.058149364163249e-05,1,0,1
4654,4654,onSlid2,8.058149364163249e-05,1,0,1
4655,4655,onSlide,8.058149364163249e-05,1,0,1
4656,4656,onSlide2,8.058149364163249e-05,1,0,1
4657,4657,onState,8.058149364163249e-05,1,0,1
4658,4658,onTurboState,8.058149364163249e-05,1,0,1
4659,4659,oneNamedExport,8.058149364163249e-05,1,0,1
4660,4660,onfulfilled,8.058149364163249e-05,1,0,1
4661,4661,onrejected,8.058149364163249e-05,1,0,1
4662,4662,openMenuState,8.058149364163249e-05,1,0,1
4663,4663,openPaths,8.058149364163249e-05,1,0,1
4664,4664,optionalProps,8.058149364163249e-05,1,0,1
4665,4665,order,8.058149364163249e-05,1,0,1
4666,4666,order1,8.058149364163249e-05,1,0,1
4667,4667,order1totals,8.058149364163249e-05,1,0,1
4668,4668,order2,8.058149364163249e-05,1,0,1
4669,4669,orderedAssets,8.058149364163249e-05,1,0,1
4670,4670,origContent1,8.058149364163249e-05,1,0,1
4671,4671,origContent2,8.058149364163249e-05,1,0,1
4672,4672,origData,8.058149364163249e-05,1,0,1
4673,4673,originalPadding2,8.058149364163249e-05,1,0,1
4674,4674,originalProcessEnv,8.058149364163249e-05,1,0,1
4675,4675,originalTarget,8.058149364163249e-05,1,0,1
4676,4676,otherButton,8.058149364163249e-05,1,0,1
4677,4677,override,8.058149364163249e-05,1,0,1
4678,4678,ownProps,8.058149364163249e-05,1,0,1
4679,4679,p2,8.058149364163249e-05,1,0,1
4680,4680,p4,8.058149364163249e-05,1,0,1
4681,4681,packageJson,8.058149364163249e-05,1,0,1
4682,4682,packagesDir,8.058149364163249e-05,1,0,1
4683,4683,pageContent,8.058149364163249e-05,1,0,1
4684,4684,pageData2,8.058149364163249e-05,1,0,1
4685,4685,pageHtml,8.058149364163249e-05,1,0,1
4686,4686,pageNowRevalidated,8.058149364163249e-05,1,0,1
4687,4687,pageNowSecond,8.058149364163249e-05,1,0,1
4688,4688,pair,8.058149364163249e-05,1,0,1
4689,4689,parallelMachine,8.058149364163249e-05,1,0,1
4690,4690,parallelMachine2,8.058149364163249e-05,1,0,1
4691,4691,parallelMachineWithOnEntry,8.058149364163249e-05,1,0,1
4692,4692,paramsToCheck,8.058149364163249e-05,1,0,1
4693,4693,parentBtn,8.058149364163249e-05,1,0,1
4694,4694,parentCollapseEl,8.058149364163249e-05,1,0,1
4695,4695,parseIntDecimal,8.058149364163249e-05,1,0,1
4696,4696,parser,8.058149364163249e-05,1,0,1
4697,4697,passState,8.058149364163249e-05,1,0,1
4698,4698,pathToBAndC,8.058149364163249e-05,1,0,1
4699,4699,pathToC,8.058149364163249e-05,1,0,1
4700,4700,pathToCFromA,8.058149364163249e-05,1,0,1
4701,4701,pathToY,8.058149364163249e-05,1,0,1
4702,4702,pathWithTwoTodos,8.058149364163249e-05,1,0,1
4703,4703,pathline,8.058149364163249e-05,1,0,1
4704,4704,pathnames,8.058149364163249e-05,1,0,1
4705,4705,pathsToY,8.058149364163249e-05,1,0,1
4706,4706,pcWithTurboButtonMachine,8.058149364163249e-05,1,0,1
4707,4707,peek,8.058149364163249e-05,1,0,1
4708,4708,persistedFetchStateConfig,8.058149364163249e-05,1,0,1
4709,4709,pingPongMachine,8.058149364163249e-05,1,0,1
4710,4710,pkgs,8.058149364163249e-05,1,0,1
4711,4711,plain,8.058149364163249e-05,1,0,1
4712,4712,playgroundUrl,8.058149364163249e-05,1,0,1
4713,4713,pluginMock,8.058149364163249e-05,1,0,1
4714,4714,pongMachine,8.058149364163249e-05,1,0,1
4715,4715,ponger,8.058149364163249e-05,1,0,1
4716,4716,popover2,8.058149364163249e-05,1,0,1
4717,4717,postRevalidate$,8.058149364163249e-05,1,0,1
4718,4718,postRevalidateProps,8.058149364163249e-05,1,0,1
4719,4719,postRevalidateRes,8.058149364163249e-05,1,0,1
4720,4720,pound,8.058149364163249e-05,1,0,1
4721,4721,prefetches,8.058149364163249e-05,1,0,1
4722,4722,preloadAfterNavigation,8.058149364163249e-05,1,0,1
4723,4723,preloadBeforeNavigation,8.058149364163249e-05,1,0,1
4724,4724,prevBtnEl,8.058149364163249e-05,1,0,1
4725,4725,prevData,8.058149364163249e-05,1,0,1
4726,4726,prevEvent,8.058149364163249e-05,1,0,1
4727,4727,prevInitialDate,8.058149364163249e-05,1,0,1
4728,4728,prevInitialRandomData,8.058149364163249e-05,1,0,1
4729,4729,prevNodes,8.058149364163249e-05,1,0,1
4730,4730,prevSpy,8.058149364163249e-05,1,0,1
4731,4731,prevState,8.058149364163249e-05,1,0,1
4732,4732,prevented,8.058149364163249e-05,1,0,1
4733,4733,previewCookie,8.058149364163249e-05,1,0,1
4734,4734,previewData,8.058149364163249e-05,1,0,1
4735,4735,previewRes,8.058149364163249e-05,1,0,1
4736,4736,previousState,8.058149364163249e-05,1,0,1
4737,4737,printDebugValue,8.058149364163249e-05,1,0,1
4738,4738,private,8.058149364163249e-05,1,0,1
4739,4739,promiseEventModel,8.058149364163249e-05,1,0,1
4740,4740,promiseService,8.058149364163249e-05,1,0,1
4741,4741,promiseSpawned,8.058149364163249e-05,1,0,1
4742,4742,promiseStateModel,8.058149364163249e-05,1,0,1
4743,4743,promiseTypes,8.058149364163249e-05,1,0,1
4744,4744,propX,8.058149364163249e-05,1,0,1
4745,4745,properties,8.058149364163249e-05,1,0,1
4746,4746,proxiedRequests,8.058149364163249e-05,1,0,1
4747,4747,proxyTimeout,8.058149364163249e-05,1,0,1
4748,4748,pushTimedNotification,8.058149364163249e-05,1,0,1
4749,4749,quality,8.058149364163249e-05,1,0,1
4750,4750,qux,8.058149364163249e-05,1,0,1
4751,4751,raise,8.058149364163249e-05,1,0,1
4752,4752,raiseMachine,8.058149364163249e-05,1,0,1
4753,4753,raisingParallelMachine,8.058149364163249e-05,1,0,1
4754,4754,randomSlug,8.058149364163249e-05,1,0,1
4755,4755,randomSlug2,8.058149364163249e-05,1,0,1
4756,4756,react$,8.058149364163249e-05,1,0,1
4757,4757,reactCodeMirrorSelector,8.058149364163249e-05,1,0,1
4758,4758,reactNamespace,8.058149364163249e-05,1,0,1
4759,4759,readFileSync,8.058149364163249e-05,1,0,1
4760,4760,readMiddlewareJSON,8.058149364163249e-05,1,0,1
4761,4761,receive,8.058149364163249e-05,1,0,1
4762,4762,receiveResponse,8.058149364163249e-05,1,0,1
4763,4763,received,8.058149364163249e-05,1,0,1
4764,4764,recomputes,8.058149364163249e-05,1,0,1
4765,4765,recreated,8.058149364163249e-05,1,0,1
4766,4766,recursiveCopy,8.058149364163249e-05,1,0,1
4767,4767,redOneState,8.058149364163249e-05,1,0,1
4768,4768,redStopState,8.058149364163249e-05,1,0,1
4769,4769,redboxSource,8.058149364163249e-05,1,0,1
4770,4770,redirectRes,8.058149364163249e-05,1,0,1
4771,4771,reduce,8.058149364163249e-05,1,0,1
4772,4772,refNoSync,8.058149364163249e-05,1,0,1
4773,4773,refNoSyncDefault,8.058149364163249e-05,1,0,1
4774,4774,refs,8.058149364163249e-05,1,0,1
4775,4775,regions,8.058149364163249e-05,1,0,1
4776,4776,register,8.058149364163249e-05,1,0,1
4777,4777,relPath,8.058149364163249e-05,1,0,1
4778,4778,relativeFilePath,8.058149364163249e-05,1,0,1
4779,4779,removeEventListener,8.058149364163249e-05,1,0,1
4780,4780,rendererReadyMsg,8.058149364163249e-05,1,0,1
4781,4781,rendererResponse,8.058149364163249e-05,1,0,1
4782,4782,rendererUrl,8.058149364163249e-05,1,0,1
4783,4783,replaceState,8.058149364163249e-05,1,0,1
4784,4784,replaced,8.058149364163249e-05,1,0,1
4785,4785,reqUrl,8.058149364163249e-05,1,0,1
4786,4786,requestPair,8.058149364163249e-05,1,0,1
4787,4787,requestedDefaultLocalePath,8.058149364163249e-05,1,0,1
4788,4788,requestedNonDefaultLocalePath,8.058149364163249e-05,1,0,1
4789,4789,requestsCount,8.058149364163249e-05,1,0,1
4790,4790,requiredProps,8.058149364163249e-05,1,0,1
4791,4791,requiredServerFiles,8.058149364163249e-05,1,0,1
4792,4792,res5,8.058149364163249e-05,1,0,1
4793,4793,res6,8.058149364163249e-05,1,0,1
4794,4794,resApp$,8.058149364163249e-05,1,0,1
4795,4795,resAppleIcon,8.058149364163249e-05,1,0,1
4796,4796,resIcon,8.058149364163249e-05,1,0,1
4797,4797,resOg,8.058149364163249e-05,1,0,1
4798,4798,resTwitter,8.058149364163249e-05,1,0,1
4799,4799,resolvedAction,8.058149364163249e-05,1,0,1
4800,4800,resolvedStateValue,8.058149364163249e-05,1,0,1
4801,4801,respondTo,8.058149364163249e-05,1,0,1
4802,4802,responses,8.058149364163249e-05,1,0,1
4803,4803,resultBar,8.058149364163249e-05,1,0,1
4804,4804,resultFoo,8.058149364163249e-05,1,0,1
4805,4805,resultFoo1,8.058149364163249e-05,1,0,1
4806,4806,retry,8.058149364163249e-05,1,0,1
4807,4807,revalidateRes,8.058149364163249e-05,1,0,1
4808,4808,revalidated,8.058149364163249e-05,1,0,1
4809,4809,revealedSecret,8.058149364163249e-05,1,0,1
4810,4810,revivedMachine,8.058149364163249e-05,1,0,1
4811,4811,rewind,8.058149364163249e-05,1,0,1
4812,4812,roboto100ItalicRegex,8.058149364163249e-05,1,0,1
4813,4813,rootDirectory,8.058149364163249e-05,1,0,1
4814,4814,rootMargin,8.058149364163249e-05,1,0,1
4815,4815,routeKeys,8.058149364163249e-05,1,0,1
4816,4816,routeName,8.058149364163249e-05,1,0,1
4817,4817,rule,8.058149364163249e-05,1,0,1
4818,4818,rulePath,8.058149364163249e-05,1,0,1
4819,4819,rulePaths,8.058149364163249e-05,1,0,1
4820,4820,run1,8.058149364163249e-05,1,0,1
4821,4821,runInAction,8.058149364163249e-05,1,0,1
4822,4822,runner,8.058149364163249e-05,1,0,1
4823,4823,s1,8.058149364163249e-05,1,0,1
4824,4824,s2,8.058149364163249e-05,1,0,1
4825,4825,sSpyByElement,8.058149364163249e-05,1,0,1
4826,4826,sSpyBySelector,8.058149364163249e-05,1,0,1
4827,4827,sSpyEl,8.058149364163249e-05,1,0,1
4828,4828,sameSite,8.058149364163249e-05,1,0,1
4829,4829,sameTime,8.058149364163249e-05,1,0,1
4830,4830,savedState,8.058149364163249e-05,1,0,1
4831,4831,scriptComponent,8.058149364163249e-05,1,0,1
4832,4832,scriptInnerHTML,8.058149364163249e-05,1,0,1
4833,4833,scriptTags,8.058149364163249e-05,1,0,1
4834,4834,scripts,8.058149364163249e-05,1,0,1
4835,4835,scrollspy2,8.058149364163249e-05,1,0,1
4836,4836,scxml,8.058149364163249e-05,1,0,1
4837,4837,secondCardSelected,8.058149364163249e-05,1,0,1
4838,4838,secondDropdownEl,8.058149364163249e-05,1,0,1
4839,4839,secondIndicator,8.058149364163249e-05,1,0,1
4840,4840,secondLevel,8.058149364163249e-05,1,0,1
4841,4841,secondMessage,8.058149364163249e-05,1,0,1
4842,4842,secondNavTab,8.058149364163249e-05,1,0,1
4843,4843,secondRenderID,8.058149364163249e-05,1,0,1
4844,4844,secondReport,8.058149364163249e-05,1,0,1
4845,4845,secondResult,8.058149364163249e-05,1,0,1
4846,4846,secondTest,8.058149364163249e-05,1,0,1
4847,4847,secure,8.058149364163249e-05,1,0,1
4848,4848,selectFixture,8.058149364163249e-05,1,0,1
4849,4849,selection,8.058149364163249e-05,1,0,1
4850,4850,sendTo,8.058149364163249e-05,1,0,1
4851,4851,sendUpdate,8.058149364163249e-05,1,0,1
4852,4852,sendid,8.058149364163249e-05,1,0,1
4853,4853,sequence,8.058149364163249e-05,1,0,1
4854,4854,serialized,8.058149364163249e-05,1,0,1
4855,4855,serverContent,8.058149364163249e-05,1,0,1
4856,4856,serverDirPath,8.058149364163249e-05,1,0,1
4857,4857,serverHtml,8.058149364163249e-05,1,0,1
4858,4858,serverInfo,8.058149364163249e-05,1,0,1
4859,4859,serverMessage,8.058149364163249e-05,1,0,1
4860,4860,serviceCalled,8.058149364163249e-05,1,0,1
4861,4861,serviceMachine,8.058149364163249e-05,1,0,1
4862,4862,setCookie,8.058149364163249e-05,1,0,1
4863,4863,setCookieHeader,8.058149364163249e-05,1,0,1
4864,4864,shadowRoot,8.058149364163249e-05,1,0,1
4865,4865,sharedClientModule,8.058149364163249e-05,1,0,1
4866,4866,sharedHtml,8.058149364163249e-05,1,0,1
4867,4867,sharedPageBundle,8.058149364163249e-05,1,0,1
4868,4868,sharedServerModule,8.058149364163249e-05,1,0,1
4869,4869,shouldPrefixPathname,8.058149364163249e-05,1,0,1
4870,4870,shouldTriggerClick,8.058149364163249e-05,1,0,1
4871,4871,showEventTriggered,8.058149364163249e-05,1,0,1
4872,4872,showFunction,8.058149364163249e-05,1,0,1
4873,4873,showListener,8.058149364163249e-05,1,0,1
4874,4874,shownFunction,8.058149364163249e-05,1,0,1
4875,4875,sibling,8.058149364163249e-05,1,0,1
4876,4876,signal,8.058149364163249e-05,1,0,1
4877,4877,simpleMachine,8.058149364163249e-05,1,0,1
4878,4878,simplePaths,8.058149364163249e-05,1,0,1
4879,4879,simultaneousMachine,8.058149364163249e-05,1,0,1
4880,4880,sitemap,8.058149364163249e-05,1,0,1
4881,4881,sitemapFilePath,8.058149364163249e-05,1,0,1
4882,4882,sitemapPaths,8.058149364163249e-05,1,0,1
4883,4883,sizeBig,8.058149364163249e-05,1,0,1
4884,4884,sizeSmall,8.058149364163249e-05,1,0,1
4885,4885,sizeToBytes,8.058149364163249e-05,1,0,1
4886,4886,skipTrailingSlashRedirect,8.058149364163249e-05,1,0,1
4887,4887,slidEvent,8.058149364163249e-05,1,0,1
4888,4888,slideTo,8.058149364163249e-05,1,0,1
4889,4889,slugFetchSlug,8.058149364163249e-05,1,0,1
4890,4890,slugSlug,8.058149364163249e-05,1,0,1
4891,4891,small$,8.058149364163249e-05,1,0,1
4892,4892,smallOgUrl,8.058149364163249e-05,1,0,1
4893,4893,socket,8.058149364163249e-05,1,0,1
4894,4894,someDelay,8.058149364163249e-05,1,0,1
4895,4895,someFunc,8.058149364163249e-05,1,0,1
4896,4896,sortBy,8.058149364163249e-05,1,0,1
4897,4897,sortFn,8.058149364163249e-05,1,0,1
4898,4898,source,8.058149364163249e-05,1,0,1
4899,4899,sourcemap,8.058149364163249e-05,1,0,1
4900,4900,sp,8.058149364163249e-05,1,0,1
4901,4901,spawnCalled,8.058149364163249e-05,1,0,1
4902,4902,spawnChild,8.058149364163249e-05,1,0,1
4903,4903,spawnCounter,8.058149364163249e-05,1,0,1
4904,4904,spawned,8.058149364163249e-05,1,0,1
4905,4905,spyAdd,8.058149364163249e-05,1,0,1
4906,4906,spyClear,8.058149364163249e-05,1,0,1
4907,4907,spyClick,8.058149364163249e-05,1,0,1
4908,4908,spyCycle,8.058149364163249e-05,1,0,1
4909,4909,spyDetect,8.058149364163249e-05,1,0,1
4910,4910,spyDispose,8.058149364163249e-05,1,0,1
4911,4911,spyLeft,8.058149364163249e-05,1,0,1
4912,4912,spyOne,8.058149364163249e-05,1,0,1
4913,4913,spyQueue,8.058149364163249e-05,1,0,1
4914,4914,spyRight,8.058149364163249e-05,1,0,1
4915,4915,spySet,8.058149364163249e-05,1,0,1
4916,4916,spyShow,8.058149364163249e-05,1,0,1
4917,4917,spyShow3,8.058149364163249e-05,1,0,1
4918,4918,spyTest,8.058149364163249e-05,1,0,1
4919,4919,spyTo,8.058149364163249e-05,1,0,1
4920,4920,spyUpdate,8.058149364163249e-05,1,0,1
4921,4921,srcFiles,8.058149364163249e-05,1,0,1
4922,4922,srcRoute,8.058149364163249e-05,1,0,1
4923,4923,ssrAppReactVersions,8.058149364163249e-05,1,0,1
4924,4924,ssrInitial,8.058149364163249e-05,1,0,1
4925,4925,ssrPaths,8.058149364163249e-05,1,0,1
4926,4926,ssrUpdated,8.058149364163249e-05,1,0,1
4927,4927,startCount,8.058149364163249e-05,1,0,1
4928,4928,startOfSectionTwo,8.058149364163249e-05,1,0,1
4929,4929,startTime,8.058149364163249e-05,1,0,1
4930,4930,startedService,8.058149364163249e-05,1,0,1
4931,4931,state1,8.058149364163249e-05,1,0,1
4932,4932,stateA,8.058149364163249e-05,1,0,1
4933,4933,stateActual,8.058149364163249e-05,1,0,1
4934,4934,stateB,8.058149364163249e-05,1,0,1
4935,4935,stateC,8.058149364163249e-05,1,0,1
4936,4936,stateCMR,8.058149364163249e-05,1,0,1
4937,4937,stateD2,8.058149364163249e-05,1,0,1
4938,4938,stateF,8.058149364163249e-05,1,0,1
4939,4939,stateMR,8.058149364163249e-05,1,0,1
4940,4940,staticVal,8.058149364163249e-05,1,0,1
4941,4941,stdout,8.058149364163249e-05,1,0,1
4942,4942,step1,8.058149364163249e-05,1,0,1
4943,4943,step2,8.058149364163249e-05,1,0,1
4944,4944,step3,8.058149364163249e-05,1,0,1
4945,4945,step4,8.058149364163249e-05,1,0,1
4946,4946,step5,8.058149364163249e-05,1,0,1
4947,4947,steps,8.058149364163249e-05,1,0,1
4948,4948,stillMorningState,8.058149364163249e-05,1,0,1
4949,4949,stopActivityMachine,8.058149364163249e-05,1,0,1
4950,4950,stopActivityService,8.058149364163249e-05,1,0,1
4951,4951,stopActivityState,8.058149364163249e-05,1,0,1
4952,4952,stopMachine,8.058149364163249e-05,1,0,1
4953,4953,stopState2,8.058149364163249e-05,1,0,1
4954,4954,str,8.058149364163249e-05,1,0,1
4955,4955,stringGuard,8.058149364163249e-05,1,0,1
4956,4956,stringifiedChineseTitle,8.058149364163249e-05,1,0,1
4957,4957,stringifiedScriptTag,8.058149364163249e-05,1,0,1
4958,4958,styleComponent,8.058149364163249e-05,1,0,1
4959,4959,styles,8.058149364163249e-05,1,0,1
4960,4960,subCategories,8.058149364163249e-05,1,0,1
4961,4961,subMachine,8.058149364163249e-05,1,0,1
4962,4962,subcategory,8.058149364163249e-05,1,0,1
4963,4963,subelement,8.058149364163249e-05,1,0,1
4964,4964,subscription,8.058149364163249e-05,1,0,1
4965,4965,sum,8.058149364163249e-05,1,0,1
4966,4966,swipeHelperSpy,8.058149364163249e-05,1,0,1
4967,4967,sync,8.058149364163249e-05,1,0,1
4968,4968,syncChildMachine,8.058149364163249e-05,1,0,1
4969,4969,syncMachine,8.058149364163249e-05,1,0,1
4970,4970,syncModel,8.058149364163249e-05,1,0,1
4971,4971,tab1El,8.058149364163249e-05,1,0,1
4972,4972,tabByElement,8.058149364163249e-05,1,0,1
4973,4973,tabBySelector,8.058149364163249e-05,1,0,1
4974,4974,tabHomeEl,8.058149364163249e-05,1,0,1
4975,4975,tabId,8.058149364163249e-05,1,0,1
4976,4976,tabIdEl,8.058149364163249e-05,1,0,1
4977,4977,tabNested2El,8.058149364163249e-05,1,0,1
4978,4978,tabPanel,8.058149364163249e-05,1,0,1
4979,4979,tabPanel2,8.058149364163249e-05,1,0,1
4980,4980,tabProfileEl,8.058149364163249e-05,1,0,1
4981,4981,target1,8.058149364163249e-05,1,0,1
4982,4982,target2,8.058149364163249e-05,1,0,1
4983,4983,target2Shown,8.058149364163249e-05,1,0,1
4984,4984,testCases,8.058149364163249e-05,1,0,1
4985,4985,testConfig,8.058149364163249e-05,1,0,1
4986,4986,testCosmosPlugin,8.058149364163249e-05,1,0,1
4987,4987,testFixtureElement,8.058149364163249e-05,1,0,1
4988,4988,testMachine1,8.058149364163249e-05,1,0,1
4989,4989,testMachine2,8.058149364163249e-05,1,0,1
4990,4990,testMachineConfig,8.058149364163249e-05,1,0,1
4991,4991,testPath,8.058149364163249e-05,1,0,1
4992,4992,testPaths,8.058149364163249e-05,1,0,1
4993,4993,testResolveDataDir,8.058149364163249e-05,1,0,1
4994,4994,testRoute,8.058149364163249e-05,1,0,1
4995,4995,testServer,8.058149364163249e-05,1,0,1
4996,4996,testSymbol,8.058149364163249e-05,1,0,1
4997,4997,testedEvents,8.058149364163249e-05,1,0,1
4998,4998,testedStateKeys,8.058149364163249e-05,1,0,1
4999,4999,testedStates,8.058149364163249e-05,1,0,1
5000,5000,testpreservefileDir,8.058149364163249e-05,1,0,1
5001,5001,testsWithLocale,8.058149364163249e-05,1,0,1
5002,5002,theme,8.058149364163249e-05,1,0,1
5003,5003,thirdLevel,8.058149364163249e-05,1,0,1
5004,5004,thirdRenderID,8.058149364163249e-05,1,0,1
5005,5005,thirdReport,8.058149364163249e-05,1,0,1
5006,5006,time,8.058149364163249e-05,1,0,1
5007,5007,timeToComplete,8.058149364163249e-05,1,0,1
5008,5008,timer,8.058149364163249e-05,1,0,1
5009,5009,timerMachine,8.058149364163249e-05,1,0,1
5010,5010,titleString,8.058149364163249e-05,1,0,1
5011,5011,titleTemplate,8.058149364163249e-05,1,0,1
5012,5012,tmpFolder,8.058149364163249e-05,1,0,1
5013,5013,toAST,8.058149364163249e-05,1,0,1
5014,5014,toArray,8.058149364163249e-05,1,0,1
5015,5015,toBeCalled,8.058149364163249e-05,1,0,1
5016,5016,toComponent,8.058149364163249e-05,1,0,1
5017,5017,toJS,8.058149364163249e-05,1,0,1
5018,5018,toSCXMLEvent,8.058149364163249e-05,1,0,1
5019,5019,toStartWith,8.058149364163249e-05,1,0,1
5020,5020,toState,8.058149364163249e-05,1,0,1
5021,5021,toStrings,8.058149364163249e-05,1,0,1
5022,5022,toast2,8.058149364163249e-05,1,0,1
5023,5023,toastByElement,8.058149364163249e-05,1,0,1
5024,5024,toastBySelector,8.058149364163249e-05,1,0,1
5025,5025,todos,8.058149364163249e-05,1,0,1
5026,5026,toolbar,8.058149364163249e-05,1,0,1
5027,5027,tooltipByElement,8.058149364163249e-05,1,0,1
5028,5028,tooltipBySelector,8.058149364163249e-05,1,0,1
5029,5029,tooltipContainer,8.058149364163249e-05,1,0,1
5030,5030,tooltipInContainerEl,8.058149364163249e-05,1,0,1
5031,5031,tooltipWithTitleEl,8.058149364163249e-05,1,0,1
5032,5032,tooltipWithoutTitleEl,8.058149364163249e-05,1,0,1
5033,5033,toplevel,8.058149364163249e-05,1,0,1
5034,5034,transaction,8.058149364163249e-05,1,0,1
5035,5035,transientMachine,8.058149364163249e-05,1,0,1
5036,5036,treePath,8.058149364163249e-05,1,0,1
5037,5037,trigger1,8.058149364163249e-05,1,0,1
5038,5038,trigger3,8.058149364163249e-05,1,0,1
5039,5039,triggerActive,8.058149364163249e-05,1,0,1
5040,5040,triggerChild,8.058149364163249e-05,1,0,1
5041,5041,triggerSpy,8.058149364163249e-05,1,0,1
5042,5042,triggerTabHomeEl,8.058149364163249e-05,1,0,1
5043,5043,triggerTabProfileEl,8.058149364163249e-05,1,0,1
5044,5044,triggerTwoEl,8.058149364163249e-05,1,0,1
5045,5045,twitterDescription,8.058149364163249e-05,1,0,1
5046,5046,twitterImage,8.058149364163249e-05,1,0,1
5047,5047,twitterImageUrlInstance,8.058149364163249e-05,1,0,1
5048,5048,twitterImageUrlPattern,8.058149364163249e-05,1,0,1
5049,5049,twitterTitle,8.058149364163249e-05,1,0,1
5050,5050,typeCheckFailRequiredValues,8.058149364163249e-05,1,0,1
5051,5051,u2,8.058149364163249e-05,1,0,1
5052,5052,uiJs,8.058149364163249e-05,1,0,1
5053,5053,uiModule,8.058149364163249e-05,1,0,1
5054,5054,uid2,8.058149364163249e-05,1,0,1
5055,5055,unchangedState,8.058149364163249e-05,1,0,1
5056,5056,underline,8.058149364163249e-05,1,0,1
5057,5057,uninitialized,8.058149364163249e-05,1,0,1
5058,5058,uniqueSlug,8.058149364163249e-05,1,0,1
5059,5059,unit,8.058149364163249e-05,1,0,1
5060,5060,units,8.058149364163249e-05,1,0,1
5061,5061,unresolvedStateValue,8.058149364163249e-05,1,0,1
5062,5062,unsafe,8.058149364163249e-05,1,0,1
5063,5063,unsavedState,8.058149364163249e-05,1,0,1
5064,5064,up,8.058149364163249e-05,1,0,1
5065,5065,updateAge,8.058149364163249e-05,1,0,1
5066,5066,updateDocs,8.058149364163249e-05,1,0,1
5067,5067,updateName,8.058149364163249e-05,1,0,1
5068,5068,updated,8.058149364163249e-05,1,0,1
5069,5069,updatedContent,8.058149364163249e-05,1,0,1
5070,5070,url$,8.058149364163249e-05,1,0,1
5071,5071,url2,8.058149364163249e-05,1,0,1
5072,5072,url3,8.058149364163249e-05,1,0,1
5073,5073,urlInstance$,8.058149364163249e-05,1,0,1
5074,5074,urls,8.058149364163249e-05,1,0,1
5075,5075,useColors,8.058149364163249e-05,1,0,1
5076,5076,userAgent,8.058149364163249e-05,1,0,1
5077,5077,userAgents,8.058149364163249e-05,1,0,1
5078,5078,userConfig,8.058149364163249e-05,1,0,1
5079,5079,userInstance,8.058149364163249e-05,1,0,1
5080,5080,validParams,8.058149364163249e-05,1,0,1
5081,5081,validUrls,8.058149364163249e-05,1,0,1
5082,5082,validity,8.058149364163249e-05,1,0,1
5083,5083,vals,8.058149364163249e-05,1,0,1
5084,5084,value1,8.058149364163249e-05,1,0,1
5085,5085,verify,8.058149364163249e-05,1,0,1
5086,5086,versionParts,8.058149364163249e-05,1,0,1
5087,5087,virtualElement,8.058149364163249e-05,1,0,1
5088,5088,waitingState,8.058149364163249e-05,1,0,1
5089,5089,warnOptionHasBeenMovedOutOfExperimental,8.058149364163249e-05,1,0,1
5090,5090,warnings,8.058149364163249e-05,1,0,1
5091,5091,watchDirs,8.058149364163249e-05,1,0,1
5092,5092,windowMock,8.058149364163249e-05,1,0,1
5093,5093,windowSpy,8.058149364163249e-05,1,0,1
5094,5094,withConfig,8.058149364163249e-05,1,0,1
5095,5095,withCustomPagesLinter,8.058149364163249e-05,1,0,1
5096,5096,withSelector,8.058149364163249e-05,1,0,1
5097,5097,withoutSelector,8.058149364163249e-05,1,0,1
5098,5098,xTab1El,8.058149364163249e-05,1,0,1
5099,5099,xfwd,8.058149364163249e-05,1,0,1
5100,5100,xyz,8.058149364163249e-05,1,0,1
5101,5101,yellowOneState,8.058149364163249e-05,1,0,1
5102,5102,"}"" - ""${",8.058149364163249e-05,1,0,1
5103,5103,"}""`",8.058149364163249e-05,1,0,1
5104,5104,}'`,8.058149364163249e-05,1,0,1
5105,5105,}/dynamic/oopsie.json`,8.058149364163249e-05,1,0,1
5106,5106,}/edge/dynamic/123`,8.058149364163249e-05,1,0,1
5107,5107,}/error-route`,8.058149364163249e-05,1,0,1
5108,5108,}/hello#some-hash`,8.058149364163249e-05,1,0,1
5109,5109,}/slow-route`,8.058149364163249e-05,1,0,1
5110,5110,}/somewhere-else`,8.058149364163249e-05,1,0,1
5111,5111,}</style>`,8.058149364163249e-05,1,0,1
5112,5112,"}=""true"">${",8.058149364163249e-05,1,0,1
5113,5113,"}=""true""></script>`",8.058149364163249e-05,1,0,1
5114,5114,}hello`,8.058149364163249e-05,1,0,1
5115,5115,reject,6.887010284800307e-05,70,32,38
5116,5116,"
          ",0.0,0,0,0
5117,5117,""" """,0.0,0,0,0
5118,5118,"""#inputId""",0.0,0,0,0
5119,5119,"""(\u03944) J'entends par attribut ce que l'entendement perçoit d'une substance comme constituant son essence. """,0.0,0,0,0
5120,5120,""".pt-overlay-backdrop""",0.0,0,0,0
5121,5121,"""0""",0.0,0,0,0
5122,5122,"""100""",0.0,0,0,0
5123,5123,"""ArrowDown""",0.0,0,0,0
5124,5124,"""Could not find webview in contexts:""",0.0,0,0,0
5125,5125,"""Existing Title""",0.0,0,0,0
5126,5126,"""Focus management""",0.0,0,0,0
5127,5127,"""Hello World""",0.0,0,0,0
5128,5128,"""Language""",0.0,0,0,0
5129,5129,"""One""",0.0,0,0,0
5130,5130,"""Stopping tests as webview context was not found.""",0.0,0,0,0
5131,5131,"""Three""",0.0,0,0,0
5132,5132,"""Uncle Moe's Family Feedbag{enter}""",0.0,0,0,0
5133,5133,"""a.btn-now""",0.0,0,0,0
5134,5134,"""autoFocus element inside overlay gets the focus""",0.0,0,0,0
5135,5135,"""body""",0.0,0,0,0
5136,5136,"""bringFocusInsideOverlay""",0.0,0,0,0
5137,5137,"""brings focus to overlay if autoFocus=true""",0.0,0,0,0
5138,5138,"""button""",0.0,0,0,0
5139,5139,"""change language""",0.0,0,0,0
5140,5140,"""clears title tag if empty title is defined""",0.0,0,0,0
5141,5141,"""click""",0.0,0,0,0
5142,5142,"""creates a query, edits the query, edits the cell's default name, edits it again, submits with the keyboard, then chills""",0.0,0,0,0
5143,5143,"""cyan""",0.0,0,0,0
5144,5144,"""date-time""",0.0,0,0,0
5145,5145,"""deepskyblue""",0.0,0,0,0
5146,5146,"""does not bring focus to overlay if autoFocus=false""",0.0,0,0,0
5147,5147,"""does not focus overlay when closed""",0.0,0,0,0
5148,5148,"""does not result in maximum call stack if two overlays open with enforceFocus=true""",0.0,0,0,0
5149,5149,"""does not return focus to overlay if enforceFocus=false""",0.0,0,0,0
5150,5150,"""doesn't focus overlay if focus is already inside overlay""",0.0,0,0,0
5151,5151,"""effect debounce is honored""",0.0,0,0,0
5152,5152,"""form""",0.0,0,0,0
5153,5153,"""hotpink""",0.0,0,0,0
5154,5154,"""input""",0.0,0,0,0
5155,5155,"""inputId""",0.0,0,0,0
5156,5156,"""mousedown""",0.0,0,0,0
5157,5157,"""orangered""",0.0,0,0,0
5158,5158,"""range""",0.0,0,0,0
5159,5159,"""react-datepicker__day--today""",0.0,0,0,0
5160,5160,"""returns focus to overlay after clicking the backdrop if enforceFocus=true""",0.0,0,0,0
5161,5161,"""returns focus to overlay if enforceFocus=true""",0.0,0,0,0
5162,5162,"""should be one postcard remaining after delete""",0.0,0,0,0
5163,5163,"""should delete a postcard""",0.0,0,0,0
5164,5164,"""should navigate Player One/Team One then back separately""",0.0,0,0,0
5165,5165,"""should set current date when pressing the Now button""",0.0,0,0,0
5166,5166,"""should update the preSelection state when a day is selected with mouse click""",0.0,0,0,0
5167,5167,"""string""",0.0,0,0,0
5168,5168,"""test2""",0.0,0,0,0
5169,5169,"""textarea""",0.0,0,0,0
5170,5170,"""woofTooltip""",0.0,0,0,0
5171,5171,$$eval,0.0,0,0,0
5172,5172,"'        ""value"": 4'",0.0,0,0,0
5173,5173,'    /  /  ',0.0,0,0,0
5174,5174,' ',0.0,0,0,0
5175,5175,' (after dblclick)',0.0,0,0,0
5176,5176,' (before dblclick)',0.0,0,0,0
5177,5177,' - ',0.0,0,0,0
5178,5178,' - curve number',0.0,0,0,0
5179,5179,' - point number',0.0,0,0,0
5180,5180,' - uid',0.0,0,0,0
5181,5181,' - x',0.0,0,0,0
5182,5182,' - xaxis',0.0,0,0,0
5183,5183,' - y',0.0,0,0,0
5184,5184,' - yaxis',0.0,0,0,0
5185,5185,' button',0.0,0,0,0
5186,5186,' has changed x position',0.0,0,0,0
5187,5187,' has changed y position',0.0,0,0,0
5188,5188,' has not changed x position',0.0,0,0,0
5189,5189,' has not changed y position',0.0,0,0,0
5190,5190,' val',0.0,0,0,0
5191,5191,'#7ED321',0.0,0,0,0
5192,5192,'#AB14CE',0.0,0,0,0
5193,5193,'#B0D0FF',0.0,0,0,0
5194,5194,'#D0D0F8',0.0,0,0,0
5195,5195,'#DDDDDD',0.0,0,0,0
5196,5196,'#F8E71C',0.0,0,0,0
5197,5197,'#FFFFFF',0.0,0,0,0
5198,5198,'#delete-all',0.0,0,0,0
5199,5199,'#editButton',0.0,0,0,0
5200,5200,'#error-in-gip-link',0.0,0,0,0
5201,5201,'#hello-link',0.0,0,0,0
5202,5202,'#index-page',0.0,0,0,0
5203,5203,'#inner-scroll',0.0,0,0,0
5204,5204,'#myPostcards',0.0,0,0,0
5205,5205,'(\u03944) Per attributum intelligo id quod intellectus de substantia percipit tanquam ejusdem essentiam constituens. ',0.0,0,0,0
5206,5206,'(reset ',0.0,0,0,0
5207,5207,') lasso points ',0.0,0,0,0
5208,5208,') select box range ',0.0,0,0,0
5209,5209,')',0.0,0,0,0
5210,5210,"','",0.0,0,0,0
5211,5211,'- event data',0.0,0,0,0
5212,5212,'-100px',0.0,0,0,0
5213,5213,'-20px',0.0,0,0,0
5214,5214,'../panel/panel',0.0,0,0,0
5215,5215,'../panel/panel.stories',0.0,0,0,0
5216,5216,'../preview/preview',0.0,0,0,0
5217,5217,'../preview/preview.stories',0.0,0,0,0
5218,5218,'../sidebar/Sidebar',0.0,0,0,0
5219,5219,'../sidebar/treeview/treeview.mockdata',0.0,0,0,0
5220,5220,'./desktop',0.0,0,0,0
5221,5221,'./mobile',0.0,0,0,0
5222,5222,'./persist',0.0,0,0,0
5223,5223,'.CodeMirror textarea',0.0,0,0,0
5224,5224,'.CodeMirror-line:eq(4)',0.0,0,0,0
5225,5225,'.axis',0.0,0,0,0
5226,5226,'.bottom',0.0,0,0,0
5227,5227,'.cdk-overlay-pane .mat-select-panel',0.0,0,0,0
5228,5228,'.cdk-overlay-pane mat-option',0.0,0,0,0
5229,5229,'.cdk-overlay-pane',0.0,0,0,0
5230,5230,'.cf-input-field',0.0,0,0,0
5231,5231,'.imaging-type-input .tt-input',0.0,0,0,0
5232,5232,'.left',0.0,0,0,0
5233,5233,'.mat-mdc-menu-panel',0.0,0,0,0
5234,5234,'.message .title',0.0,0,0,0
5235,5235,'.modal-dialog',0.0,0,0,0
5236,5236,'.modal-title',0.0,0,0,0
5237,5237,'.nsewdrag',0.0,0,0,0
5238,5238,'.page-header--container',0.0,0,0,0
5239,5239,'.polar > .draglayer > .maindrag',0.0,0,0,0
5240,5240,'.radiologist-input .tt-input',0.0,0,0,0
5241,5241,'.result-input input',0.0,0,0,0
5242,5242,'.right',0.0,0,0,0
5243,5243,'.ring-button',0.0,0,0,0
5244,5244,'.ring-input',0.0,0,0,0
5245,5245,'.variables-toolbar--label',0.0,0,0,0
5246,5246,'.veo-contents',0.0,0,0,0
5247,5247,'/api/users.list',0.0,0,0,0
5248,5248,'/api/v2/buckets/000000000000000a',0.0,0,0,0
5249,5249,'/api/v2/buckets/000000000000000a/labels',0.0,0,0,0
5250,5250,'/api/v2/buckets/000000000000000a/logs',0.0,0,0,0
5251,5251,'/api/v2/buckets/000000000000000a/members',0.0,0,0,0
5252,5252,'/api/v2/buckets/000000000000000a/owners',0.0,0,0,0
5253,5253,'/api/v2/buckets/000000000000000b',0.0,0,0,0
5254,5254,'/api/v2/buckets/000000000000000b/labels',0.0,0,0,0
5255,5255,'/api/v2/buckets/000000000000000b/logs',0.0,0,0,0
5256,5256,'/api/v2/buckets/000000000000000b/members',0.0,0,0,0
5257,5257,'/api/v2/buckets/000000000000000b/owners',0.0,0,0,0
5258,5258,'/api/v2/buckets/7902bd683453c00c',0.0,0,0,0
5259,5259,'/api/v2/buckets/7902bd683453c00c/labels',0.0,0,0,0
5260,5260,'/api/v2/buckets/7902bd683453c00c/logs',0.0,0,0,0
5261,5261,'/api/v2/buckets/7902bd683453c00c/members',0.0,0,0,0
5262,5262,'/api/v2/buckets/7902bd683453c00c/owners',0.0,0,0,0
5263,5263,'/api/v2/buckets/7f44462ac794c7c1',0.0,0,0,0
5264,5264,'/api/v2/buckets/7f44462ac794c7c1/labels',0.0,0,0,0
5265,5265,'/api/v2/buckets/7f44462ac794c7c1/logs',0.0,0,0,0
5266,5266,'/api/v2/buckets/7f44462ac794c7c1/members',0.0,0,0,0
5267,5267,'/api/v2/buckets/7f44462ac794c7c1/owners',0.0,0,0,0
5268,5268,'/api/v2/buckets/a8fee6b433c16f86',0.0,0,0,0
5269,5269,'/api/v2/buckets/a8fee6b433c16f86/labels',0.0,0,0,0
5270,5270,'/api/v2/buckets/a8fee6b433c16f86/logs',0.0,0,0,0
5271,5271,'/api/v2/buckets/a8fee6b433c16f86/members',0.0,0,0,0
5272,5272,'/api/v2/buckets/a8fee6b433c16f86/owners',0.0,0,0,0
5273,5273,'/api/v2/buckets/adbb0107da2d7d38',0.0,0,0,0
5274,5274,'/api/v2/buckets/adbb0107da2d7d38/labels',0.0,0,0,0
5275,5275,'/api/v2/buckets/adbb0107da2d7d38/logs',0.0,0,0,0
5276,5276,'/api/v2/buckets/adbb0107da2d7d38/members',0.0,0,0,0
5277,5277,'/api/v2/buckets/adbb0107da2d7d38/owners',0.0,0,0,0
5278,5278,'/api/v2/buckets/e2871ad8f92e752a',0.0,0,0,0
5279,5279,'/api/v2/buckets/e2871ad8f92e752a/labels',0.0,0,0,0
5280,5280,'/api/v2/buckets/e2871ad8f92e752a/logs',0.0,0,0,0
5281,5281,'/api/v2/buckets/e2871ad8f92e752a/members',0.0,0,0,0
5282,5282,'/api/v2/buckets/e2871ad8f92e752a/owners',0.0,0,0,0
5283,5283,'/api/v2/write?org=&bucket=000000000000000a',0.0,0,0,0
5284,5284,'/api/v2/write?org=&bucket=000000000000000b',0.0,0,0,0
5285,5285,'/api/v2/write?org=e483753c9bdb47bf&bucket=7902bd683453c00c',0.0,0,0,0
5286,5286,'/api/v2/write?org=e483753c9bdb47bf&bucket=7f44462ac794c7c1',0.0,0,0,0
5287,5287,'/api/v2/write?org=e483753c9bdb47bf&bucket=a8fee6b433c16f86',0.0,0,0,0
5288,5288,'/api/v2/write?org=e483753c9bdb47bf&bucket=adbb0107da2d7d38',0.0,0,0,0
5289,5289,'/api/v2/write?org=e483753c9bdb47bf&bucket=e2871ad8f92e752a',0.0,0,0,0
5290,5290,'/hmr',0.0,0,0,0
5291,5291,'/hmr/contact',0.0,0,0,0
5292,5292,'/hmr/error-in-gip',0.0,0,0,0
5293,5293,'/hmr/new-page',0.0,0,0,0
5294,5294,'/orgs/',0.0,0,0,0
5295,5295,'/select/multiple-select-with-a-description.html',0.0,0,0,0
5296,5296,'/select/select-with-a-customized-filter-and-an-add-item-button.html',0.0,0,0,0
5297,5297,'/select/simple-input-based-select.html',0.0,0,0,0
5298,5298,'/select/simple-select-with-default-filter-mode-enabled.html',0.0,0,0,0
5299,5299,'000000000000000a',0.0,0,0,0
5300,5300,'000000000000000b',0.0,0,0,0
5301,5301,'10',0.0,0,0,0
5302,5302,'12/12/2030',0.0,0,0,0
5303,5303,'2000px',0.0,0,0,0
5304,5304,'200px',0.0,0,0,0
5305,5305,'2019-01-01',0.0,0,0,0
5306,5306,'2019-10-18T14:05:24.838291-07:00',0.0,0,0,0
5307,5307,'2019-10-18T14:05:24.838292-07:00',0.0,0,0,0
5308,5308,'2019-11-05T08:57:54.459819-08:00',0.0,0,0,0
5309,5309,'2019-11-05T08:57:59.280485-08:00',0.0,0,0,0
5310,5310,'2019-11-05T08:57:59.280486-08:00',0.0,0,0,0
5311,5311,'2019-11-05T08:58:09.593805-08:00',0.0,0,0,0
5312,5312,'2019/12/25 – 2019/12/31',0.0,0,0,0
5313,5313,'35',0.0,0,0,0
5314,5314,'4h',0.0,0,0,0
5315,5315,'56px',0.0,0,0,0
5316,5316,'7',0.0,0,0,0
5317,5317,'7902bd683453c00c',0.0,0,0,0
5318,5318,'7f44462ac794c7c1',0.0,0,0,0
5319,5319,'</Button>',0.0,0,0,0
5320,5320,"'<div foo=""bar"" j=""2"" i=""2"">inner</div>'",0.0,0,0,0
5321,5321,"'<div foo=""bar"" j=""4"" i=""5"">inner</div>'",0.0,0,0,0
5322,5322,"'<div id=\""dynamic-tt-test\""/>'",0.0,0,0,0
5323,5323,"'<div is-alt=""true""></div>'",0.0,0,0,0
5324,5324,"'<div style=\""display: inline-block; position: absolute; left: 0; top: 0;\"" rel=\""tooltip\"" title=\""Top tooltip\"">Top Dynamic Tooltip</div>'",0.0,0,0,0
5325,5325,"'<div style=\""display: inline-block; position: absolute; left: 0;\"" rel=\""tooltip\"" title=\""Left tooltip\"">Left Dynamic Tooltip</div>'",0.0,0,0,0
5326,5326,"'<div style=\""display: inline-block; position: absolute; right: 0;\"" rel=\""tooltip\"" title=\""Right tooltip\"">Right Dynamic Tooltip</div>'",0.0,0,0,0
5327,5327,"'<input type=""range"" min=""0"" max=""100"" list=""steplist"">'",0.0,0,0,0
5328,5328,'> 16.8.3',0.0,0,0,0
5329,5329,'>',0.0,0,0,0
5330,5330,'?query=true',0.0,0,0,0
5331,5331,'@build/credentials.json',0.0,0,0,0
5332,5332,'@container',0.0,0,0,0
5333,5333,'@flaky Click-to-select',0.0,0,0,0
5334,5334,'@flaky Skip dimensions which are not plain objects or whose `values` is not an array',0.0,0,0,0
5335,5335,'@flaky Test select box and lasso per trace:',0.0,0,0,0
5336,5336,'@flaky being sized relative to data vertically is getting lower ',0.0,0,0,0
5337,5337,'@flaky can drag colorbars linked to color axes in editable mode',0.0,0,0,0
5338,5338,'@flaky can drag marker-level colorbars in editable mode',0.0,0,0,0
5339,5339,'@flaky can drag root-level colorbars in editable mode',0.0,0,0,0
5340,5340,'@flaky has no hover effects for titles that used to be blank',0.0,0,0,0
5341,5341,'@flaky should be able to toggle visibility',0.0,0,0,0
5342,5342,'@flaky should change plot type with incomplete data',0.0,0,0,0
5343,5343,'@flaky should cleanly clear and restart selections on double click when add/subtract mode on',0.0,0,0,0
5344,5344,'@flaky should not scroll document while panning',0.0,0,0,0
5345,5345,'@flaky should not transition layout when axis auto-ranged value do not changed',0.0,0,0,0
5346,5346,'@flaky should only transition the layout when both traces and layout have animatable changes by default',0.0,0,0,0
5347,5347,'@flaky should persist the position of every nodes after drag in attributes nodes.(x|y)',0.0,0,0,0
5348,5348,'@flaky should remove fill2d',0.0,0,0,0
5349,5349,'@flaky should respond to drag interactions on plot area',0.0,0,0,0
5350,5350,'@flaky should sort z data based on axis categoryorder for ',0.0,0,0,0
5351,5351,'@flaky should still be responsive if the plot is edited',0.0,0,0,0
5352,5352,'@flaky should transition layout when one or more axis auto-ranged value changed',0.0,0,0,0
5353,5353,'@flaky should update ranges of date and category axes',0.0,0,0,0
5354,5354,'@flaky snaps ordinal constraints',0.0,0,0,0
5355,5355,'@flaky supports axis constraints with zoom',0.0,0,0,0
5356,5356,'@gl @flaky Test hover and click interactions',0.0,0,0,0
5357,5357,'@gl Plotly.newPlot should remove gl context from the graph div of a gl2d plot',0.0,0,0,0
5358,5358,'@gl Plots.cleanPlot should remove gl context from the graph div of a gl2d plot',0.0,0,0,0
5359,5359,'@gl should display correct hover labels of the second point of the very first scatter3d trace',0.0,0,0,0
5360,5360,'@gl should honor *hoverlabel.namelength*',0.0,0,0,0
5361,5361,'@mocks/0',0.0,0,0,0
5362,5362,'@mocks/0.json',0.0,0,0,0
5363,5363,'@mocks/14.json',0.0,0,0,0
5364,5364,'@mocks/box_grouped',0.0,0,0,0
5365,5365,'@mocks/finance_style.json',0.0,0,0,0
5366,5366,'@mocks/geo_choropleth-text',0.0,0,0,0
5367,5367,'@mocks/geo_choropleth-text.json',0.0,0,0,0
5368,5368,'@mocks/gl2d_axes_labels2.json',0.0,0,0,0
5369,5369,'@mocks/heatmap_categoryorder',0.0,0,0,0
5370,5370,'@mocks/hist_grouped',0.0,0,0,0
5371,5371,'@mocks/mapbox_0.json',0.0,0,0,0
5372,5372,'@mocks/mapbox_bubbles-text',0.0,0,0,0
5373,5373,'@mocks/ohlc_first.json',0.0,0,0,0
5374,5374,'@mocks/polar_scatter.json',0.0,0,0,0
5375,5375,'@mocks/polar_subplots',0.0,0,0,0
5376,5376,'@mocks/scattercarpet',0.0,0,0,0
5377,5377,'@mocks/ternary_simple',0.0,0,0,0
5378,5378,'@mocks/violin_grouped',0.0,0,0,0
5379,5379,'@mocks/violin_grouped.json',0.0,0,0,0
5380,5380,'@noCI should work on scattermapbox traces',0.0,0,0,0
5381,5381,'@preview',0.0,0,0,0
5382,5382,'@token',0.0,0,0,0
5383,5383,'Active',0.0,0,0,0
5384,5384,'Add 1 <Fragment> to parent 1',0.0,0,0,0
5385,5385,'Add 10 <span> to parent 4',0.0,0,0,0
5386,5386,'Add 11 <Foo> to parent 1',0.0,0,0,0
5387,5387,'Add 2 <Foo> to parent 1',0.0,0,0,0
5388,5388,'Add 2 <Parent> to parent 1',0.0,0,0,0
5389,5389,'Add 2 <div> to parent 1',0.0,0,0,0
5390,5390,'Add 3 <Bar> to parent 2',0.0,0,0,0
5391,5391,'Add 3 <Foo> to parent 11',0.0,0,0,0
5392,5392,'Add 3 <Foo> to parent 2',0.0,0,0,0
5393,5393,'Add 3 <Foo> to parent 7',0.0,0,0,0
5394,5394,'Add 3 <div> to parent 1',0.0,0,0,0
5395,5395,'Add 4 <Foo> to parent 3',0.0,0,0,0
5396,5396,'Add 4 <div> to parent 1',0.0,0,0,0
5397,5397,'Add 4 <div> to parent 3',0.0,0,0,0
5398,5398,'Add 5 <Foo> to parent 4',0.0,0,0,0
5399,5399,'Add 5 <div> to parent 4',0.0,0,0,0
5400,5400,'Add 6 <div> to parent 5',0.0,0,0,0
5401,5401,'Add 6 <span> to parent 3',0.0,0,0,0
5402,5402,'Add 7 <h1> to parent 6',0.0,0,0,0
5403,5403,'Add 7 <span> to parent 3',0.0,0,0,0
5404,5404,'Add 8 <div> to parent 3',0.0,0,0,0
5405,5405,'Add 9 <span> to parent 4',0.0,0,0,0
5406,5406,'Administration',0.0,0,0,0
5407,5407,'Animation',0.0,0,0,0
5408,5408,'Application Metrics',0.0,0,0,0
5409,5409,'ArrowRight',0.0,0,0,0
5410,5410,'Audits',0.0,0,0,0
5411,5411,'Backspace',0.0,0,0,0
5412,5412,'Backup',0.0,0,0,0
5413,5413,'Bucky',0.0,0,0,0
5414,5414,'Calculates correct virtual bounds when masonry is offset with custom virtual bounds',0.0,0,0,0
5415,5415,'Can Onboard to Quick Start',0.0,0,0,0
5416,5416,'Can onboard to advanced',0.0,0,0,0
5417,5417,'Can onboard to configure later',0.0,0,0,0
5418,5418,'Check is clear',0.0,0,0,0
5419,5419,'Chest Scan',0.0,0,0,0
5420,5420,'Collectors',0.0,0,0,0
5421,5421,'Configuration',0.0,0,0,0
5422,5422,'Create Configuration',0.0,0,0,0
5423,5423,'Create and Verify',0.0,0,0,0
5424,5424,'Create',0.0,0,0,0
5425,5425,'D',0.0,0,0,0
5426,5426,'December 2019',0.0,0,0,0
5427,5427,'Disabled in IE because of weird rendering artefact',0.0,0,0,0
5428,5428,'Dr Test',0.0,0,0,0
5429,5429,'E',0.0,0,0,0
5430,5430,'EDT',0.0,0,0,0
5431,5431,'EST',0.0,0,0,0
5432,5432,'EZ_buckets',0.0,0,0,0
5433,5433,'Edit Label',0.0,0,0,0
5434,5434,'End',0.0,0,0,0
5435,5435,'Error Recovery',0.0,0,0,0
5436,5436,'Expect toggle once',0.0,0,0,0
5437,5437,'Expect toggle twice',0.0,0,0,0
5438,5438,'Expected both overlays to be tracked.',0.0,0,0,0
5439,5439,'Expected one to be first.',0.0,0,0,0
5440,5440,'Expected one to now be last.',0.0,0,0,0
5441,5441,'Expected two to be last.',0.0,0,0,0
5442,5442,'Expected two to now be first.',0.0,0,0,0
5443,5443,'F',0.0,0,0,0
5444,5444,'Finish',0.0,0,0,0
5445,5445,'HTMLDataListElement',0.0,0,0,0
5446,5446,'Health Checks',0.0,0,0,0
5447,5447,'Home',0.0,0,0,0
5448,5448,'Imaging Request Saved',0.0,0,0,0
5449,5449,'Imaging Request was saved successfully',0.0,0,0,0
5450,5450,'Inactive',0.0,0,0,0
5451,5451,'Initial User Setup',0.0,0,0,0
5452,5452,'Input based select',0.0,0,0,0
5453,5453,'Lennex Zinyando - P00017',0.0,0,0,0
5454,5454,'Linux',0.0,0,0,0
5455,5455,'Listen for Data',0.0,0,0,0
5456,5456,'Loads more when it gets to the bottom of the viewport',0.0,0,0,0
5457,5457,'Logs',0.0,0,0,0
5458,5458,'MO_buckets',0.0,0,0,0
5459,5459,'Mag',0.0,0,0,0
5460,5460,'Masonry > External cache',0.0,0,0,0
5461,5461,'Masonry > Null items',0.0,0,0,0
5462,5462,'Masonry > Scrolls',0.0,0,0,0
5463,5463,'Masonry',0.0,0,0,0
5464,5464,'MasonryInfinite',0.0,0,0,0
5465,5465,'Multi-value select with options descriptions',0.0,0,0,0
5466,5466,'My Goal',0.0,0,0,0
5467,5467,'Name this Cell',0.0,0,0,0
5468,5468,'Onboarding',0.0,0,0,0
5469,5469,'Open Sans',0.0,0,0,0
5470,5470,'Open',0.0,0,0,0
5471,5471,'Open/Close Component',0.0,0,0,0
5472,5472,'OverlayKeyboardDispatcher',0.0,0,0,0
5473,5473,'Page.getLayoutMetrics',0.0,0,0,0
5474,5474,'PageDown',0.0,0,0,0
5475,5475,'PageUp',0.0,0,0,0
5476,5476,'Patient is healthy',0.0,0,0,0
5477,5477,'Patient summary is displayed',0.0,0,0,0
5478,5478,'Push Me Harder',0.0,0,0,0
5479,5479,'Remove 10',0.0,0,0,0
5480,5480,'Remove 2',0.0,0,0,0
5481,5481,'Remove 3',0.0,0,0,0
5482,5482,'Remove 4',0.0,0,0,0
5483,5483,'Remove 5',0.0,0,0,0
5484,5484,'Remove 9',0.0,0,0,0
5485,5485,'Searching and filtering',0.0,0,0,0
5486,5486,'Searching buckets',0.0,0,0,0
5487,5487,'Select button',0.0,0,0,0
5488,5488,'Select with filter',0.0,0,0,0
5489,5489,'Select',0.0,0,0,0
5490,5490,'Setup Initial User',0.0,0,0,0
5491,5491,'Should not throw an error when null/undefined items are inserted',0.0,0,0,0
5492,5492,'Sorting by Retention',0.0,0,0,0
5493,5493,'Submit',0.0,0,0,0
5494,5494,'System bucket for monitoring logs',0.0,0,0,0
5495,5495,'System bucket for task logs',0.0,0,0,0
5496,5496,'Task',0.0,0,0,0
5497,5497,'Test removal of gl contexts',0.0,0,0,0
5498,5498,'The box is now Closed!',0.0,0,0,0
5499,5499,'The box is now Open!',0.0,0,0,0
5500,5500,'This is a new config testing',0.0,0,0,0
5501,5501,'This is new name',0.0,0,0,0
5502,5502,'This is not a plain object',0.0,0,0,0
5503,5503,'This is not an array',0.0,0,0,0
5504,5504,'TimezonePicker',0.0,0,0,0
5505,5505,'Title',0.0,0,0,0
5506,5506,'UI|Layout/Desktop',0.0,0,0,0
5507,5507,'Update timings 2',0.0,0,0,0
5508,5508,'Update timings 3',0.0,0,0,0
5509,5509,'WEBVIEW',0.0,0,0,0
5510,5510,'Welcome',0.0,0,0,0
5511,5511,'When tasks already exist',0.0,0,0,0
5512,5512,'Windows',0.0,0,0,0
5513,5513,"'[aria-label=""Choose Tuesday, December 31st 2019. It\'s available.""]'",0.0,0,0,0
5514,5514,"'[aria-label=""Choose Wednesday, December 25th 2019. It\'s available.""]'",0.0,0,0,0
5515,5515,"'[data-baseweb=""calendar""]'",0.0,0,0,0
5516,5516,"'[data-id=""monthYearSelectButton""]'",0.0,0,0,0
5517,5517,"'[data-id=""monthYearSelectMenu""]'",0.0,0,0,0
5518,5518,'_constructor',0.0,0,0,0
5519,5519,'a8fee6b433c16f86',0.0,0,0,0
5520,5520,'aa=20;\nexport',0.0,0,0,0
5521,5521,'actions navigation',0.0,0,0,0
5522,5522,'adbb0107da2d7d38',0.0,0,0,0
5523,5523,'add-resource-dropdown--button',0.0,0,0,0
5524,5524,'add-resource-dropdown--new',0.0,0,0,0
5525,5525,'add-resource-dropdown--template',0.0,0,0,0
5526,5526,'admin-step--head-main',0.0,0,0,0
5527,5527,'aggregate',0.0,0,0,0
5528,5528,'alert-success',0.0,0,0,0
5529,5529,'all',0.0,0,0,0
5530,5530,'and dragmode is ',0.0,0,0,0
5531,5531,'api/v2/setup',0.0,0,0,0
5532,5532,'apple',0.0,0,0,0
5533,5533,'arguments[0].click()',0.0,0,0,0
5534,5534,'attribut (атрибут)',0.0,0,0,0
5535,5535,'attributum (атрибут)',0.0,0,0,0
5536,5536,'audits',0.0,0,0,0
5537,5537,'audits-page-heading',0.0,0,0,0
5538,5538,'auto left',0.0,0,0,0
5539,5539,'avg',0.0,0,0,0
5540,5540,'axes are autorange:true by default',0.0,0,0,0
5541,5541,'axes are now autorange:false',0.0,0,0,0
5542,5542,'axes are still autorange:false',0.0,0,0,0
5543,5543,'bEE',0.0,0,0,0
5544,5544,'bad',0.0,0,0,0
5545,5545,'bar lasso',0.0,0,0,0
5546,5546,'bar select',0.0,0,0,0
5547,5547,'base range',0.0,0,0,0
5548,5548,'be.enabled',0.0,0,0,0
5549,5549,'beepBoop',0.0,0,0,0
5550,5550,'black',0.0,0,0,0
5551,5551,'both trace and layout transitions under *ordering:traces first*',0.0,0,0,0
5552,5552,'both trace and layout transitions',0.0,0,0,0
5553,5553,'bottomLeft',0.0,0,0,0
5554,5554,'box lasso',0.0,0,0,0
5555,5555,'box select',0.0,0,0,0
5556,5556,'box',0.0,0,0,0
5557,5557,'bucket',0.0,0,0,0
5558,5558,'button--advanced',0.0,0,0,0
5559,5559,'button--conf-later',0.0,0,0,0
5560,5560,'button--quick-start',0.0,0,0,0
5561,5561,'button:contains(Add)',0.0,0,0,0
5562,5562,'button:contains(Complete)',0.0,0,0,0
5563,5563,'button:contains(Ok)',0.0,0,0,0
5564,5564,'button:contains(Return)',0.0,0,0,0
5565,5565,'button:contains(Update)',0.0,0,0,0
5566,5566,'cached',0.0,0,0,0
5567,5567,'callCount',0.0,0,0,0
5568,5568,'calls the onCompleted prop after the mutation is complete',0.0,0,0,0
5569,5569,'can be used interchangeably with lasso/box select',0.0,0,0,0
5570,5570,'can click to filter tasks by labels',0.0,0,0,0
5571,5571,'can create a dashboard from a Template',0.0,0,0,0
5572,5572,'can create a dashboard from empty state',0.0,0,0,0
5573,5573,'can create a telegraf config',0.0,0,0,0
5574,5574,'can delete a task',0.0,0,0,0
5575,5575,'can edit a task',0.0,0,0,0
5576,5576,'can filter aggregation functions by name from script editor mode',0.0,0,0,0
5577,5577,'can filter telegraf configs and sort by bucket and name',0.0,0,0,0
5578,5578,'can save query as task even when it has a variable',0.0,0,0,0
5579,5579,'can update a label',0.0,0,0,0
5580,5580,'can update configuration name and delete a configuration',0.0,0,0,0
5581,5581,'can use the function selector to build a query',0.0,0,0,0
5582,5582,'can view setup instructions for a config',0.0,0,0,0
5583,5583,'can view table data & sort values numerically',0.0,0,0,0
5584,5584,'can view time-series data',0.0,0,0,0
5585,5585,'candlestick',0.0,0,0,0
5586,5586,'card-select-Bashboard-Template',0.0,0,0,0
5587,5587,'cassandra',0.0,0,0,0
5588,5588,'changes the render after code change',0.0,0,0,0
5589,5589,'chips-4',0.0,0,0,0
5590,5590,'choropleth lasso',0.0,0,0,0
5591,5591,'choropleth pan',0.0,0,0,0
5592,5592,'choropleth select',0.0,0,0,0
5593,5593,'choropleth',0.0,0,0,0
5594,5594,'cleanly clears and starts selections although add/subtract mode on',0.0,0,0,0
5595,5595,'cleanup on unmount',0.0,0,0,0
5596,5596,'clears entire selection when the last selected data point',0.0,0,0,0
5597,5597,'click-me',0.0,0,0,0
5598,5598,'coke-0',0.0,0,0,0
5599,5599,'collector-card--input',0.0,0,0,0
5600,5600,'collector-card--name-button',0.0,0,0,0
5601,5601,'color-picker--input',0.0,0,0,0
5602,5602,'coloraxis',0.0,0,0,0
5603,5603,'componentDidUnmount',0.0,0,0,0
5604,5604,'componentWillMount',0.0,0,0,0
5605,5605,'condensed',0.0,0,0,0
5606,5606,'configuration',0.0,0,0,0
5607,5607,'configuration-page-heading',0.0,0,0,0
5608,5608,'considers the first arrow key press as forward navigation',0.0,0,0,0
5609,5609,'content height',0.0,0,0,0
5610,5610,'context-delete-menu',0.0,0,0,0
5611,5611,'context-delete-task',0.0,0,0,0
5612,5612,'context-menu',0.0,0,0,0
5613,5613,'context-menu-item',0.0,0,0,0
5614,5614,'contourgl',0.0,0,0,0
5615,5615,'cookie',0.0,0,0,0
5616,5616,'coords needs to be defined',0.0,0,0,0
5617,5617,'coords.x needs to be defined',0.0,0,0,0
5618,5618,'coords.y needs to be defined',0.0,0,0,0
5619,5619,'covariance',0.0,0,0,0
5620,5620,'create a message',0.0,0,0,0
5621,5621,'create a new imaging request',0.0,0,0,0
5622,5622,'create-dashboard-button',0.0,0,0,0
5623,5623,'create-label-form--description',0.0,0,0,0
5624,5624,'create-label-form--name',0.0,0,0,0
5625,5625,'create-label-form--submit',0.0,0,0,0
5626,5626,'cyan',0.0,0,0,0
5627,5627,'data-referenced annotations should update on drag',0.0,0,0,0
5628,5628,'data-table-columns',0.0,0,0,0
5629,5629,'date/category lasso',0.0,0,0,0
5630,5630,'date/category select',0.0,0,0,0
5631,5631,'datepicker',0.0,0,0,0
5632,5632,'datepicker-range',0.0,0,0,0
5633,5633,'deals correctly with histogram\'s binning in the persistent selection case',0.0,0,0,0
5634,5634,'defbuck',0.0,0,0,0
5635,5635,'deletes all backup messages and navigates to all messages',0.0,0,0,0
5636,5636,'description',0.0,0,0,0
5637,5637,'disables submit when a query is deleted',0.0,0,0,0
5638,5638,"'do not transition autoranged axes, just the traces'",0.0,0,0,0
5639,5639,"'document.querySelector(\'#myPostcards .row paper-fab[icon=""delete""]\').click()'",0.0,0,0,0
5640,5640,"'document.querySelectorAll(""#myPostcards .row:not([hidden])"").length'",0.0,0,0,0
5641,5641,'does not wrap around',0.0,0,0,0
5642,5642,'doubleclick event #',0.0,0,0,0
5643,5643,'dropdown--item From a Template',0.0,0,0,0
5644,5644,'e2871ad8f92e752a',0.0,0,0,0
5645,5645,'empty-dashboards-list',0.0,0,0,0
5646,5646,'empty-graph--no-queries',0.0,0,0,0
5647,5647,'empty-graph--no-results',0.0,0,0,0
5648,5648,'empty-tasks-list',0.0,0,0,0
5649,5649,'enables the submit button when a query is typed',0.0,0,0,0
5650,5650,'equal',0.0,0,0,0
5651,5651,'europe',0.0,0,0,0
5652,5652,'event data keys',0.0,0,0,0
5653,5653,'event',0.0,0,0,0
5654,5654,"'export default ""not-a-page""\nexport const fn = '",0.0,0,0,0
5655,5655,"'export default () => (<div id=""new-page"">the-new-page</div>)'",0.0,0,0,0
5656,5656,'export default () => /search/ \nexport const fn = ',0.0,0,0,0
5657,5657,'export',0.0,0,0,0
5658,5658,'filter',0.0,0,0,0
5659,5659,'flex',0.0,0,0,0
5660,5660,'flux-function math.abs',0.0,0,0,0
5661,5661,'flux-function math.floor',0.0,0,0,0
5662,5662,'flux-function mean',0.0,0,0,0
5663,5663,'flux-function strings.title',0.0,0,0,0
5664,5664,'flux-function strings.trim',0.0,0,0,0
5665,5665,'form[name=new-goal-form]',0.0,0,0,0
5666,5666,'form[name=visual-properties-form]',0.0,0,0,0
5667,5667,'fragment',0.0,0,0,0
5668,5668,'from center move toward bottom-right',0.0,0,0,0
5669,5669,'from center move toward top-left',0.0,0,0,0
5670,5670,'from center to not far enough',0.0,0,0,0
5671,5671,'from quadrant #1 move top-right',0.0,0,0,0
5672,5672,'from quadrant #1 to not far enough',0.0,0,0,0
5673,5673,'from right edge move left',0.0,0,0,0
5674,5674,'from right edge to not far enough',0.0,0,0,0
5675,5675,'from the Dashboard view',0.0,0,0,0
5676,5676,'from the org view',0.0,0,0,0
5677,5677,"'from(bucket: ""foo"")'",0.0,0,0,0
5678,5678,'fullData',0.0,0,0,0
5679,5679,'g.annotation-text-g',0.0,0,0,0
5680,5680,'g.hovertext',0.0,0,0,0
5681,5681,'h3',0.0,0,0,0
5682,5682,'has echo plugin',0.0,0,0,0
5683,5683,'has no message in linux app',0.0,0,0,0
5684,5684,'has one message in windows app',0.0,0,0,0
5685,5685,'have.text',0.0,0,0,0
5686,5686,'health',0.0,0,0,0
5687,5687,'health-page-heading',0.0,0,0,0
5688,5688,'heatmap',0.0,0,0,0
5689,5689,'histogram lasso',0.0,0,0,0
5690,5690,'histogram select',0.0,0,0,0
5691,5691,'histrogram',0.0,0,0,0
5692,5692,'hotpink',0.0,0,0,0
5693,5693,'hoverlabel.namelength',0.0,0,0,0
5694,5694,'http://localhost:3001/Masonry',0.0,0,0,0
5695,5695,'http://localhost:3001/Masonry?deferMount=1&manualFetch=1',0.0,0,0,0
5696,5696,'http://localhost:3001/Masonry?virtualize=1&externalCache=1',0.0,0,0,0
5697,5697,'http://localhost:3001/MasonryInfinite?virtualize=1&externalCache=1',0.0,0,0,0
5698,5698,'https://example.com',0.0,0,0,0
5699,5699,'ie',0.0,0,0,0
5700,5700,'iframe',0.0,0,0,0
5701,5701,'ignores array keys orthogonal to the direction',0.0,0,0,0
5702,5702,'ignores clicks on boxes in a box trace type',0.0,0,0,0
5703,5703,'imaging',0.0,0,0,0
5704,5704,'imports the appropriate packages to build a query',0.0,0,0,0
5705,5705,'incorrect number of plotly_relayout events triggered - ',0.0,0,0,0
5706,5706,'independent',0.0,0,0,0
5707,5707,"'initially, zoom is active'",0.0,0,0,0
5708,5708,'innerHTML',0.0,0,0,0
5709,5709,'input-field--bucketname',0.0,0,0,0
5710,5710,'input-field--orgname',0.0,0,0,0
5711,5711,'input-field--password',0.0,0,0,0
5712,5712,'input-field--password-chk',0.0,0,0,0
5713,5713,'input-field--username',0.0,0,0,0
5714,5714,'invokes optional onRenderCell prop per item render',0.0,0,0,0
5715,5715,'is clicked while add/subtract modifier keys are active',0.0,0,0,0
5716,5716,'is clicked',0.0,0,0,0
5717,5717,'is disabled when clickmode does not include \'select\'',0.0,0,0,0
5718,5718,'is supported by scattergl in pan/zoom mode',0.0,0,0,0
5719,5719,'is supported by',0.0,0,0,0
5720,5720,'is supported in pan/zoom mode',0.0,0,0,0
5721,5721,'just layout transition',0.0,0,0,0
5722,5722,'just trace transition',0.0,0,0,0
5723,5723,'keydown complete spy',0.0,0,0,0
5724,5724,'label',0.0,0,0,0
5725,5725,'left positioned tooltip is dynamically positioned right',0.0,0,0,0
5726,5726,'legendonly',0.0,0,0,0
5727,5727,'li=Visual Settings',0.0,0,0,0
5728,5728,'location',0.0,0,0,0
5729,5729,'logs',0.0,0,0,0
5730,5730,'logs-page-heading',0.0,0,0,0
5731,5731,'long Items',0.0,0,0,0
5732,5732,'marker.size',0.0,0,0,0
5733,5733,'mat-slide-toggle',0.0,0,0,0
5734,5734,'match',0.0,0,0,0
5735,5735,'mem',0.0,0,0,0
5736,5736,'metrics',0.0,0,0,0
5737,5737,'metrics-page-heading',0.0,0,0,0
5738,5738,'mock',0.0,0,0,0
5739,5739,"'must transition autoranged axes, not the traces'",0.0,0,0,0
5740,5740,'name-sorter',0.0,0,0,0
5741,5741,'new-page',0.0,0,0,0
5742,5742,'new-page.js',0.0,0,0,0
5743,5743,'next.router.isReady',0.0,0,0,0
5744,5744,'no new relayout events after *not far enough* cases',0.0,0,0,0
5745,5745,'not.contain',0.0,0,0,0
5746,5746,'not.have.class',0.0,0,0,0
5747,5747,'notification-success',0.0,0,0,0
5748,5748,'ohlc',0.0,0,0,0
5749,5749,'onInputKeyDown Enter',0.0,0,0,0
5750,5750,'onboarding/0',0.0,0,0,0
5751,5751,'onboarding/1',0.0,0,0,0
5752,5752,'onboarding/2',0.0,0,0,0
5753,5753,'org',0.0,0,0,0
5754,5754,'orgSetup',0.0,0,0,0
5755,5755,'overflow',0.0,0,0,0
5756,5756,'overlay--container',0.0,0,0,0
5757,5757,'pan2d',0.0,0,0,0
5758,5758,'passes basic a11y tests',0.0,0,0,0
5759,5759,'pink',0.0,0,0,0
5760,5760,'plotly_click',0.0,0,0,0
5761,5761,'plotly_hover',0.0,0,0,0
5762,5762,'plotly_relayout',0.0,0,0,0
5763,5763,'plotly_unhover',0.0,0,0,0
5764,5764,'pointIndices',0.0,0,0,0
5765,5765,'pointNumber',0.0,0,0,0
5766,5766,'pointcloud',0.0,0,0,0
5767,5767,'points length',0.0,0,0,0
5768,5768,'polar.radialaxis.range',0.0,0,0,0
5769,5769,'position',0.0,0,0,0
5770,5770,'provides appropriate zone options if daylight savings time',0.0,0,0,0
5771,5771,'provides appropriate zone options if standard time',0.0,0,0,0
5772,5772,'r',0.0,0,0,0
5773,5773,'raw script editing',0.0,0,0,0
5774,5774,'raw-data-table',0.0,0,0,0
5775,5775,'react-datepicker__day--today',0.0,0,0,0
5776,5776,'relayoutCallback',0.0,0,0,0
5777,5777,'resourceIDs',0.0,0,0,0
5778,5778,'retains selected points when switching between pan and zoom mode',0.0,0,0,0
5779,5779,'return',0.0,0,0,0
5780,5780,"'rgb(0, 0, 0)'",0.0,0,0,0
5781,5781,"'rgb(0, 128, 0)'",0.0,0,0,0
5782,5782,"'rgba(0,0,0,0.2)'",0.0,0,0,0
5783,5783,'right auto',0.0,0,0,0
5784,5784,'right positioned tooltip is dynamically positioned left',0.0,0,0,0
5785,5785,'routes',0.0,0,0,0
5786,5786,'rtl',0.0,0,0,0
5787,5787,'save-query-as',0.0,0,0,0
5788,5788,'scatter',0.0,0,0,0
5789,5789,'scattercarpet lasso',0.0,0,0,0
5790,5790,'scattercarpet select',0.0,0,0,0
5791,5791,'scattergeo lasso',0.0,0,0,0
5792,5792,'scattergeo pan',0.0,0,0,0
5793,5793,'scattergeo select',0.0,0,0,0
5794,5794,'scattergl after visibility restyle',0.0,0,0,0
5795,5795,'scattergl before visibility restyle',0.0,0,0,0
5796,5796,'scattergl fancy after visibility restyle',0.0,0,0,0
5797,5797,'scattergl fancy before visibility restyle',0.0,0,0,0
5798,5798,'scattergl with hoverinfo',0.0,0,0,0
5799,5799,'scattermapbox lasso',0.0,0,0,0
5800,5800,'scattermapbox pan',0.0,0,0,0
5801,5801,'scattermapbox select',0.0,0,0,0
5802,5802,'scattermapbox',0.0,0,0,0
5803,5803,'scatterpolar lasso',0.0,0,0,0
5804,5804,'scatterpolar select',0.0,0,0,0
5805,5805,'scatterternary lasso after relayout',0.0,0,0,0
5806,5806,'scatterternary lasso',0.0,0,0,0
5807,5807,'scatterternary select',0.0,0,0,0
5808,5808,'selected points length',0.0,0,0,0
5809,5809,'selected pt ',0.0,0,0,0
5810,5810,'selectedpoints array for trace ',0.0,0,0,0
5811,5811,'selectedpoints',0.0,0,0,0
5812,5812,'selector-list _monitoring',0.0,0,0,0
5813,5813,'selector-list _tasks',0.0,0,0,0
5814,5814,'selector-list defbuck',0.0,0,0,0
5815,5815,'selector-list max',0.0,0,0,0
5816,5816,'selector-list sort',0.0,0,0,0
5817,5817,'selects a single data point when being clicked',0.0,0,0,0
5818,5818,'selects day when typed',0.0,0,0,0
5819,5819,'selects range - verifies end of year',0.0,0,0,0
5820,5820,'setup-instructions-link',0.0,0,0,0
5821,5821,'short Items',0.0,0,0,0
5822,5822,'should activate the new registered user',0.0,0,0,0
5823,5823,'should adjust position of centered option if there is little space above',0.0,0,0,0
5824,5824,'should adjust position of centered option if there is little space below',0.0,0,0,0
5825,5825,'should align a centered option properly when scrolling while the panel is open',0.0,0,0,0
5826,5826,"'should align the first option to the trigger, if nothing is selected'",0.0,0,0,0
5827,5827,'should allow <input list /> to pass through as an attribute',0.0,0,0,0
5828,5828,'should allow URL query strings on index without refresh',0.0,0,0,0
5829,5829,'should allow URL query strings without refresh',0.0,0,0,0
5830,5830,'should be active with a blue background',0.0,0,0,0
5831,5831,'should be closed',0.0,0,0,0
5832,5832,'should be invoked for components on unmount',0.0,0,0,0
5833,5833,'should be invoked normally on unmount',0.0,0,0,0
5834,5834,'should be open',0.0,0,0,0
5835,5835,'should complete the keydown stream on dispose',0.0,0,0,0
5836,5836,'should correctly replace state when same asPath but different url',0.0,0,0,0
5837,5837,'should detect runtime errors on the module scope',0.0,0,0,0
5838,5838,'should detect syntax errors and recover',0.0,0,0,0
5839,5839,'should dispatch body keyboard events to the most recently attached overlay',0.0,0,0,0
5840,5840,'should dispatch targeted keyboard events to the overlay containing that target',0.0,0,0,0
5841,5841,"'should fall back to ""above"" positioning if scroll adjustment will not help'",0.0,0,0,0
5842,5842,"'should fall back to ""above"" positioning properly when scrolled'",0.0,0,0,0
5843,5843,'should filter by dom type #1',0.0,0,0,0
5844,5844,'should filter by dom type #2',0.0,0,0,0
5845,5845,'should filter by fragment type',0.0,0,0,0
5846,5846,'should filter down the list when a search is performed',0.0,0,0,0
5847,5847,'should filter on update',0.0,0,0,0
5848,5848,'should find filtered nodes',0.0,0,0,0
5849,5849,'should focus the menu panel if all items are disabled inside lazy content',0.0,0,0,0
5850,5850,'should focus the menu panel if all items are disabled',0.0,0,0,0
5851,5851,'should handle onInputKeyDown ArrowDown',0.0,0,0,0
5852,5852,'should handle onInputKeyDown ArrowLeft',0.0,0,0,0
5853,5853,'should handle onInputKeyDown ArrowRight',0.0,0,0,0
5854,5854,'should handle onInputKeyDown ArrowUp',0.0,0,0,0
5855,5855,'should handle onInputKeyDown End',0.0,0,0,0
5856,5856,'should handle onInputKeyDown Home',0.0,0,0,0
5857,5857,'should handle onInputKeyDown PageDown',0.0,0,0,0
5858,5858,'should handle onInputKeyDown PageUp',0.0,0,0,0
5859,5859,'should have contributors listed in each group',0.0,0,0,0
5860,5860,'should have installed the react-overlay-editor editor handler',0.0,0,0,0
5861,5861,'should have no results',0.0,0,0,0
5862,5862,'should keep the position within the viewport on repeat openings',0.0,0,0,0
5863,5863,'should load audits',0.0,0,0,0
5864,5864,'should load configuration',0.0,0,0,0
5865,5865,'should load health',0.0,0,0,0
5866,5866,'should load logs',0.0,0,0,0
5867,5867,'should load metrics',0.0,0,0,0
5868,5868,'should load user management',0.0,0,0,0
5869,5869,'should log animation events',0.0,0,0,0
5870,5870,'should login with admin account',0.0,0,0,0
5871,5871,'should mount after filtered update',0.0,0,0,0
5872,5872,'should not change value on click when click action is noop',0.0,0,0,0
5873,5873,'should not error when rewriting to fallback dynamic SSG page',0.0,0,0,0
5874,5874,'should not preSelect date if not between minDate and maxDate',0.0,0,0,0
5875,5875,'should not re-execute the script when re-rendering',0.0,0,0,0
5876,5876,'should not select dates excluded from filterDate',0.0,0,0,0
5877,5877,'should not select excludeDates',0.0,0,0,0
5878,5878,'should not show the default HMR error overlay',0.0,0,0,0
5879,5879,'should not update the selected date if the date input manually it has something wrong',0.0,0,0,0
5880,5880,'should of formatted build output correctly',0.0,0,0,0
5881,5881,'should only mount visible items on remount - %s',0.0,0,0,0
5882,5882,'should open the calendar when an arrow key is pressed',0.0,0,0,0
5883,5883,'should output correct event data contourgl',0.0,0,0,0
5884,5884,'should output correct event data for heatmapgl (asymmetric case) ',0.0,0,0,0
5885,5885,'should output correct event data for heatmapgl',0.0,0,0,0
5886,5886,'should output correct event data for pointcloud',0.0,0,0,0
5887,5887,'should output correct event data for scattergl after visibility restyle',0.0,0,0,0
5888,5888,'should output correct event data for scattergl in *lasso* dragmode',0.0,0,0,0
5889,5889,'should output correct event data for scattergl in *select* dragmode',0.0,0,0,0
5890,5890,'should output correct event data for scattergl with hoverinfo: \'none\'',0.0,0,0,0
5891,5891,'should output correct event data for scattergl',0.0,0,0,0
5892,5892,'should output correct event data for scattergl-fancy',0.0,0,0,0
5893,5893,'should preseve state after HMR update',0.0,0,0,0
5894,5894,'should re-render nested components',0.0,0,0,0
5895,5895,'should re-render nested functional components',0.0,0,0,0
5896,5896,'should recover after a bad return from the render function',0.0,0,0,0
5897,5897,'should recover after an error reported via SSR',0.0,0,0,0
5898,5898,'should recover after exporting an invalid page',0.0,0,0,0
5899,5899,'should recover from 404 after a page has been added',0.0,0,0,0
5900,5900,'should recover from errors in getInitialProps in client',0.0,0,0,0
5901,5901,'should recover from errors in the render function',0.0,0,0,0
5902,5902,'should remove the hero from the list when clicked',0.0,0,0,0
5903,5903,'should render with a null child',0.0,0,0,0
5904,5904,"'should render with the user, root and tooltip classes'",0.0,0,0,0
5905,5905,'should require admin for detailed info',0.0,0,0,0
5906,5906,'should reset the keyboard selection when closed',0.0,0,0,0
5907,5907,'should respond to drag interactions',0.0,0,0,0
5908,5908,'should restore the scroll position on navigating forward',0.0,0,0,0
5909,5909,'should retain the keyboard selection when already open',0.0,0,0,0
5910,5910,'should return teams paginated user list',0.0,0,0,0
5911,5911,'should set the default bucket in the dropdown to the selected bucket',0.0,0,0,0
5912,5912,'should show the error on all pages',0.0,0,0,0
5913,5913,'should sort the bucket names alphabetically',0.0,0,0,0
5914,5914,'should stop emitting events to detached overlays',0.0,0,0,0
5915,5915,'should stop emitting events to disposed overlays',0.0,0,0,0
5916,5916,'should track overlays in order as they are attached and detached',0.0,0,0,0
5917,5917,'should unmount nodes',0.0,0,0,0
5918,5918,'should update filters after 1st render with unmounts',0.0,0,0,0
5919,5919,'should update filters after 1st render',0.0,0,0,0
5920,5920,'should update the preSelection state when a day is selected with mouse click',0.0,0,0,0
5921,5921,'should update the selected date on manual input',0.0,0,0,0
5922,5922,'should update the selected date',0.0,0,0,0
5923,5923,'should work for bar traces',0.0,0,0,0
5924,5924,'should work for box traces',0.0,0,0,0
5925,5925,'should work for date/category traces',0.0,0,0,0
5926,5926,'should work for histogram traces',0.0,0,0,0
5927,5927,'should work for violin traces',0.0,0,0,0
5928,5928,'should work on choropleth traces',0.0,0,0,0
5929,5929,'should work on scattercarpet traces',0.0,0,0,0
5930,5930,'should work on scattergeo traces',0.0,0,0,0
5931,5931,'should work on scatterpolar traces',0.0,0,0,0
5932,5932,'should work on scatterternary traces',0.0,0,0,0
5933,5933,'should work on traces with enabled transforms',0.0,0,0,0
5934,5934,'shows the empty state when the query returns no results',0.0,0,0,0
5935,5935,'single-stat',0.0,0,0,0
5936,5936,'single-stat--text',0.0,0,0,0
5937,5937,'sorting & filtering',0.0,0,0,0
5938,5938,'sorts string column',0.0,0,0,0
5939,5939,'span=My Goal',0.0,0,0,0
5940,5940,'standard',0.0,0,0,0
5941,5941,'storybook-chromatic/isChromatic',0.0,0,0,0
5942,5942,'streaming',0.0,0,0,0
5943,5943,'strict mode checks',0.0,0,0,0
5944,5944,'sum',0.0,0,0,0
5945,5945,'supports 1D and 2D Zoom',0.0,0,0,0
5946,5946,'supports adding to an existing selection',0.0,0,0,0
5947,5947,'supports axis constraints with zoom',0.0,0,0,0
5948,5948,'supports subtracting from an existing selection',0.0,0,0,0
5949,5949,'switch-to-script-editor',0.0,0,0,0
5950,5950,'switched on dragmode',0.0,0,0,0
5951,5951,'table-row',0.0,0,0,0
5952,5952,'task--radio-button',0.0,0,0,0
5953,5953,'task-card--name',0.0,0,0,0
5954,5954,'task-card--name-button',0.0,0,0,0
5955,5955,'task-form-name',0.0,0,0,0
5956,5956,'task-form-save',0.0,0,0,0
5957,5957,'task-form-schedule-input',0.0,0,0,0
5958,5958,'tax',0.0,0,0,0
5959,5959,'telegraf-plugins--System',0.0,0,0,0
5960,5960,'template--Bashboard-Template',0.0,0,0,0
5961,5961,'template-panel',0.0,0,0,0
5962,5962,'test plugin',0.0,0,0,0
5963,5963,'testing image export formats',0.0,0,0,0
5964,5964,'text',0.0,0,0,0
5965,5965,'textarea',0.0,0,0,0
5966,5966,'theta',0.0,0,0,0
5967,5967,'thrillbo-swaggins',0.0,0,0,0
5968,5968,"'throw new Error(""an-expected-error"");\nreturn'",0.0,0,0,0
5969,5969,'timeout passed',0.0,0,0,0
5970,5970,'title.text',0.0,0,0,0
5971,5971,'toolbar-function',0.0,0,0,0
5972,5972,'toolbar-tab',0.0,0,0,0
5973,5973,"'tooltips should be placed dynamically, with the dynamic placement option'",0.0,0,0,0
5974,5974,'top positioned tooltip is dynamically positioned bottom',0.0,0,0,0
5975,5975,'topLeft',0.0,0,0,0
5976,5976,'touchend',0.0,0,0,0
5977,5977,'touchmove',0.0,0,0,0
5978,5978,'tra',0.0,0,0,0
5979,5979,'trace 0',0.0,0,0,0
5980,5980,'trace type ',0.0,0,0,0
5981,5981,'transformed trace select (all points selected)',0.0,0,0,0
5982,5982,"'transition just traces, as now axis ranges are set'",0.0,0,0,0
5983,5983,'trigger-mount',0.0,0,0,0
5984,5984,"'ul[role=""listbox""] li'",0.0,0,0,0
5985,5985,'unclickable',0.0,0,0,0
5986,5986,'updating',0.0,0,0,0
5987,5987,'user-management',0.0,0,0,0
5988,5988,'user-management-page-heading',0.0,0,0,0
5989,5989,'user_test',0.0,0,0,0
5990,5990,"'various aligns, portals, items and scrolls'",0.0,0,0,0
5991,5991,'violin lasso',0.0,0,0,0
5992,5992,'violin select',0.0,0,0,0
5993,5993,'violin',0.0,0,0,0
5994,5994,'visual snapshot tests',0.0,0,0,0
5995,5995,'visualize tables',0.0,0,0,0
5996,5996,'visualize with 360 lines',0.0,0,0,0
5997,5997,'waiting',0.0,0,0,0
5998,5998,'webpack-hot-middleware-clientOverlay',0.0,0,0,0
5999,5999,'webview context:',0.0,0,0,0
6000,6000,'when a config already exists',0.0,0,0,0
6001,6001,'when being dragged to expand the y-axis',0.0,0,0,0
6002,6002,'width',0.0,0,0,0
6003,6003,"'window.itdidnotrefresh = ""hello""'",0.0,0,0,0
6004,6004,'window.itdidnotrefresh',0.0,0,0,0
6005,6005,'window.location.search',0.0,0,0,0
6006,6006,'woofTooltip',0.0,0,0,0
6007,6007,'works in a multi-trace plot',0.0,0,0,0
6008,6008,'x2',0.0,0,0,0
6009,6009,'x: 0',0.0,0,0,0
6010,6010,'xaxis',0.0,0,0,0
6011,6011,'xaxis.range[0]',0.0,0,0,0
6012,6012,'xaxis.range[1]',0.0,0,0,0
6013,6013,'xaxis.title.text',0.0,0,0,0
6014,6014,'y-axis is autorange:true by default',0.0,0,0,0
6015,6015,'y-axis is now autorange:false',0.0,0,0,0
6016,6016,'y-axis is still autorange:true',0.0,0,0,0
6017,6017,'y2',0.0,0,0,0
6018,6018,'y: 0',0.0,0,0,0
6019,6019,'y[0]',0.0,0,0,0
6020,6020,'yaxis',0.0,0,0,0
6021,6021,'yaxis.autorange',0.0,0,0,0
6022,6022,'yaxis.range[0]',0.0,0,0,0
6023,6023,'yaxis.range[1]',0.0,0,0,0
6024,6024,'yaxis.scaleanchor',0.0,0,0,0
6025,6025,'yaxis.scaleratio',0.0,0,0,0
6026,6026,'yaxis.title.text',0.0,0,0,0
6027,6027,'yo',0.0,0,0,0
6028,6028,'z',0.0,0,0,0
6029,6029,'z: 0',0.0,0,0,0
6030,6030,'{backspace}',0.0,0,0,0
6031,6031,'{enter}',0.0,0,0,0
6032,6032,'{selectall} {backspace}',0.0,0,0,0
6033,6033,/Objects are not valid as a React child/,0.0,0,0,0
6034,6034,/The default export is not a React Component/,0.0,0,0,0
6035,6035,/This is the contact page/,0.0,0,0,0
6036,6036,/\+2 more paths/,0.0,0,0,0
6037,6037,/aa is not defined/,0.0,0,0,0
6038,6038,/an-expected-error/,0.0,0,0,0
6039,6039,/orgs\/.*\/buckets/,0.0,0,0,0
6040,6040,"/style=""cursor: pointer;""/",0.0,0,0,0
6041,6041,/the-new-page/,0.0,0,0,0
6042,6042,/○ \/normal/,0.0,0,0,0
6043,6043,/● \/blog\/\[post\]/,0.0,0,0,0
6044,6044,0.036,0.0,0,0,0
6045,6045,0.059,0.0,0,0,0
6046,6046,0.1,0.0,0,0,0
6047,6047,0.12,0.0,0,0,0
6048,6048,0.145,0.0,0,0,0
6049,6049,0.146,0.0,0,0,0
6050,6050,0.149,0.0,0,0,0
6051,6051,0.192,0.0,0,0,0
6052,6052,0.235,0.0,0,0,0
6053,6053,0.24,0.0,0,0,0
6054,6054,0.258,0.0,0,0,0
6055,6055,0.275,0.0,0,0,0
6056,6056,0.3037383177570093,0.0,0,0,0
6057,6057,0.309,0.0,0,0,0
6058,6058,0.31,0.0,0,0,0
6059,6059,0.327,0.0,0,0,0
6060,6060,0.37,0.0,0,0,0
6061,6061,0.409,0.0,0,0,0
6062,6062,0.41,0.0,0,0,0
6063,6063,1.01,0.0,0,0,0
6064,6064,1.125,0.0,0,0,0
6065,6065,1.25,0.0,0,0,0
6066,6066,1.7,0.0,0,0,0
6067,6067,106,0.0,0,0,0
6068,6068,116,0.0,0,0,0
6069,6069,12.90,0.0,0,0,0
6070,6070,134,0.0,0,0,0
6071,6071,1400,0.0,0,0,0
6072,6072,15.8,0.0,0,0,0
6073,6073,16.1,0.0,0,0,0
6074,6074,160,0.0,0,0,0
6075,6075,162,0.0,0,0,0
6076,6076,163,0.0,0,0,0
6077,6077,165,0.0,0,0,0
6078,6078,166,0.0,0,0,0
6079,6079,183,0.0,0,0,0
6080,6080,187,0.0,0,0,0
6081,6081,195,0.0,0,0,0
6082,6082,198,0.0,0,0,0
6083,6083,2.25,0.0,0,0,0
6084,6084,2.5,0.0,0,0,0
6085,6085,21.99,0.0,0,0,0
6086,6086,23.6,0.0,0,0,0
6087,6087,239,0.0,0,0,0
6088,6088,24.2,0.0,0,0,0
6089,6089,245,0.0,0,0,0
6090,6090,25,0.0,0,0,0
6091,6091,25.98,0.0,0,0,0
6092,6092,256,0.0,0,0,0
6093,6093,259200,0.0,0,0,0
6094,6094,262,0.0,0,0,0
6095,6095,270,0.0,0,0,0
6096,6096,277,0.0,0,0,0
6097,6097,290,0.0,0,0,0
6098,6098,3.1,0.0,0,0,0
6099,6099,3.5,0.0,0,0,0
6100,6100,3000,0.0,0,0,0
6101,6101,301,0.0,0,0,0
6102,6102,312,0.0,0,0,0
6103,6103,324,0.0,0,0,0
6104,6104,329,0.0,0,0,0
6105,6105,331,0.0,0,0,0
6106,6106,34.55,0.0,0,0,0
6107,6107,340,0.0,0,0,0
6108,6108,341,0.0,0,0,0
6109,6109,347,0.0,0,0,0
6110,6110,351,0.0,0,0,0
6111,6111,355,0.0,0,0,0
6112,6112,360,0.0,0,0,0
6113,6113,369,0.0,0,0,0
6114,6114,38.14,0.0,0,0,0
6115,6115,4.5,0.0,0,0,0
6116,6116,4.95,0.0,0,0,0
6117,6117,426,0.0,0,0,0
6118,6118,440,0.0,0,0,0
6119,6119,470,0.0,0,0,0
6120,6120,48,0.0,0,0,0
6121,6121,5.22,0.0,0,0,0
6122,6122,5.303738317757009,0.0,0,0,0
6123,6123,5.50,0.0,0,0,0
6124,6124,5.7,0.0,0,0,0
6125,6125,50.64,0.0,0,0,0
6126,6126,5000,0.0,0,0,0
6127,6127,51.70,0.0,0,0,0
6128,6128,56.24,0.0,0,0,0
6129,6129,565,0.0,0,0,0
6130,6130,6.1,0.0,0,0,0
6131,6131,604800,0.0,0,0,0
6132,6132,65.25,0.0,0,0,0
6133,6133,669,0.0,0,0,0
6134,6134,67,0.0,0,0,0
6135,6135,68,0.0,0,0,0
6136,6136,680,0.0,0,0,0
6137,6137,685,0.0,0,0,0
6138,6138,69,0.0,0,0,0
6139,6139,7.0,0.0,0,0,0
6140,6140,7.6,0.0,0,0,0
6141,6141,70,0.0,0,0,0
6142,6142,71,0.0,0,0,0
6143,6143,72,0.0,0,0,0
6144,6144,73,0.0,0,0,0
6145,6145,74,0.0,0,0,0
6146,6146,8.2,0.0,0,0,0
6147,6147,8.4,0.0,0,0,0
6148,6148,870,0.0,0,0,0
6149,6149,BACKDROP_SELECTOR,0.0,0,0,0
6150,6150,BROWSER,0.0,0,0,0
6151,6151,Bucket,0.0,0,0,0
6152,6152,Classes,0.0,0,0,0
6153,6153,CustomEvent,0.0,0,0,0
6154,6154,DBLCLICKDELAY,0.0,0,0,0
6155,6155,Drawing,0.0,0,0,0
6156,6156,ElementFinder,0.0,0,0,0
6157,6157,Existing Title,0.0,0,0,0
6158,6158,FakeIcon,0.0,0,0,0
6159,6159,FormMonkey,0.0,0,0,0
6160,6160,FriendStatus,0.0,0,0,0
6161,6161,GQLResolver,0.0,0,0,0
6162,6162,HAMMER_GESTURE_CONFIG,0.0,0,0,0
6163,6163,HTMLTextAreaElement,0.0,0,0,0
6164,6164,Hello World,0.0,0,0,0
6165,6165,ID,0.0,0,0,0
6166,6166,IPage,0.0,0,0,0
6167,6167,MAPBOX_ACCESS_TOKEN,0.0,0,0,0
6168,6168,MATH_FLOOR,0.0,0,0,0
6169,6169,MAT_SLIDE_TOGGLE_DEFAULT_OPTIONS,0.0,0,0,0
6170,6170,MEAN,0.0,0,0,0
6171,6171,MatSlideToggleModule,0.0,0,0,0
6172,6172,Mobile,0.0,0,0,0
6173,6173,MochaDone,0.0,0,0,0
6174,6174,MockPage,0.0,0,0,0
6175,6175,Name,0.0,0,0,0
6176,6176,OVERLAY_CONTENT,0.0,0,0,0
6177,6177,OverlayModule,0.0,0,0,0
6178,6178,Platform,0.0,0,0,0
6179,6179,SELECT_PATH,0.0,0,0,0
6180,6180,STRINGS_TRIM,0.0,0,0,0
6181,6181,SignInPage,0.0,0,0,0
6182,6182,SimpleMenuWithRepeater,0.0,0,0,0
6183,6183,SimpleMenuWithRepeaterInLazyContent,0.0,0,0,0
6184,6184,SimulateAsync,0.0,0,0,0
6185,6185,SinonStub,0.0,0,0,0
6186,6186,TABLE_ROOT,0.0,0,0,0
6187,6187,TEST_CONTAINER,0.0,0,0,0
6188,6188,TRIDENT,0.0,0,0,0
6189,6189,TestComponentModule,0.0,0,0,0
6190,6190,TestGestureConfig,0.0,0,0,0
6191,6191,TestUser,0.0,0,0,0
6192,6192,Token,0.0,0,0,0
6193,6193,Type,0.0,0,0,0
6194,6194,VIEWPORT_WIDTH,0.0,0,0,0
6195,6195,VIS_TYPES,0.0,0,0,0
6196,6196,WheelEvent,0.0,0,0,0
6197,6197,Wrap,0.0,0,0,0
6198,6198,__runCosmosLoader,0.0,0,0,0
6199,6199,_doubleClick,0.0,0,0,0
6200,6200,_modeBar,0.0,0,0,0
6201,6201,_plot,0.0,0,0,0
6202,6202,_transformOrigin,0.0,0,0,0
6203,6203,"`
        import""${",0.0,0,0,0
6204,6204,`)`,0.0,0,0,0
6205,6205,`.${,0.0,0,0,0
6206,6206,`/`,0.0,0,0,0
6207,6207,`/page-2/`,0.0,0,0,0
6208,6208,`/some-rewrite/${,0.0,0,0,0
6209,6209,`Expected panel animation to originate at the bottom.`,0.0,0,0,0
6210,6210,`Expected panel not to be scrolled.`,0.0,0,0,0
6211,6211,`Expected panel to adjust scroll position to fit in viewport.`,0.0,0,0,0
6212,6212,`Expected select panel continue being inside the viewport.`,0.0,0,0,0
6213,6213,`Expected select panel to be inside the viewport.`,0.0,0,0,0
6214,6214,`Expected trigger bottom to align with overlay bottom.`,0.0,0,0,0
6215,6215,`Focus router wrapper after navigation to regular page (from index)`,0.0,0,0,0
6216,6216,`Post: post-${,0.0,0,0,0
6217,6217,`bottom`,0.0,0,0,0
6218,6218,`dark`,0.0,0,0,0
6219,6219,`desktop`,0.0,0,0,0
6220,6220,`focused action after ${,0.0,0,0,0
6221,6221,`focused action initial ${,0.0,0,0,0
6222,6222,"`from(bucket: ""defbuck"")
  |> range(start: -10s)
  |> filter(fn: (r) => r._measurement == ""no exist"")`",0.0,0,0,0
6223,6223,"`from(bucket: ""defbuck"")
  |> range(start: -15m, stop: now())
  |> filter(fn: (r) => r._measurement == `",0.0,0,0,0
6224,6224,`http://localhost:3001/Masonry?virtualize=1&scrollContainer=1&virtualBoundsTop=300&virtualBoundsBottom=300&offsetTop=${,0.0,0,0,0
6225,6225,`label--pill ${,0.0,0,0,0
6226,6226,`mobile`,0.0,0,0,0
6227,6227,`onRouteUpdate`,0.0,0,0,0
6228,6228,`storybook-layout`,0.0,0,0,0
6229,6229,`task-card`,0.0,0,0,0
6230,6230,`view-type--${,0.0,0,0,0
6231,6231,`view-type--table`,0.0,0,0,0
6232,6232,`vis-graphic--${,0.0,0,0,0
6233,6233,`window.next.router.push('/1')`,0.0,0,0,0
6234,6234,`window.next.router.push('/2')`,0.0,0,0,0
6235,6235,abs,0.0,0,0,0
6236,6236,addParameters,0.0,0,0,0
6237,6237,addSource,0.0,0,0,0
6238,6238,addSpies,0.0,0,0,0
6239,6239,addWeeks,0.0,0,0,0
6240,6240,adminMenu,0.0,0,0,0
6241,6241,afterEach,0.0,0,0,0
6242,6242,aggregations,0.0,0,0,0
6243,6243,alignItems,0.0,0,0,0
6244,6244,altKey,0.0,0,0,0
6245,6245,analyzeAccessibility,0.0,0,0,0
6246,6246,annotations,0.0,0,0,0
6247,6247,arrayContaining,0.0,0,0,0
6248,6248,asdf,0.0,0,0,0
6249,6249,assertHoverLabelContent,0.0,0,0,0
6250,6250,assertHoverLabelStyle,0.0,0,0,0
6251,6251,assertSelectionNodes,0.0,0,0,0
6252,6252,assertShapeFullyVisible,0.0,0,0,0
6253,6253,assertions,0.0,0,0,0
6254,6254,at,0.0,0,0,0
6255,6255,authenticateUser,0.0,0,0,0
6256,6256,autoSignOut,0.0,0,0,0
6257,6257,backPlayers,0.0,0,0,0
6258,6258,backTeams,0.0,0,0,0
6259,6259,background,0.0,0,0,0
6260,6260,backupServerToken,0.0,0,0,0
6261,6261,beforeAll,0.0,0,0,0
6262,6262,boxpoints,0.0,0,0,0
6263,6263,calendar,0.0,0,0,0
6264,6264,calledBefore,0.0,0,0,0
6265,6265,calledThrice,0.0,0,0,0
6266,6266,calledTwice,0.0,0,0,0
6267,6267,canOutsideClickClose,0.0,0,0,0
6268,6268,cancelable,0.0,0,0,0
6269,6269,change,0.0,0,0,0
6270,6270,changeFocus,0.0,0,0,0
6271,6271,checkTriggerAlignedWithOption,0.0,0,0,0
6272,6272,cleanPlot,0.0,0,0,0
6273,6273,clip,0.0,0,0,0
6274,6274,configureTestingModule,0.0,0,0,0
6275,6275,contentSize,0.0,0,0,0
6276,6276,contentWindow,0.0,0,0,0
6277,6277,continue,0.0,0,0,0
6278,6278,control,0.0,0,0,0
6279,6279,createCDPSession,0.0,0,0,0
6280,6280,createCell,0.0,0,0,0
6281,6281,createComponent,0.0,0,0,0
6282,6282,createDashboard,0.0,0,0,0
6283,6283,createDashboardTemplate,0.0,0,0,0
6284,6284,createFormComponent,0.0,0,0,0
6285,6285,createGraphDiv,0.0,0,0,0
6286,6286,createLabel,0.0,0,0,0
6287,6287,createMessage,0.0,0,0,0
6288,6288,createOverlayContents,0.0,0,0,0
6289,6289,createResolversStub,0.0,0,0,0
6290,6290,createTestRenderer,0.0,0,0,0
6291,6291,createView,0.0,0,0,0
6292,6292,currentURL,0.0,0,0,0
6293,6293,customSnapshotIdentifier,0.0,0,0,0
6294,6294,dark,0.0,0,0,0
6295,6295,declarations,0.0,0,0,0
6296,6296,defaultPrevented,0.0,0,0,0
6297,6297,defaultProps,0.0,0,0,0
6298,6298,destroyGraphDiv,0.0,0,0,0
6299,6299,detach,0.0,0,0,0
6300,6300,disableToggleValue,0.0,0,0,0
6301,6301,disabled,0.0,0,0,0
6302,6302,doubleClick,0.0,0,0,0
6303,6303,dpos,0.0,0,0,0
6304,6304,editable,0.0,0,0,0
6305,6305,ends_at,0.0,0,0,0
6306,6306,enterLeave,0.0,0,0,0
6307,6307,eventually,0.0,0,0,0
6308,6308,excludeDates,0.0,0,0,0
6309,6309,executeJS,0.0,0,0,0
6310,6310,executeScript,0.0,0,0,0
6311,6311,expectAndFail,0.0,0,0,0
6312,6312,expectMessages,0.0,0,0,0
6313,6313,fakeAsync,0.0,0,0,0
6314,6314,family,0.0,0,0,0
6315,6315,fillParent,0.0,0,0,0
6316,6316,filterDate,0.0,0,0,0
6317,6317,findDOMNode,0.0,0,0,0
6318,6318,findRenderedDOMComponentWithClass,0.0,0,0,0
6319,6319,findVNodeIdForDom,0.0,0,0,0
6320,6320,fireImmediately,0.0,0,0,0
6321,6321,firstChild,0.0,0,0,0
6322,6322,flakeyIt,0.0,0,0,0
6323,6323,geo,0.0,0,0,0
6324,6324,gestureConfig,0.0,0,0,0
6325,6325,getActionButton,0.0,0,0,0
6326,6326,getAllScenarioNames,0.0,0,0,0
6327,6327,getByLabelText,0.0,0,0,0
6328,6328,getByType,0.0,0,0,0
6329,6329,getCBNode,0.0,0,0,0
6330,6330,getDate,0.0,0,0,0
6331,6331,getDialButton,0.0,0,0,0
6332,6332,getFormInput,0.0,0,0,0
6333,6333,getHeroesList,0.0,0,0,0
6334,6334,getJwtToken,0.0,0,0,0
6335,6335,getLoggingCheckbox,0.0,0,0,0
6336,6336,getModifiedDateSortButton,0.0,0,0,0
6337,6337,getPopperChildren,0.0,0,0,0
6338,6338,getSignInPage,0.0,0,0,0
6339,6339,getSnapshotConfig,0.0,0,0,0
6340,6340,getSortedBucketNames,0.0,0,0,0
6341,6341,getTranslate,0.0,0,0,0
6342,6342,getUserDeactivatedButtonByLogin,0.0,0,0,0
6343,6343,getWebElement,0.0,0,0,0
6344,6344,goal_amount,0.0,0,0,0
6345,6345,goto,0.0,0,0,0
6346,6346,gotoPlayersTab,0.0,0,0,0
6347,6347,gotoTeamsTab,0.0,0,0,0
6348,6348,grid,0.0,0,0,0
6349,6349,groupFixture,0.0,0,0,0
6350,6350,groups,0.0,0,0,0
6351,6351,hasElementById,0.0,0,0,0
6352,6352,hiddenToken,0.0,0,0,0
6353,6353,ignoreElements,0.0,0,0,0
6354,6354,imports,0.0,0,0,0
6355,6355,indexOf,0.0,0,0,0
6356,6356,innerHeight,0.0,0,0,0
6357,6357,insertNullItems,0.0,0,0,0
6358,6358,interactions,0.0,0,0,0
6359,6359,is-alt,0.0,0,0,0
6360,6360,isContextLost,0.0,0,0,0
6361,6361,isExisting,0.0,0,0,0
6362,6362,isHidden,0.0,0,0,0
6363,6363,isTrue,0.0,0,0,0
6364,6364,itIf,0.0,0,0,0
6365,6365,justifyContent,0.0,0,0,0
6366,6366,l,0.0,0,0,0
6367,6367,line,0.0,0,0,0
6368,6368,lineHeight,0.0,0,0,0
6369,6369,lines,0.0,0,0,0
6370,6370,loadedPlayersList,0.0,0,0,0
6371,6371,loadedTeamList,0.0,0,0,0
6372,6372,local,0.0,0,0,0
6373,6373,locations,0.0,0,0,0
6374,6374,logIn,0.0,0,0,0
6375,6375,logging,0.0,0,0,0
6376,6376,login,0.0,0,0,0
6377,6377,loginButton,0.0,0,0,0
6378,6378,loginPageTitle,0.0,0,0,0
6379,6379,loginWithOAuth,0.0,0,0,0
6380,6380,long,0.0,0,0,0
6381,6381,manage,0.0,0,0,0
6382,6382,manual_goal_amount,0.0,0,0,0
6383,6383,mapboxAccessToken,0.0,0,0,0
6384,6384,margin,0.0,0,0,0
6385,6385,marginTop,0.0,0,0,0
6386,6386,max,0.0,0,0,0
6387,6387,maxDate,0.0,0,0,0
6388,6388,menu,0.0,0,0,0
6389,6389,min,0.0,0,0,0
6390,6390,minDate,0.0,0,0,0
6391,6391,minHeight,0.0,0,0,0
6392,6392,minWidth,0.0,0,0,0
6393,6393,mock2,0.0,0,0,0
6394,6394,monthsShown,0.0,0,0,0
6395,6395,most,0.0,0,0,0
6396,6396,multipleScatter3dMock,0.0,0,0,0
6397,6397,navigateAndWaitForRouteChange,0.0,0,0,0
6398,6398,newPlot,0.0,0,0,0
6399,6399,ngOnDestroy,0.0,0,0,0
6400,6400,notStrictEqual,0.0,0,0,0
6401,6401,nums,0.0,0,0,0
6402,6402,onCompleted,0.0,0,0,0
6403,6403,onPagesUpdated,0.0,0,0,0
6404,6404,onRenderCell,0.0,0,0,0
6405,6405,onSelect,0.0,0,0,0
6406,6406,onSubmit,0.0,0,0,0
6407,6407,openCloseHref,0.0,0,0,0
6408,6408,openMenu,0.0,0,0,0
6409,6409,operation,0.0,0,0,0
6410,6410,overflow,0.0,0,0,0
6411,6411,overlayContainerElement,0.0,0,0,0
6412,6412,parseInt,0.0,0,0,0
6413,6413,pattern,0.0,0,0,0
6414,6414,plan,0.0,0,0,0
6415,6415,playerOne,0.0,0,0,0
6416,6416,plotly_doubleclick,0.0,0,0,0
6417,6417,polar,0.0,0,0,0
6418,6418,propTypes,0.0,0,0,0
6419,6419,providers,0.0,0,0,0
6420,6420,ptData,0.0,0,0,0
6421,6421,pureMerge,0.0,0,0,0
6422,6422,purge,0.0,0,0,0
6423,6423,quit,0.0,0,0,0
6424,6424,radialaxis,0.0,0,0,0
6425,6425,random,0.0,0,0,0
6426,6426,reaction,0.0,0,0,0
6427,6427,removeChild,0.0,0,0,0
6428,6428,renderStory,0.0,0,0,0
6429,6429,repeat,0.0,0,0,0
6430,6430,resetDialToOpen,0.0,0,0,0
6431,6431,resetEvents,0.0,0,0,0
6432,6432,resetGlobalState,0.0,0,0,0
6433,6433,resetTestingModule,0.0,0,0,0
6434,6434,responseBody,0.0,0,0,0
6435,6435,responsive,0.0,0,0,0
6436,6436,retries,0.0,0,0,0
6437,6437,runWithPouchDump,0.0,0,0,0
6438,6438,scope,0.0,0,0,0
6439,6439,screenshot,0.0,0,0,0
6440,6440,scrollLeft,0.0,0,0,0
6441,6441,scrollTop,0.0,0,0,0
6442,6442,scrollWidth,0.0,0,0,0
6443,6443,scrolledSubject,0.0,0,0,0
6444,6444,secondCall,0.0,0,0,0
6445,6445,seed,0.0,0,0,0
6446,6446,selectButton,0.0,0,0,0
6447,6447,selectedPanel,0.0,0,0,0
6448,6448,selectedPromise,0.0,0,0,0
6449,6449,setAsyncScriptTimeout,0.0,0,0,0
6450,6450,setImplicitWaitTimeout,0.0,0,0,0
6451,6451,setInterval,0.0,0,0,0
6452,6452,setPassword,0.0,0,0,0
6453,6453,setProps,0.0,0,0,0
6454,6454,setState,0.0,0,0,0
6455,6455,setTolerance,0.0,0,0,0
6456,6456,setUserName,0.0,0,0,0
6457,6457,setValue,0.0,0,0,0
6458,6458,setViewport,0.0,0,0,0
6459,6459,shouldCloseOnSelect,0.0,0,0,0
6460,6460,showscale,0.0,0,0,0
6461,6461,signin,0.0,0,0,0
6462,6462,sleep,0.0,0,0,0
6463,6463,sleepFor,0.0,0,0,0
6464,6464,splashscreen,0.0,0,0,0
6465,6465,startingWindowHeight,0.0,0,0,0
6466,6466,staticItem,0.0,0,0,0
6467,6467,stories,0.0,0,0,0
6468,6468,storiesOf,0.0,0,0,0
6469,6469,styled,0.0,0,0,0
6470,6470,support,0.0,0,0,0
6471,6471,switchContextToWebview,0.0,0,0,0
6472,6472,teamOne,0.0,0,0,0
6473,6473,test,0.0,0,0,0
6474,6474,testPlayerNavigated,0.0,0,0,0
6475,6475,testResponsive,0.0,0,0,0
6476,6476,testTeamNavigated,0.0,0,0,0
6477,6477,thirdCall,0.0,0,0,0
6478,6478,throws,0.0,0,0,0
6479,6479,tick,0.0,0,0,0
6480,6480,timeout,0.0,0,0,0
6481,6481,toBeLessThanOrEqual,0.0,0,0,0
6482,6482,toHaveNoAccessibilityIssues,0.0,0,0,0
6483,6483,toMatchImageSnapshot,0.0,0,0,0
6484,6484,toggleMount,0.0,0,0,0
6485,6485,togglePosition,0.0,0,0,0
6486,6486,toggleVisibility,0.0,0,0,0
6487,6487,transforms,0.0,0,0,0
6488,6488,uiSchema,0.0,0,0,0
6489,6489,unmount,0.0,0,0,0
6490,6490,useFactory,0.0,0,0,0
6491,6491,useState,0.0,0,0,0
6492,6492,useValue,0.0,0,0,0
6493,6493,username,0.0,0,0,0
6494,6494,waitForAPIorTimeout,0.0,0,0,0
6495,6495,waitForCount,0.0,0,0,0
6496,6496,waitForExists,0.0,0,0,0
6497,6497,waitUntilHidden,0.0,0,0,0
6498,6498,windowsServerToken,0.0,0,0,0
6499,6499,withKnobs,0.0,0,0,0
6500,6500,withRoot,0.0,0,0,0
6501,6501,writeData,0.0,0,0,0
6502,6502,xit,0.0,0,0,0
6503,6503,yaxis2,0.0,0,0,0
6504,6504,ysizemode,0.0,0,0,0
6505,6505,} Harder${,0.0,0,0,0
6506,6506,} change settings`,0.0,0,0,0
6507,6507,} create and delete`,0.0,0,0,0
6508,6508,"}""
        ${",0.0,0,0,0
6509,6509,"}""
        import""${",0.0,0,0,0
6510,6510,}${,0.0,0,0,0
6511,6511,}/?query=true`,0.0,0,0,0
6512,6512,}/`,0.0,0,0,0
6513,6513,}/dashboards`,0.0,0,0,0
6514,6514,}/hello/?query=true`,0.0,0,0,0
6515,6515,}/hello/`,0.0,0,0,0
6516,6516,}/load-data/telegrafs`,0.0,0,0,0
6517,6517,}/settings/labels`,0.0,0,0,0
6518,6518,}/tasks`,0.0,0,0,0
6519,6519,"
				A Section
			",0.0,0,0,0
6520,6520,"
				Pizza
			",0.0,0,0,0
6521,6521,"
			Foo
		",0.0,0,0,0
6522,6522,"
			Pizza
		",0.0,0,0,0
6523,6523,"
			butterbrot
		",0.0,0,0,0
6524,6524,"
			pizza
		",0.0,0,0,0
6525,6525, + ,0.0,0,0,0
6526,6526,"""!""",0.0,0,0,0
6527,6527,"""#2159 - computed property keys""",0.0,0,0,0
6528,6528,"""#2309 don't trigger oBO for computeds that aren't subscribed to""",0.0,0,0,0
6529,6529,"""#2457""",0.0,0,0,0
6530,6530,"""#2667""",0.0,0,0,0
6531,6531,"""#2686 - 2""",0.0,0,0,0
6532,6532,"""#2686 - 3""",0.0,0,0,0
6533,6533,"""$""",0.0,0,0,0
6534,6534,"""'foo'""",0.0,0,0,0
6535,6535,"""-""",0.0,0,0,0
6536,6536,"""--keepAliveTimeout doesn't change server.keepAliveTimeout when not passed""",0.0,0,0,0
6537,6537,"""-1""",0.0,0,0,0
6538,6538,"""../src/utils/assertEnvironment.ts""",0.0,0,0,0
6539,6539,"""/foo""",0.0,0,0,0
6540,6540,"""/section""",0.0,0,0,0
6541,6541,"""1072 - @observable without initial value and observe before first access""",0.0,0,0,0
6542,6542,"""1850""",0.0,0,0,0
6543,6543,"""192x192""",0.0,0,0,0
6544,6544,"""267 (typescript) should be possible to declare properties observable outside strict mode""",0.0,0,0,0
6545,6545,"""288 atom not detected for object property""",0.0,0,0,0
6546,6546,"""373 - fix isObservable for unused computed""",0.0,0,0,0
6547,6547,"""379, inheritable actions (typescript)""",0.0,0,0,0
6548,6548,"""505, don't throw when accessing subclass fields in super constructor (typescript)""",0.0,0,0,0
6549,6549,"""705 - setter undoing caching (typescript)""",0.0,0,0,0
6550,6550,"""<span /><span />""",0.0,0,0,0
6551,6551,"""@computed.equals (TS)""",0.0,0,0,0
6552,6552,"""@observable.deep (TS)""",0.0,0,0,0
6553,6553,"""@observable.ref (TS)""",0.0,0,0,0
6554,6554,"""@observable.shallow (TS)""",0.0,0,0,0
6555,6555,"""@observable.shallow - 2 (TS)""",0.0,0,0,0
6556,6556,"""@override must override""",0.0,0,0,0
6557,6557,"""@override""",0.0,0,0,0
6558,6558,"""A %s using nested titleTemplate attributes""",0.0,0,0,0
6559,6559,"""A Second Test using nested titleTemplate attributes""",0.0,0,0,0
6560,6560,"""Can't resolve './does-not-exist.woff2'""",0.0,0,0,0
6561,6561,"""Cannot use import statement outside a module""",0.0,0,0,0
6562,6562,"""Child Two Title""",0.0,0,0,0
6563,6563,"""Computing isMatchWrong""",0.0,0,0,0
6564,6564,"""Computing isSelected for card""",0.0,0,0,0
6565,6565,"""Computing isWrong for card """,0.0,0,0,0
6566,6566,"""Current result: """,0.0,0,0,0
6567,6567,"""Current result: 1$""",0.0,0,0,0
6568,6568,"""Current result: 2$""",0.0,0,0,0
6569,6569,"""Current result: 3$""",0.0,0,0,0
6570,6570,"""Current result: loading""",0.0,0,0,0
6571,6571,"""Dangerous <script> include""",0.0,0,0,0
6572,6572,"""DebugName""",0.0,0,0,0
6573,6573,"""Deeper Title""",0.0,0,0,0
6574,6574,"""Doe""",0.0,0,0,0
6575,6575,"""Don't ignore event with different locale""",0.0,0,0,0
6576,6576,"""Extending builtins is not support #2765""",0.0,0,0,0
6577,6577,"""I'm still a valid page""",0.0,0,0,0
6578,6578,"""Invalid href '/hello//world' passed to next/router in page: '/my/path/[name]'. Repeated forward-slashes (//) or backslashes \\ are not valid in the href.""",0.0,0,0,0
6579,6579,"""Invalid prop `testProp` of type `array` supplied to """,0.0,0,0,0
6580,6580,"""Invalid prop `testProp` of type `date` supplied to """,0.0,0,0,0
6581,6581,"""Invalid prop `testProp` of type `number` supplied to """,0.0,0,0,0
6582,6582,"""Invalid prop `testProp` of type `object` supplied to """,0.0,0,0,0
6583,6583,"""Invalid prop `testProp` of type `regexp` supplied to """,0.0,0,0,0
6584,6584,"""Invalid prop `testProp` of type `string` supplied to """,0.0,0,0,0
6585,6585,"""John""",0.0,0,0,0
6586,6586,"""Log only if derivation is actually about to re-run #2859""",0.0,0,0,0
6587,6587,"""Main Title""",0.0,0,0,0
6588,6588,"""Master""",0.0,0,0,0
6589,6589,"""Michel""",0.0,0,0,0
6590,6590,"""Mr.""",0.0,0,0,0
6591,6591,"""Nested Title""",0.0,0,0,0
6592,6592,"""New description""",0.0,0,0,0
6593,6593,"""Only elements types base, body, head, html, link, meta, noscript, script, style, title are allowed. Helmet does not support rendering <div> elements. Refer to our API for more information.""",0.0,0,0,0
6594,6594,"""Pasta""",0.0,0,0,0
6595,6595,"""Pizza""",0.0,0,0,0
6596,6596,"""Property `testProp` of component `testComponent` has invalid PropType notation.""",0.0,0,0,0
6597,6597,"""Share the repo""",0.0,0,0,0
6598,6598,"""Some Great Title""",0.0,0,0,0
6599,6599,"""Test Title with itemProp""",0.0,0,0,0
6600,6600,"""Test Title""",0.0,0,0,0
6601,6601,"""Test description & encoding of special characters like ' \"" > < `""",0.0,0,0,0
6602,6602,"""Test description &amp; encoding of special characters like &#x27; &quot; &gt; &lt; `""",0.0,0,0,0
6603,6603,"""This is a %s of the titleTemplate feature""",0.0,0,0,0
6604,6604,"""This is a %s of the titleTemplate feature. Another %s.""",0.0,0,0,0
6605,6605,"""This is a %s""",0.0,0,0,0
6606,6606,"""This is a Second Test of the titleTemplate feature""",0.0,0,0,0
6607,6607,"""This is a Test of the titleTemplate feature""",0.0,0,0,0
6608,6608,"""This is a Test of the titleTemplate feature. Another Test.""",0.0,0,0,0
6609,6609,"""This is a te$t te$$t te$$$t te$$$$t""",0.0,0,0,0
6610,6610,"""This is an %s""",0.0,0,0,0
6611,6611,"""This is an extra + test""",0.0,0,0,0
6612,6612,"""This is text and & and '.""",0.0,0,0,0
6613,6613,"""Title: Some Great Title""",0.0,0,0,0
6614,6614,"""Tom Tank""",0.0,0,0,0
6615,6615,"""Unexpected identifier""",0.0,0,0,0
6616,6616,"""Valid values""",0.0,0,0,0
6617,6617,"""Weird..""",0.0,0,0,0
6618,6618,"""Weststrate""",0.0,0,0,0
6619,6619,"""You may be attempting to nest <Helmet> components within each other, which is not allowed. Refer to our API for more information.""",0.0,0,0,0
6620,6620,"""You may only call rewind() on the server. Call peek() to read the current state.""",0.0,0,0,0
6621,6621,"""[1]""",0.0,0,0,0
6622,6622,"""[2]""",0.0,0,0,0
6623,6623,"""[mobx.trace] 'autorun' is invalidated due to a change in: 'x.fooIsGreaterThan5'""",0.0,0,0,0
6624,6624,"""[mobx.trace] 'autorun' is invalidated due to a change in: 'x.fullname'""",0.0,0,0,0
6625,6625,"""[mobx.trace] 'autorun' tracing enabled""",0.0,0,0,0
6626,6626,"""[mobx.trace] 'x.fooIsGreaterThan5' tracing enabled""",0.0,0,0,0
6627,6627,"""[mobx.trace] 'x.fullname' is invalidated due to a change in: 'x.firstname'""",0.0,0,0,0
6628,6628,"""[mobx.trace] 'x.fullname' tracing enabled""",0.0,0,0,0
6629,6629,"""[mobx.trace] Computed value 'x.fooIsGreaterThan5' is being read outside a reactive context. Doing a full recompute.""",0.0,0,0,0
6630,6630,"""[mobx.trace] Computed value 'x.fooIsGreaterThan5' was suspended and it will recompute on the next access.""",0.0,0,0,0
6631,6631,"""[mobx.trace] Computed value 'x.fullname' is being read outside a reactive context. Doing a full recompute.""",0.0,0,0,0
6632,6632,"""[mobx.trace] Computed value 'x.fullname' was suspended and it will recompute on the next access.""",0.0,0,0,0
6633,6633,"""_blank""",0.0,0,0,0
6634,6634,"""`testComponent`, expected `mobx.ObservableArray` or javascript `array`.""",0.0,0,0,0
6635,6635,"""`testComponent`, expected `mobx.ObservableMap`.""",0.0,0,0,0
6636,6636,"""`testComponent`, expected `mobx.ObservableObject` or javascript `object`.""",0.0,0,0,0
6637,6637,"""a, b, c""",0.0,0,0,0
6638,6638,"""action decorator (typescript)""",0.0,0,0,0
6639,6639,"""action decorator on field (typescript)""",0.0,0,0,0
6640,6640,"""action.bound binds (TS)""",0.0,0,0,0
6641,6641,"""allows duplicate link tags if specified in the same component""",0.0,0,0,0
6642,6642,"""allows duplicate meta tags if specified in the same component""",0.0,0,0,0
6643,6643,"""always""",0.0,0,0,0
6644,6644,"""amount""",0.0,0,0,0
6645,6645,"""annotations""",0.0,0,0,0
6646,6646,"""are not cleared""",0.0,0,0,0
6647,6647,"""arr""",0.0,0,0,0
6648,6648,"""arrayOrObservableArray""",0.0,0,0,0
6649,6649,"""arrayOrObservableArrayOf""",0.0,0,0,0
6650,6650,"""article""",0.0,0,0,0
6651,6651,"""attributes are cleared once managed in helmet""",0.0,0,0,0
6652,6652,"""attributes are not cleared""",0.0,0,0,0
6653,6653,"""attributes are overwritten if specified in helmet""",0.0,0,0,0
6654,6654,"""auto""",0.0,0,0,0
6655,6655,"""autorun""",0.0,0,0,0
6656,6656,"""b, c, a""",0.0,0,0,0
6657,6657,"""base""",0.0,0,0,0
6658,6658,"""baseTag""",0.0,0,0,0
6659,6659,"""basic observable - skip imports - keepDecorators""",0.0,0,0,0
6660,6660,"""basic observable - skip imports""",0.0,0,0,0
6661,6661,"""basic observable""",0.0,0,0,0
6662,6662,"""basic""",0.0,0,0,0
6663,6663,"""baz""",0.0,0,0,0
6664,6664,"""bla""",0.0,0,0,0
6665,6665,"""boe""",0.0,0,0,0
6666,6666,"""box""",0.0,0,0,0
6667,6667,"""ca observed""",0.0,0,0,0
6668,6668,"""ca unobserved""",0.0,0,0,0
6669,6669,"""calls the deepest defined callback with the deepest state""",0.0,0,0,0
6670,6670,"""caseA""",0.0,0,0,0
6671,6671,"""caseB""",0.0,0,0,0
6672,6672,"""caseC""",0.0,0,0,0
6673,6673,"""caseD""",0.0,0,0,0
6674,6674,"""caseE - base""",0.0,0,0,0
6675,6675,"""caseE""",0.0,0,0,0
6676,6676,"""caseF""",0.0,0,0,0
6677,6677,"""charset""",0.0,0,0,0
6678,6678,"""check layout renders just it's params""",0.0,0,0,0
6679,6679,"""class - annotations""",0.0,0,0,0
6680,6680,"""class - decorators""",0.0,0,0,0
6681,6681,"""class comp with export after""",0.0,0,0,0
6682,6682,"""class comp with export before""",0.0,0,0,0
6683,6683,"""class comp with inject and observer""",0.0,0,0,0
6684,6684,"""class comp with inject""",0.0,0,0,0
6685,6685,"""class comp with local fields - 1""",0.0,0,0,0
6686,6686,"""class comp with local fields preserves Props generic""",0.0,0,0,0
6687,6687,"""class comp with observer and decorator from another package""",0.0,0,0,0
6688,6688,"""class comp with observer, inject and decorator from another package""",0.0,0,0,0
6689,6689,"""class comp""",0.0,0,0,0
6690,6690,"""class default export comp with observer and inject""",0.0,0,0,0
6691,6691,"""class with constructor""",0.0,0,0,0
6692,6692,"""class with method and extends""",0.0,0,0,0
6693,6693,"""class""",0.0,0,0,0
6694,6694,"""class,lang""",0.0,0,0,0
6695,6695,"""class,tabindex""",0.0,0,0,0
6696,6696,"""cleared once it is managed in helmet""",0.0,0,0,0
6697,6697,"""clears all link tags if none are specified""",0.0,0,0,0
6698,6698,"""clears all meta tags if none are specified""",0.0,0,0,0
6699,6699,"""clears all noscripts tags if none are specified""",0.0,0,0,0
6700,6700,"""clears all scripts tags if none are specified""",0.0,0,0,0
6701,6701,"""clears all style tags if none are specified""",0.0,0,0,0
6702,6702,"""clears body attributes that are handled within helmet""",0.0,0,0,0
6703,6703,"""clears html attributes that are handled within helmet""",0.0,0,0,0
6704,6704,"""clears the base tag if one is not specified""",0.0,0,0,0
6705,6705,"""clears title attributes that are handled within helmet""",0.0,0,0,0
6706,6706,"""computed """,0.0,0,0,0
6707,6707,"""computed - setter - options""",0.0,0,0,0
6708,6708,"""computed - setter - struct""",0.0,0,0,0
6709,6709,"""computed - setter""",0.0,0,0,0
6710,6710,"""computed setter should succeed""",0.0,0,0,0
6711,6711,"""computed""",0.0,0,0,0
6712,6712,"""computed2""",0.0,0,0,0
6713,6713,"""create generic arguments for makeObservable""",0.0,0,0,0
6714,6714,"""custom action decorator (typescript)""",0.0,0,0,0
6715,6715,"""custom action decorator on field (typescript)""",0.0,0,0,0
6716,6716,"""customClass""",0.0,0,0,0
6717,6717,"""decorators""",0.0,0,0,0
6718,6718,"""do not create generic arguments for makeObservable - keepDecorators""",0.0,0,0,0
6719,6719,"""does html encode title""",0.0,0,0,0
6720,6720,"""does not accept nested Helmets""",0.0,0,0,0
6721,6721,"""does not change the DOM if it recevies identical props""",0.0,0,0,0
6722,6722,"""does not encode all characters with HTML character entity equivalents""",0.0,0,0,0
6723,6723,"""does not render tag when primary attribute (innerHTML) is null""",0.0,0,0,0
6724,6724,"""does not render tag when primary attribute (src) is null""",0.0,0,0,0
6725,6725,"""does not render tag when primary attribute is null""",0.0,0,0,0
6726,6726,"""does not render undefined attribute values""",0.0,0,0,0
6727,6727,"""does not write the DOM if the client and server are identical""",0.0,0,0,0
6728,6728,"""doesn't crash cryptically on undefined return from the service creator""",0.0,0,0,0
6729,6729,"""encodes special characters in title""",0.0,0,0,0
6730,6730,"""encodes special characters""",0.0,0,0,0
6731,6731,"""enumerability""",0.0,0,0,0
6732,6732,"""executes synchronously when defer={true} and async otherwise""",0.0,0,0,0
6733,6733,"""export const config={amp:'hybrid'};function About(props){return<h3>My AMP About Page!</h3>;}export default About;""",0.0,0,0,0
6734,6734,"""extendObservable can be used late and support non-enumerable getters #2386""",0.0,0,0,0
6735,6735,"""extended class with constructor""",0.0,0,0,0
6736,6736,"""extra""",0.0,0,0,0
6737,6737,"""field - bound - named""",0.0,0,0,0
6738,6738,"""field - named""",0.0,0,0,0
6739,6739,"""field - unnamed""",0.0,0,0,0
6740,6740,"""flow.bound #2941""",0.0,0,0,0
6741,6741,"""flow.bound #3271""",0.0,0,0,0
6742,6742,"""foo""",0.0,0,0,0
6743,6743,"""foo-class""",0.0,0,0,0
6744,6744,"""foo.js""",0.0,0,0,0
6745,6745,"""fooIsGreaterThan5""",0.0,0,0,0
6746,6746,"""fullname""",0.0,0,0,0
6747,6747,"""ga""",0.0,0,0,0
6748,6748,"""handle non-classes - 1""",0.0,0,0,0
6749,6749,"""handle non-classes - 2""",0.0,0,0,0
6750,6750,"""handle undeclared observable members""",0.0,0,0,0
6751,6751,"""handles undefined children""",0.0,0,0,0
6752,6752,"""handles valueless attributes""",0.0,0,0,0
6753,6753,"""hoi""",0.0,0,0,0
6754,6754,"""http-equiv""",0.0,0,0,0
6755,6755,"""http://example.com""",0.0,0,0,0
6756,6756,"""http://localhost/""",0.0,0,0,0
6757,6757,"""http://localhost/helmet/new""",0.0,0,0,0
6758,6758,"""http://localhost/style2.css""",0.0,0,0,0
6759,6759,"""http://mysite.com""",0.0,0,0,0
6760,6760,"""http://react-styleguidist.js.org/""",0.0,0,0,0
6761,6761,"""icon""",0.0,0,0,0
6762,6762,"""id""",0.0,0,0,0
6763,6763,"""id,title""",0.0,0,0,0
6764,6764,"""inheritance overrides observable""",0.0,0,0,0
6765,6765,"""inheritance""",0.0,0,0,0
6766,6766,"""inherited fields are assignable before makeObservable""",0.0,0,0,0
6767,6767,"""initialized outside of helmet""",0.0,0,0,0
6768,6768,"""isn't any""",0.0,0,0,0
6769,6769,"""issue 165""",0.0,0,0,0
6770,6770,"""issue 191 - shared initializers (ts)""",0.0,0,0,0
6771,6771,"""issue 285 (typescript)""",0.0,0,0,0
6772,6772,"""it should support asyncAction as decorator (ts)""",0.0,0,0,0
6773,6773,"""key""",0.0,0,0,0
6774,6774,"""lang,hidden""",0.0,0,0,0
6775,6775,"""lang,id,title""",0.0,0,0,0
6776,6776,"""lang-html""",0.0,0,0,0
6777,6777,"""lets you read current state in peek() whether or not a DOM is present""",0.0,0,0,0
6778,6778,"""light""",0.0,0,0,0
6779,6779,"""link""",0.0,0,0,0
6780,6780,"""loading""",0.0,0,0,0
6781,6781,"""loginCount""",0.0,0,0,0
6782,6782,"""makeAutoObservable + Object.create #3197""",0.0,0,0,0
6783,6783,"""makeAutoObservable + override + annotation cache #2832""",0.0,0,0,0
6784,6784,"""makeAutoObservable + production build #2751""",0.0,0,0,0
6785,6785,"""makeAutoObservable + symbolic keys""",0.0,0,0,0
6786,6786,"""makeAutoObservable actions can be used for state updaters and state readers""",0.0,0,0,0
6787,6787,"""makeAutoObservable allows overrides""",0.0,0,0,0
6788,6788,"""makeAutoObservable can be used late and support non-enumerable getters""",0.0,0,0,0
6789,6789,"""makeAutoObservable cannot be used on observable objects""",0.0,0,0,0
6790,6790,"""makeAutoObservable cannot be used on subclasses""",0.0,0,0,0
6791,6791,"""makeAutoObservable has sane defaults""",0.0,0,0,0
6792,6792,"""makeAutoObservable respects options.deep #2542'""",0.0,0,0,0
6793,6793,"""makeAutoObservable supports autoBind""",0.0,0,0,0
6794,6794,"""makeObservable can be used late and support non-enumerable getters""",0.0,0,0,0
6795,6795,"""makeObservable doesn't trigger in always mode'""",0.0,0,0,0
6796,6796,"""makeObservable gets added to the non-type import #2415""",0.0,0,0,0
6797,6797,"""makeObservable has sane defaults""",0.0,0,0,0
6798,6798,"""makeObservable not added to imports #2540""",0.0,0,0,0
6799,6799,"""makeObservable picks up annotations""",0.0,0,0,0
6800,6800,"""makeObservable picks up decorators""",0.0,0,0,0
6801,6801,"""makeObservable respects options.name #2614'""",0.0,0,0,0
6802,6802,"""makeObservable supports autoBind""",0.0,0,0,0
6803,6803,"""makeObservable supports private fields""",0.0,0,0,0
6804,6804,"""makeObservable throws when mixing @decorators with annotations""",0.0,0,0,0
6805,6805,"""merges deepest component title with nearest upstream titleTemplate""",0.0,0,0,0
6806,6806,"""meta""",0.0,0,0,0
6807,6807,"""method - bound - named - generator""",0.0,0,0,0
6808,6808,"""method - bound - named""",0.0,0,0,0
6809,6809,"""method - bound - unnamed""",0.0,0,0,0
6810,6810,"""method - unbound - computed name""",0.0,0,0,0
6811,6811,"""method - unbound - named""",0.0,0,0,0
6812,6812,"""method - unbound - unnamed""",0.0,0,0,0
6813,6813,"""mobx""",0.0,0,0,0
6814,6814,"""multiple inheritance should work""",0.0,0,0,0
6815,6815,"""multiple targets""",0.0,0,0,0
6816,6816,"""never""",0.0,0,0,0
6817,6817,"""noscript""",0.0,0,0,0
6818,6818,"""number""",0.0,0,0,0
6819,6819,"""o observed""",0.0,0,0,0
6820,6820,"""o unobserved""",0.0,0,0,0
6821,6821,"""object""",0.0,0,0,0
6822,6822,"""objectOrObservableObject""",0.0,0,0,0
6823,6823,"""observable """,0.0,0,0,0
6824,6824,"""observable - shallow """,0.0,0,0,0
6825,6825,"""observable - shallow - computed name """,0.0,0,0,0
6826,6826,"""observable actions can be used for state updaters and state readers""",0.0,0,0,0
6827,6827,"""observableArray""",0.0,0,0,0
6828,6828,"""observableArrayOf""",0.0,0,0,0
6829,6829,"""observableMap""",0.0,0,0,0
6830,6830,"""observableObject""",0.0,0,0,0
6831,6831,"""observableSymbol""",0.0,0,0,0
6832,6832,"""observe computed values""",0.0,0,0,0
6833,6833,"""observe object and map properties""",0.0,0,0,0
6834,6834,"""observed""",0.0,0,0,0
6835,6835,"""og:type""",0.0,0,0,0
6836,6836,"""onBecomeObserved""",0.0,0,0,0
6837,6837,"""onBecomeObservedinitial""",0.0,0,0,0
6838,6838,"""onBecomeObservednew""",0.0,0,0,0
6839,6839,"""onBecomeUnobserved""",0.0,0,0,0
6840,6840,"""onBecomeUnobservedinitial""",0.0,0,0,0
6841,6841,"""onBecomeUnobservednew""",0.0,0,0,0
6842,6842,"""only adds new tags and preserves tags when rendering additional Helmet instances""",0.0,0,0,0
6843,6843,"""opts out of string encoding""",0.0,0,0,0
6844,6844,"""override must override""",0.0,0,0,0
6845,6845,"""override""",0.0,0,0,0
6846,6846,"""overrides duplicate link tags with a single link tag in a nested component""",0.0,0,0,0
6847,6847,"""overrides duplicate meta tags with single meta tag in a nested component""",0.0,0,0,0
6848,6848,"""overrides single link tag with duplicate link tags in a nested component""",0.0,0,0,0
6849,6849,"""overrides single meta tag with duplicate meta tags in a nested component""",0.0,0,0,0
6850,6850,"""overwritten if specified in helmet""",0.0,0,0,0
6851,6851,"""p""",0.0,0,0,0
6852,6852,"""page title with prop itemProp""",0.0,0,0,0
6853,6853,"""page.js doesn't have a root layout. To fix this error, make sure every page has a root layout.""",0.0,0,0,0
6854,6854,"""pathname: '/object/[slug]'""",0.0,0,0,0
6855,6855,"""pathname: '/object/slug'""",0.0,0,0,0
6856,6856,"""pizza""",0.0,0,0,0
6857,6857,"""printDebugValue""",0.0,0,0,0
6858,6858,"""properly handles title with children and titleTemplate""",0.0,0,0,0
6859,6859,"""provides initial values if no state is found""",0.0,0,0,0
6860,6860,"""react""",0.0,0,0,0
6861,6861,"""recognizes valid tags regardless of attribute ordering""",0.0,0,0,0
6862,6862,"""red""",0.0,0,0,0
6863,6863,"""ref""",0.0,0,0,0
6864,6864,"""renderStatic""",0.0,0,0,0
6865,6865,"""renders base tag as React component""",0.0,0,0,0
6866,6866,"""renders base tags as string""",0.0,0,0,0
6867,6867,"""renders body attributes as component""",0.0,0,0,0
6868,6868,"""renders body attributes as string""",0.0,0,0,0
6869,6869,"""renders dollar characters in a title correctly when titleTemplate present""",0.0,0,0,0
6870,6870,"""renders html attributes as component""",0.0,0,0,0
6871,6871,"""renders html attributes as string""",0.0,0,0,0
6872,6872,"""renders link tags as React components""",0.0,0,0,0
6873,6873,"""renders link tags as string""",0.0,0,0,0
6874,6874,"""renders meta tags as React components""",0.0,0,0,0
6875,6875,"""renders meta tags as string""",0.0,0,0,0
6876,6876,"""renders noscript tags as React components""",0.0,0,0,0
6877,6877,"""renders script tags as React components""",0.0,0,0,0
6878,6878,"""renders script tags as string""",0.0,0,0,0
6879,6879,"""renders style tags as React components""",0.0,0,0,0
6880,6880,"""renders style tags as string""",0.0,0,0,0
6881,6881,"""renders title and allows children containing expressions""",0.0,0,0,0
6882,6882,"""renders title as React component""",0.0,0,0,0
6883,6883,"""renders title tag as string""",0.0,0,0,0
6884,6884,"""renders title with itemprop name as React component""",0.0,0,0,0
6885,6885,"""renders title with itemprop name as string""",0.0,0,0,0
6886,6886,"""replaces multiple title strings in titleTemplate""",0.0,0,0,0
6887,6887,"""requestAnimationFrame works as expected""",0.0,0,0,0
6888,6888,"""require('foo')""",0.0,0,0,0
6889,6889,"""retains existing title tag when no title tag is defined""",0.0,0,0,0
6890,6890,"""reusing initializers""",0.0,0,0,0
6891,6891,"""rewind() provides a fallback object for empty Helmet state""",0.0,0,0,0
6892,6892,"""script""",0.0,0,0,0
6893,6893,"""scriptTags""",0.0,0,0,0
6894,6894,"""section""",0.0,0,0,0
6895,6895,"""sets attributes based on the deepest nested component""",0.0,0,0,0
6896,6896,"""sets base tag based on deepest nested component""",0.0,0,0,0
6897,6897,"""sets link tags based on deepest nested component""",0.0,0,0,0
6898,6898,"""sets meta tags based on deepest nested component""",0.0,0,0,0
6899,6899,"""sets script tags based on deepest nested component""",0.0,0,0,0
6900,6900,"""sets title based on deepest nested component""",0.0,0,0,0
6901,6901,"""sets title using deepest nested component with a defined title""",0.0,0,0,0
6902,6902,"""sets undefined attribute values to empty strings""",0.0,0,0,0
6903,6903,"""should allow rewriting to SSG page with fallback: 'blocking'""",0.0,0,0,0
6904,6904,"""should allow specifying `onReceive`'s argument type manually""",0.0,0,0,0
6905,6905,"""should be implicitly optional and not warn""",0.0,0,0,0
6906,6906,"""should fail date and regexp correctly""",0.0,0,0,0
6907,6907,"""should give empty optional catchall params won't give params to any layout""",0.0,0,0,0
6908,6908,"""should handle getStaticProps when fallback: 'blocking'""",0.0,0,0,0
6909,6909,"""should not crash when using doctrine to parse a default prop that isn't in the props list""",0.0,0,0,0
6910,6910,"""should not provide a loose type for `onReceive`'s argument as a default""",0.0,0,0,0
6911,6911,"""should not stop the interpreter even if subscribers' count go temporarily to zero""",0.0,0,0,0
6912,6912,"""should only call data expression once when entering root's final state""",0.0,0,0,0
6913,6913,"""should preserve typestate for the service returned by Interpreter.start() and a servcie's .state getter.""",0.0,0,0,0
6914,6914,"""should provide context to single prop updater in assign when it's mixed with a static value for another prop""",0.0,0,0,0
6915,6915,"""should reenter targeted ancestor (as it's a descendant of the transition domain)""",0.0,0,0,0
6916,6916,"""should resolve transitioning from regions that don't exist (remove region)""",0.0,0,0,0
6917,6917,"""should scroll down to the navigated page when it's below viewort""",0.0,0,0,0
6918,6918,"""should scroll to top of page when scrolling to phe top of the document wouldn't have the page in the viewport""",0.0,0,0,0
6919,6919,"""should throw an error when an event's type is the wildcard""",0.0,0,0,0
6920,6920,"""should throw if getInitialProps won't return an object """,0.0,0,0,0
6921,6921,"""should warn for missing required values, function (test)""",0.0,0,0,0
6922,6922,"""should't scroll horizontally""",0.0,0,0,0
6923,6923,"""shouldn't crash when invoking a machine with initial transient transition depending on custom data""",0.0,0,0,0
6924,6924,"""shouldn't end up with `any` context after calling `state.matches`""",0.0,0,0,0
6925,6925,"""shouldn't end up with `never` within a branch after two `state.matches` calls""",0.0,0,0,0
6926,6926,"""shouldn't exit (and reenter) state on targetless delayed transition""",0.0,0,0,0
6927,6927,"""shouldn't exit a state on a parent's targetless transition""",0.0,0,0,0
6928,6928,"""simple""",0.0,0,0,0
6929,6929,"""slot""",0.0,0,0,0
6930,6930,"""small""",0.0,0,0,0
6931,6931,"""strong""",0.0,0,0,0
6932,6932,"""subclass - annotation - override""",0.0,0,0,0
6933,6933,"""subclass - annotation""",0.0,0,0,0
6934,6934,"""subclass - cannot re-annotate""",0.0,0,0,0
6935,6935,"""subclass - cannot re-decorate""",0.0,0,0,0
6936,6936,"""subclass - cannot redefine property""",0.0,0,0,0
6937,6937,"""subclass - decorator - override""",0.0,0,0,0
6938,6938,"""subclass - decorator""",0.0,0,0,0
6939,6939,"""tabindex""",0.0,0,0,0
6940,6940,"""tags 'rel' and 'href' properly use 'rel' as the primary identification for this tag, regardless of ordering""",0.0,0,0,0
6941,6941,"""tags with rel='stylesheet' uses the href as the primary identification of the tag, regardless of ordering""",0.0,0,0,0
6942,6942,"""tags without 'cssText' are not accepted""",0.0,0,0,0
6943,6943,"""tags without 'href' are not accepted""",0.0,0,0,0
6944,6944,"""tags without 'href' or 'rel' are not accepted, even if they are valid for other tags""",0.0,0,0,0
6945,6945,"""tags without 'innerHTML' are not accepted""",0.0,0,0,0
6946,6946,"""tags without 'name', 'http-equiv', 'property', 'charset', or 'itemprop' are not accepted""",0.0,0,0,0
6947,6947,"""tags without 'src' are not accepted""",0.0,0,0,0
6948,6948,"""te$t te$$t te$$$t te$$$$t""",0.0,0,0,0
6949,6949,"""test symbol""",0.0,0,0,0
6950,6950,"""test-class""",0.0,0,0,0
6951,6951,"""testString""",0.0,0,0,0
6952,6952,"""throws if mobx is not installed""",0.0,0,0,0
6953,6953,"""throws if react is not installed""",0.0,0,0,0
6954,6954,"""throws in rewind() when a DOM is present""",0.0,0,0,0
6955,6955,"""title""",0.0,0,0,0
6956,6956,"""toJS bug #1413 (TS)""",0.0,0,0,0
6957,6957,"""true""",0.0,0,0,0
6958,6958,"""two""",0.0,0,0,0
6959,6959,"""typescript: parameterized computed decorator""",0.0,0,0,0
6960,6960,"""unbound methods""",0.0,0,0,0
6961,6961,"""unobserved computed reads should warn with requiresReaction enabled""",0.0,0,0,0
6962,6962,"""untracked 1""",0.0,0,0,0
6963,6963,"""updates base tag""",0.0,0,0,0
6964,6964,"""updates html attributes""",0.0,0,0,0
6965,6965,"""updates link tags""",0.0,0,0,0
6966,6966,"""updates meta tags""",0.0,0,0,0
6967,6967,"""updates multiple body attributes""",0.0,0,0,0
6968,6968,"""updates noscript tags""",0.0,0,0,0
6969,6969,"""updates page title and allows children containing expressions""",0.0,0,0,0
6970,6970,"""updates page title with multiple children""",0.0,0,0,0
6971,6971,"""updates page title""",0.0,0,0,0
6972,6972,"""updates script tags""",0.0,0,0,0
6973,6973,"""updates style tags""",0.0,0,0,0
6974,6974,"""updates title attributes""",0.0,0,0,0
6975,6975,"""updates with multiple additions and removals - all new""",0.0,0,0,0
6976,6976,"""updates with multiple additions and removals - overwrite and new""",0.0,0,0,0
6977,6977,"""uses a titleTemplate based on deepest nested component""",0.0,0,0,0
6978,6978,"""uses a titleTemplate if defined""",0.0,0,0,0
6979,6979,"""uses defaultTitle if no title is defined""",0.0,0,0,0
6980,6980,"""val""",0.0,0,0,0
6981,6981,"""value""",0.0,0,0,0
6982,6982,"""value1""",0.0,0,0,0
6983,6983,"""value1Computed""",0.0,0,0,0
6984,6984,"""verify object assign (typescript)""",0.0,0,0,0
6985,6985,"""warn""",0.0,0,0,0
6986,6986,"""warns on invalid elements""",0.0,0,0,0
6987,6987,"""warns on invalid self-closing elements""",0.0,0,0,0
6988,6988,"""weird syntaxes""",0.0,0,0,0
6989,6989,"""when handling client state change, calls the function with new state, addedTags and removedTags """,0.0,0,0,0
6990,6990,"""won't work""",0.0,0,0,0
6991,6991,"""work on map with number as key""",0.0,0,0,0
6992,6992,"""y""",0.0,0,0,0
6993,6993,"""膣膗 鍆錌雔""",0.0,0,0,0
6994,6994,$mobx,0.0,0,0,0
6995,6995,"'            <button class=""nav-link active"" id=""nav-home-tab"" data-bs-toggle=""tab"" data-bs-target=""#nav-home"" type=""button"" role=""tab"" aria-controls=""nav-home"" aria-selected=""true"">Home</button>'",0.0,0,0,0
6996,6996,"'            <button class=""nav-link"" id=""nav-profile-tab"" data-bs-toggle=""tab"" data-bs-target=""#nav-profile"" type=""button"" role=""tab"" aria-controls=""nav-profile"" aria-selected=""false"">Profile</button>'",0.0,0,0,0
6997,6997,"'            <button data-bs-target=""#childContent1"" data-bs-toggle=""collapse"" class=""accordion-toggle"">Child 1</button>'",0.0,0,0,0
6998,6998,"'            <button data-bs-target=""#childContent2"" data-bs-toggle=""collapse"" class=""accordion-toggle"">Child 2</button>'",0.0,0,0,0
6999,6999,"'          <a id=""nestedLinkTrigger"" data-bs-toggle=""collapse"" href=""#nestedCollapseOne"" aria-expanded=""false"" aria-controls=""nestedCollapseOne""></a>'",0.0,0,0,0
7000,7000,"'          <div class=""nav nav-tabs"" id=""nav-tab"" role=""tablist"">'",0.0,0,0,0
7001,7001,"'          <div class=""tab-pane fade show active"" id=""nav-home"" role=""tabpanel"" aria-labelledby=""nav-home-tab"">Home</div>'",0.0,0,0,0
7002,7002,"'          <div class=""tab-pane fade"" id=""nav-profile"" role=""tabpanel"" aria-labelledby=""nav-profile-tab"">Profile</div>'",0.0,0,0,0
7003,7003,"'          <div id=""childContent1"" class=""accordion-collapse collapse"" data-bs-parent=""#childGroup"">'",0.0,0,0,0
7004,7004,"'          <div id=""childContent2"" class=""accordion-collapse collapse"" data-bs-parent=""#childGroup"">'",0.0,0,0,0
7005,7005,"'          <div id=""nestedCollapseOne"" data-bs-parent=""#nestedAccordion"" class=""collapse"" role=""tabpanel""></div>'",0.0,0,0,0
7006,7006,"'          <li class=""nav-item""><a href=""#detail"">Detail</a></li>'",0.0,0,0,0
7007,7007,"'          <li class=""nav-item""><a href=""#masthead"">Overview</a></li>'",0.0,0,0,0
7008,7008,'        </nav>',0.0,0,0,0
7009,7009,'        </ul>',0.0,0,0,0
7010,7010,"'        <a id=""linkTrigger"" data-bs-toggle=""collapse"" href=""#collapseOne"" aria-expanded=""false"" aria-controls=""collapseOne""></a>'",0.0,0,0,0
7011,7011,"'        <a id=""linkTriggerTwo"" data-bs-toggle=""collapse"" href=""#collapseTwo"" aria-expanded=""false"" aria-controls=""collapseTwo""></a>'",0.0,0,0,0
7012,7012,"'        <div class=""item"">'",0.0,0,0,0
7013,7013,"'        <div class=""tab-content"" id=""nav-tabContent"">'",0.0,0,0,0
7014,7014,"'        <div id=""collapseOne"" class=""collapse"" role=""tabpanel"" data-bs-parent=""#accordion""></div>'",0.0,0,0,0
7015,7015,"'        <div id=""collapseTwo"" class=""collapse show"" role=""tabpanel"" data-bs-parent=""#accordion""></div>'",0.0,0,0,0
7016,7016,'        <nav>',0.0,0,0,0
7017,7017,"'        <ul class=""nav"">'",0.0,0,0,0
7018,7018,'        Accordion Item #1',0.0,0,0,0
7019,7019,'        Tab with numeric ID should work (#2)',0.0,0,0,0
7020,7020,'        Working Tab 1 (#tab1)',0.0,0,0,0
7021,7021,'      </a>',0.0,0,0,0
7022,7022,'      </button>',0.0,0,0,0
7023,7023,"'      <a class=""dropdown-item active"" href=""#dropdown1"" id=""dropdown1-tab"" data-bs-toggle=""tab"">@fat</a>'",0.0,0,0,0
7024,7024,"'      <a class=""dropdown-item"" href=""#"">Another link</a>'",0.0,0,0,0
7025,7025,"'      <a class=""dropdown-item"" href=""#"">Secondary link</a>'",0.0,0,0,0
7026,7026,"'      <a class=""dropdown-item"" href=""#"">Some Item</a>'",0.0,0,0,0
7027,7027,"'      <a class=""dropdown-item"" href=""#"">Something else here</a>'",0.0,0,0,0
7028,7028,"'      <a class=""dropdown-item"" href=""#dropdown2"" id=""dropdown2-tab"" data-bs-toggle=""tab"">@mdo</a>'",0.0,0,0,0
7029,7029,"'      <a class=""dropdown-item"" href=""#sub1"">Submenu 1</a>'",0.0,0,0,0
7030,7030,"'      <a class=""dropdown-item"" href=""#subMenu"">Sub menu</a>'",0.0,0,0,0
7031,7031,"'      <a class=""nav-link"" draggable=""false"" data-toggle=""tab"" href=""#tab1"">'",0.0,0,0,0
7032,7032,"'      <a id=""trigger2"" class=""nav-link"" draggable=""false"" data-toggle=""tab"" href=""#2"">'",0.0,0,0,0
7033,7033,"'      <button class=""accordion-button"" type=""button"" data-bs-toggle=""collapse"" data-bs-target=""#collapseOne"" aria-expanded=""true"" aria-controls=""collapseOne"">'",0.0,0,0,0
7034,7034,"'      <button id=""btnClose"" class=""btn-close"" aria-label=""Close""></button>'",0.0,0,0,0
7035,7035,"'      <button type=""button"" data-bs-dismiss=""modal""></button>'",0.0,0,0,0
7036,7036,"'      <button type=""button"" data-bs-target=""#nested-tab1"" class=""nav-link active"" data-bs-toggle=""tab"" role=""tab"" aria-controls=""x-tab1"" aria-selected=""true"">Nested Tab 1</button>'",0.0,0,0,0
7037,7037,"'      <button type=""button"" id=""tabNested2"" data-bs-target=""#nested-tab2"" class=""nav-link"" data-bs-toggle=""tab"" role=""tab"" aria-controls=""x-profile"">Nested Tab2</button>'",0.0,0,0,0
7038,7038,"'      <div class=""accordion-body"">'",0.0,0,0,0
7039,7039,"'      <div class=""container"" id=""ss-target"">'",0.0,0,0,0
7040,7040,"'      <div class=""content""></div>'",0.0,0,0,0
7041,7041,"'      <div class=""divider""></div>'",0.0,0,0,0
7042,7042,"'      <div class=""tab-pane active"" id=""nested-tab1"" role=""tabpanel"">Nested Tab1 Content</div>'",0.0,0,0,0
7043,7043,"'      <div class=""tab-pane"" id=""nested-tab2"" role=""tabpanel"">Nested Tab2 Content</div>'",0.0,0,0,0
7044,7044,"'      <div id=""childGroup"" class=""accordion"">'",0.0,0,0,0
7045,7045,"'      <div id=""nestedAccordion"">'",0.0,0,0,0
7046,7046,"'      <input type=""text"">'",0.0,0,0,0
7047,7047,"'      <li><a class=""dropdown-item"" href=""#dropdown1"" id=""dropdown1-tab"" data-bs-toggle=""tab"">@fat</a></li>'",0.0,0,0,0
7048,7048,"'      <li><a class=""dropdown-item"" href=""#dropdown2"" id=""dropdown2-tab"" data-bs-toggle=""tab"">@mdo</a></li>'",0.0,0,0,0
7049,7049,'      <option selected>Open this select menu</option>',0.0,0,0,0
7050,7050,"'      <option value=""1"">One</option>'",0.0,0,0,0
7051,7051,'      <textarea></textarea>',0.0,0,0,0
7052,7052,'      Working Tab 1 (#tab1) Content Here',0.0,0,0,0
7053,7053,'      Working Tab 2 (#2) with numeric ID',0.0,0,0,0
7054,7054,'     </a>',0.0,0,0,0
7055,7055,"'     <div class=""tab-pane fade"" id=""tab1"">'",0.0,0,0,0
7056,7056,"'     <div style=""height: 200px;"" id=""detail"">Detail</div>'",0.0,0,0,0
7057,7057,"'     <div style=""height: 200px;"" id=""masthead"">Overview</div>'",0.0,0,0,0
7058,7058,"'     <li class=""nav-item""><a class=""nav-link active"" id=""one-link"" href=""#"">One</a></li>'",0.0,0,0,0
7059,7059,'    </h2>',0.0,0,0,0
7060,7060,'    </nav>',0.0,0,0,0
7061,7061,'    </select>',0.0,0,0,0
7062,7062,'    </ul>',0.0,0,0,0
7063,7063,"'    <a class=""dropdown-item disabled"" href=""#sub1"">Submenu 1</a>'",0.0,0,0,0
7064,7064,"'    <a class=""dropdown-item"" href=""#"">Action 1</a>'",0.0,0,0,0
7065,7065,"'    <a class=""dropdown-item"" href=""#"">Link</a>'",0.0,0,0,0
7066,7066,"'    <a class=""dropdown-item"" href=""#"">Some Item</a>'",0.0,0,0,0
7067,7067,"'    <a class=""dropdown-item"" href=""#sub1"" style=""display: none"">Hidden link</a>'",0.0,0,0,0
7068,7068,"'    <a class=""dropdown-item"" href=""#sub1"" style=""visibility: hidden"">Hidden link</a>'",0.0,0,0,0
7069,7069,"'    <a class=""dropdown-item"" href=""#sub1"">Submenu 1</a>'",0.0,0,0,0
7070,7070,"'    <a class=""dropdown-item"" href=""#subMenu"">Sub menu</a>'",0.0,0,0,0
7071,7071,"'    <a class=""dropdown-toggle"" data-bs-toggle=""dropdown"" href=""#testmenu"">Test menu</a>'",0.0,0,0,0
7072,7072,"'    <a class=""list-group-item"" id=""a-1"" href=""#div-1"">div 1</a>'",0.0,0,0,0
7073,7073,"'    <a class=""list-group-item"" id=""a-2"" href=""#div-2"">div 2</a>'",0.0,0,0,0
7074,7074,"'    <a class=""nav-link dropdown-toggle active"" data-bs-toggle=""dropdown"" href=""#"">Dropdown</a>'",0.0,0,0,0
7075,7075,"'    <a class=""nav-link nav-tab"" href=""#profile"" role=""tab"" data-bs-toggle=""tab"">'",0.0,0,0,0
7076,7076,"'    <a class=""nav-link nav-tab"" href=""#references"" role=""tab"" data-bs-toggle=""tab"">'",0.0,0,0,0
7077,7077,"'    <a class=""nav-link"" id=""a-1"" href=""#div-1"">div 1</a>'",0.0,0,0,0
7078,7078,"'    <a class=""nav-link"" id=""a-2"" href=""#div-2"">div 2</a>'",0.0,0,0,0
7079,7079,"'    <a data-bs-toggle=""collapse"" href=""#"">Toggle item 1</a>'",0.0,0,0,0
7080,7080,"'    <a data-bs-toggle=""collapse"" href=""#"">Toggle item</a>'",0.0,0,0,0
7081,7081,"'    <a href=""#"" class=""active"">link</a>'",0.0,0,0,0
7082,7082,"'    <a id=""anchor-1"" href=""#div-jsm-1"">div 1</a></li>'",0.0,0,0,0
7083,7083,"'    <a id=""anchor-2"" href=""#foo"">div 2</a></li>'",0.0,0,0,0
7084,7084,"'    <a id=""item1"" class=""dropdown-item"" href=""#"">A link</a>'",0.0,0,0,0
7085,7085,"'    <a id=""item1"" class=""dropdown-item"" href=""#"">Another link</a>'",0.0,0,0,0
7086,7086,"'    <a id=""item2"" class=""dropdown-item"" href=""#"">Another link</a>'",0.0,0,0,0
7087,7087,"'    <a id=""linkTrigger"" data-bs-toggle=""collapse"" href=""#collapseOne"" aria-expanded=""false"" aria-controls=""collapseOne""></a>'",0.0,0,0,0
7088,7088,"'    <a id=""linkTriggerTwo"" data-bs-toggle=""collapse"" href=""#collapseTwo"" aria-expanded=""false"" aria-controls=""collapseTwo""></a>'",0.0,0,0,0
7089,7089,"'    <a id=""secondNav"" class=""nav-link nav-tab"" href=""#buzz"" role=""tab"" data-bs-toggle=""tab"">'",0.0,0,0,0
7090,7090,"'    <a id=""triggerCollapse2"" data-bs-toggle=""collapse"" href=""#"">Toggle item 2</a>'",0.0,0,0,0
7091,7091,"'    <a type=""button"" data-bs-dismiss=""modal""></a>'",0.0,0,0,0
7092,7092,"'    <button class=""btn dropdown-toggle"" data-bs-toggle=""dropdown"" aria-expanded=""false"">Dropdown</button>'",0.0,0,0,0
7093,7093,"'    <button class=""btn dropdown-toggle"" data-bs-toggle=""dropdown""><span id=""childElement"">Dropdown</span></button>'",0.0,0,0,0
7094,7094,"'    <button class=""btn dropdown-toggle"" data-bs-toggle=""dropdown"">Dropdown</button>'",0.0,0,0,0
7095,7095,"'    <button class=""dropdown-item d-none"" type=""button"">Hidden button by class</button>'",0.0,0,0,0
7096,7096,"'    <button class=""dropdown-item"" type=""button"" disabled>Disabled button</button>'",0.0,0,0,0
7097,7097,"'    <button data-bs-target=""#parentContent"" data-bs-toggle=""collapse"" class=""accordion-toggle"">Parent</button>'",0.0,0,0,0
7098,7098,"'    <button disabled class=""btn dropdown-toggle"" data-bs-toggle=""dropdown"">Dropdown</button>'",0.0,0,0,0
7099,7099,"'    <button type=""button"" class=""nav-link nav-tab"" data-bs-target=""#home"" role=""tab"" data-bs-toggle=""tab"">Home</button>'",0.0,0,0,0
7100,7100,"'    <button type=""button"" data-bs-dismiss=""modal""></button>'",0.0,0,0,0
7101,7101,"'    <button type=""button"" data-bs-target=""myCarousel"" data-bs-slide-to=""2"" aria-label=""Slide 3""></button>'",0.0,0,0,0
7102,7102,"'    <button type=""button"" id=""firstIndicator"" data-bs-target=""myCarousel"" data-bs-slide-to=""0"" class=""active"" aria-current=""true"" aria-label=""Slide 1""></button>'",0.0,0,0,0
7103,7103,"'    <button type=""button"" id=""secondIndicator"" data-bs-target=""myCarousel"" data-bs-slide-to=""1"" aria-label=""Slide 2""></button>'",0.0,0,0,0
7104,7104,"'    <button type=""button"" id=""secondNav"" class=""nav-link nav-tab"" data-bs-target=""#profile"" role=""tab"" data-bs-toggle=""tab"">Profile</button>'",0.0,0,0,0
7105,7105,'    <button>with a button</button>',0.0,0,0,0
7106,7106,"'    <circle cx=""50"" cy=""50"" r=""30"" fill=""#fff""/>'",0.0,0,0,0
7107,7107,"'    <div class=""accordion-body"">'",0.0,0,0,0
7108,7108,"'    <div class=""carousel-item active"" data-bs-interval=""7"">item 1</div>'",0.0,0,0,0
7109,7109,"'    <div class=""carousel-item active"">'",0.0,0,0,0
7110,7110,"'    <div class=""carousel-item active"">item 1</div>'",0.0,0,0,0
7111,7111,"'    <div class=""carousel-item active"">item 2</div>'",0.0,0,0,0
7112,7112,"'    <div class=""carousel-item carousel-item-next"">item 2</div>'",0.0,0,0,0
7113,7113,"'    <div class=""carousel-item"" data-bs-interval=""7"">item 2</div>'",0.0,0,0,0
7114,7114,"'    <div class=""carousel-item"">'",0.0,0,0,0
7115,7115,"'    <div class=""carousel-item""></div>'",0.0,0,0,0
7116,7116,"'    <div class=""carousel-item"">item 1</div>'",0.0,0,0,0
7117,7117,"'    <div class=""carousel-item"">item 2</div>'",0.0,0,0,0
7118,7118,"'    <div class=""carousel-item"">item 3</div>'",0.0,0,0,0
7119,7119,"'    <div class=""collapse"">Lorem ipsum</div>'",0.0,0,0,0
7120,7120,"'    <div class=""modal-body""></div>'",0.0,0,0,0
7121,7121,"'    <div class=""modal-content""></div>'",0.0,0,0,0
7122,7122,"'    <div class=""modal-header"">'",0.0,0,0,0
7123,7123,"'    <div class=""tab-content"">'",0.0,0,0,0
7124,7124,"'    <div class=""topbar-inner"">'",0.0,0,0,0
7125,7125,"'    <div id=""collapse1"" class=""collapse show"">Lorem ipsum 1</div>'",0.0,0,0,0
7126,7126,"'    <div id=""collapse2"" class=""collapse"">Lorem ipsum 2</div>'",0.0,0,0,0
7127,7127,"'    <div id=""collapseOne"" class=""accordion-collapse collapse show"" data-bs-parent=""#accordionExample"">'",0.0,0,0,0
7128,7128,"'    <div id=""collapseOne"" class=""collapse"" role=""tabpanel"" data-bs-parent=""#accordion""></div>'",0.0,0,0,0
7129,7129,"'    <div id=""collapseOne"" data-bs-parent=""#accordion"" class=""collapse"" role=""tabpanel"">'",0.0,0,0,0
7130,7130,"'    <div id=""collapseTwo"" class=""collapse show"" role=""tabpanel"" data-bs-parent=""#accordion""></div>'",0.0,0,0,0
7131,7131,"'    <div id=""collapseTwo"" data-bs-parent=""#accordion"" class=""collapse show"" role=""tabpanel""></div>'",0.0,0,0,0
7132,7132,"'    <div id=""item"" class=""carousel-item active"">'",0.0,0,0,0
7133,7133,"'    <div id=""item"" class=""carousel-item"">'",0.0,0,0,0
7134,7134,"'    <div id=""item1"" class=""carousel-item active"">item 1</div>'",0.0,0,0,0
7135,7135,"'    <div id=""item1"" class=""carousel-item"">item 1</div>'",0.0,0,0,0
7136,7136,"'    <div id=""item2"" class=""carousel-item"">item 2</div>'",0.0,0,0,0
7137,7137,"'    <div id=""item3"" class=""carousel-item active"">item 3</div>'",0.0,0,0,0
7138,7138,"'    <div id=""item3"" class=""carousel-item"">item 3</div>'",0.0,0,0,0
7139,7139,"'    <div id=""one"" class=""carousel-item active""></div>'",0.0,0,0,0
7140,7140,"'    <div id=""secondItem"" class=""carousel-item"" data-bs-interval=""9385"">item 2</div>'",0.0,0,0,0
7141,7141,"'    <div id=""secondItem"" class=""carousel-item"">item 2</div>'",0.0,0,0,0
7142,7142,"'    <div id=""three"" class=""carousel-item"">item 3</div>'",0.0,0,0,0
7143,7143,"'    <div id=""two"" class=""carousel-item""></div>'",0.0,0,0,0
7144,7144,"'    <div style=""height: 200px;"" id=""detail"">Detail</div>'",0.0,0,0,0
7145,7145,"'    <div style=""height: 200px;"" id=""masthead"">Overview</div>'",0.0,0,0,0
7146,7146,'    <div>',0.0,0,0,0
7147,7147,"'    <h2 class=""accordion-header"">'",0.0,0,0,0
7148,7148,"'    <input type=""text"">'",0.0,0,0,0
7149,7149,"'    <li class=""nav-item""><a class=""nav-link active"" id=""one-link"" href=""#"">One</a></li>'",0.0,0,0,0
7150,7150,"'    <li class=""nav-item""><a class=""nav-link active"" id=""one-link"" href=""#one"">One</a></li>'",0.0,0,0,0
7151,7151,"'    <li class=""nav-item""><a class=""nav-link"" id=""a-1"" href=""#div-1"">div 1</a></li>'",0.0,0,0,0
7152,7152,"'    <li class=""nav-item""><a class=""nav-link"" id=""a-2"" href=""#div-2"">div 2</a></li>'",0.0,0,0,0
7153,7153,"'    <li class=""nav-item""><a class=""nav-link"" id=""three-link"" href=""#three"">Three</a></li>'",0.0,0,0,0
7154,7154,"'    <li class=""nav-item""><a class=""nav-link"" id=""two-link"" href=""#two"">Two</a></li>'",0.0,0,0,0
7155,7155,"'    <li class=""nav-item""><a id=""li-100-1"" class=""nav-link"" href=""#div-100-1"">div 1</a></li>'",0.0,0,0,0
7156,7156,"'    <li class=""nav-item""><a id=""li-100-2"" class=""nav-link"" href=""#div-100-2"">div 2</a></li>'",0.0,0,0,0
7157,7157,"'    <li class=""nav-item""><a id=""li-100-3"" class=""nav-link"" href=""#div-100-3"">div 3</a></li>'",0.0,0,0,0
7158,7158,"'    <li class=""nav-item""><a id=""li-100-4"" class=""nav-link"" href=""#div-100-4"">div 4</a></li>'",0.0,0,0,0
7159,7159,"'    <li class=""nav-item""><a id=""li-100-5"" class=""nav-link"" href=""#div-100-5"">div 5</a></li>'",0.0,0,0,0
7160,7160,"'    <li class=""nav-item""><a id=""li-jsm-1"" class=""nav-link"" href=""#présentation"">div 1</a></li>'",0.0,0,0,0
7161,7161,"'    <li class=""nav-item""><a id=""one-link""   class=""nav-link active"" href=""#one"">One</a></li>'",0.0,0,0,0
7162,7162,"'    <li class=""nav-item""><a id=""one-link"" class=""nav-link active"" href=""#one"">One</a></li>'",0.0,0,0,0
7163,7163,"'    <li class=""nav-item""><a id=""three-link"" class=""nav-link"" href=""#three"">Three</a></li>'",0.0,0,0,0
7164,7164,"'    <li class=""nav-item""><a id=""two-link""   class=""nav-link"" href=""#two"">Two</a></li>'",0.0,0,0,0
7165,7165,"'    <li class=""nav-item""><a id=""two-link"" class=""nav-link"" href=""#two"">Two</a></li>'",0.0,0,0,0
7166,7166,"'    <nav class=""nav nav-tabs"" role=""tablist"">'",0.0,0,0,0
7167,7167,"'    <rect width=""100%"" fill=""#563d7c""/>'",0.0,0,0,0
7168,7168,'    <select>',0.0,0,0,0
7169,7169,"'    <span id=""element-2""></span>'",0.0,0,0,0
7170,7170,'    <textarea></textarea>',0.0,0,0,0
7171,7171,"'    <ul class=""dropdown-menu"">'",0.0,0,0,0
7172,7172,'    a simple toast',0.0,0,0,0
7173,7173,'    display: none;',0.0,0,0,0
7174,7174,"'   <a class=""nav-link active"" id=""one-link"" href=""#"">One</a>'",0.0,0,0,0
7175,7175,"'   <button class=""btn"">BTN</button>'",0.0,0,0,0
7176,7176,"'   <div id=""div2""></div>'",0.0,0,0,0
7177,7177,"'   <div id=""div3""></div>'",0.0,0,0,0
7178,7178,'  .d-none {',0.0,0,0,0
7179,7179,'  </nav>',0.0,0,0,0
7180,7180,'  </summary>',0.0,0,0,0
7181,7181,'  </svg>',0.0,0,0,0
7182,7182,'  </ul>',0.0,0,0,0
7183,7183,"'  <a class=""carousel-control-prev"" href=""#myCarousel"" role=""button"" data-bs-slide=""prev""></a>'",0.0,0,0,0
7184,7184,"'  <a class=""dropdown-toggle"" data-bs-toggle=""dropdown"" href=""#testmenu"">Test menu</a>'",0.0,0,0,0
7185,7185,"'  <a href=""#"" data-bs-dismiss=""offcanvas"">Close</a>'",0.0,0,0,0
7186,7186,"'  <a href=""#"" id=""first"">first</a>'",0.0,0,0,0
7187,7187,"'  <a href=""#"" id=""inside"">inside</a>'",0.0,0,0,0
7188,7188,"'  <a href=""#"" id=""last"">last</a>'",0.0,0,0,0
7189,7189,"'  <a href=""javascript:alert(7)"" aria-label=""This is a link"" data-foo=""bar"">Click me</a>'",0.0,0,0,0
7190,7190,"'  <a id=""linkTriggerOne"" data-bs-toggle=""collapse"" data-bs-target="".collapseOne"" href=""#"" aria-expanded=""false"" aria-controls=""collapseOne""></a>'",0.0,0,0,0
7191,7191,"'  <a id=""linkTriggerTwo"" data-bs-toggle=""collapse"" data-bs-target="".collapseTwo"" href=""#"" aria-expanded=""false"" aria-controls=""collapseTwo""></a>'",0.0,0,0,0
7192,7192,"'  <a id=""next"" class=""carousel-control-next"" href=""#myCarousel"" role=""button"" data-bs-slide=""next""></a>'",0.0,0,0,0
7193,7193,"'  <a type=""button"" data-bs-dismiss=""test""></a>'",0.0,0,0,0
7194,7194,"'  <button class=""btn dropdown-toggle disabled"" data-bs-toggle=""dropdown"">Dropdown</button>'",0.0,0,0,0
7195,7195,"'  <button class=""btn dropdown-toggle visually-hidden"" data-bs-toggle=""dropdown"" aria-expanded=""false"">Dropdown</button>'",0.0,0,0,0
7196,7196,"'  <button class=""btn dropdown-toggle"" data-bs-toggle=""dropdown"" aria-expanded=""false"">Dropdown</button>'",0.0,0,0,0
7197,7197,"'  <button class=""btn dropdown-toggle"" data-bs-toggle=""dropdown"" aria-expanded=""true"">Dropdown</button>'",0.0,0,0,0
7198,7198,"'  <button class=""btn dropdown-toggle"" data-bs-toggle=""dropdown"" data-bs-auto-close=""false"">Dropdown toggle</button>'",0.0,0,0,0
7199,7199,"'  <button class=""btn dropdown-toggle"" data-bs-toggle=""dropdown"" data-bs-auto-close=""inside"">Dropdown toggle</button>'",0.0,0,0,0
7200,7200,"'  <button class=""btn dropdown-toggle"" data-bs-toggle=""dropdown"" data-bs-auto-close=""outside"">Dropdown toggle</button>'",0.0,0,0,0
7201,7201,"'  <button class=""btn dropdown-toggle"" data-bs-toggle=""dropdown"" data-bs-display=""static"">Dropdown</button>'",0.0,0,0,0
7202,7202,"'  <button class=""btn dropdown-toggle"" data-bs-toggle=""dropdown"" data-bs-offset=""10,20"">Dropdown</button>'",0.0,0,0,0
7203,7203,"'  <button class=""btn dropdown-toggle"" data-bs-toggle=""dropdown"" data-bs-placement=""right"">Dropdown</button>'",0.0,0,0,0
7204,7204,"'  <button class=""btn dropdown-toggle"" data-bs-toggle=""dropdown""></button>'",0.0,0,0,0
7205,7205,"'  <button class=""btn dropdown-toggle"" data-bs-toggle=""dropdown"">Dropdown toggle</button>'",0.0,0,0,0
7206,7206,"'  <button class=""btn dropdown-toggle"" data-bs-toggle=""dropdown"">Dropdown</button>'",0.0,0,0,0
7207,7207,"'  <button class=""btn"">Actions</button>'",0.0,0,0,0
7208,7208,"'  <button class=""carousel-control-next"" type=""button"" data-bs-target=""#carousel"" data-bs-slide=""next""></button>'",0.0,0,0,0
7209,7209,"'  <button class=""carousel-control-prev"" data-bs-target=""#myCarousel"" type=""button"" data-bs-slide=""prev""></button>'",0.0,0,0,0
7210,7210,"'  <button class=""carousel-control-prev"" type=""button"" data-bs-target=""#carousel"" data-bs-slide=""prev""></button>'",0.0,0,0,0
7211,7211,"'  <button class=""firstBtn btn"" data-bs-toggle=""dropdown"" aria-expanded=""false"">Dropdown</button>'",0.0,0,0,0
7212,7212,"'  <button class=""secondBtn btn"" data-bs-toggle=""dropdown"" aria-expanded=""false"">Dropdown</button>'",0.0,0,0,0
7213,7213,"'  <button disabled class=""btn dropdown-toggle"" data-bs-toggle=""dropdown"">Dropdown</button>'",0.0,0,0,0
7214,7214,"'  <button id=""button"" disabled=""true""></button>'",0.0,0,0,0
7215,7215,"'  <button id=""button""></button>'",0.0,0,0,0
7216,7216,"'  <button id=""button1"" disabled=""disabled""></button>'",0.0,0,0,0
7217,7217,"'  <button id=""button2"" disabled></button>'",0.0,0,0,0
7218,7218,"'  <button id=""dropdown1"" class=""btn dropdown-toggle"" data-bs-toggle=""dropdown"">Dropdown toggle</button>'",0.0,0,0,0
7219,7219,"'  <button id=""dropdown2"" class=""btn dropdown-toggle"" data-bs-toggle=""dropdown"">Dropdown toggle</button>'",0.0,0,0,0
7220,7220,"'  <button id=""next"" class=""carousel-control-next"" data-bs-target=""#myCarousel"" type=""button"" data-bs-slide=""next""></button>'",0.0,0,0,0
7221,7221,"'  <button id=""next"" class=""carousel-control-next"" type=""button"" data-bs-slide=""next""></button>'",0.0,0,0,0
7222,7222,"'  <button type=""button"" class=""ms-2 mb-1 btn-close"" data-bs-dismiss=""toast"" aria-label=""Close""></button>'",0.0,0,0,0
7223,7223,"'  <button type=""button"" data-bs-dismiss=""alert"">x</button>'",0.0,0,0,0
7224,7224,"'  <button type=""button"" data-bs-dismiss=""test"" data-bs-target=""#foo""></button>'",0.0,0,0,0
7225,7225,"'  <button type=""button"" data-bs-dismiss=""test""></button>'",0.0,0,0,0
7226,7226,"'  <button type=""button"" data-bs-target=""#home"" role=""tab"">Home</button>'",0.0,0,0,0
7227,7227,"'  <button type=""button"" data-bs-target=""#x-tab2"" class=""nav-link active"" data-bs-toggle=""tab"" role=""tab"" aria-controls=""x-tab2"" aria-selected=""true"">Tab 2</button>'",0.0,0,0,0
7228,7228,"'  <button type=""button"" data-bs-target=""#x-tab3"" class=""nav-link"" data-bs-toggle=""tab"" role=""tab"" aria-controls=""x-tab3"">Tab 3</button>'",0.0,0,0,0
7229,7229,"'  <button type=""button"" data-bs-target="".alert"" data-bs-dismiss=""alert"">x</button>'",0.0,0,0,0
7230,7230,"'  <button type=""button"" disabled data-bs-dismiss=""test""></button>'",0.0,0,0,0
7231,7231,"'  <button type=""button"" id=""tab1"" data-bs-target=""#x-tab1"" class=""nav-link"" data-bs-toggle=""tab"" role=""tab"" aria-controls=""x-tab1"">Tab 1</button>'",0.0,0,0,0
7232,7232,"'  <button type=""button"" id=""triggerProfile"" data-bs-target=""#profile"" role=""tab"">Profile</button>'",0.0,0,0,0
7233,7233,"'  <button type=""button"">test btn</button>'",0.0,0,0,0
7234,7234,"'  <div class=""accordion-header"">'",0.0,0,0,0
7235,7235,"'  <div class=""accordion-item"">'",0.0,0,0,0
7236,7236,"'  <div class=""carousel""></div>'",0.0,0,0,0
7237,7237,"'  <div class=""carousel-control-next""></div>'",0.0,0,0,0
7238,7238,"'  <div class=""carousel-control-prev""></div>'",0.0,0,0,0
7239,7239,"'  <div class=""carousel-indicators"">'",0.0,0,0,0
7240,7240,"'  <div class=""carousel-inner"">'",0.0,0,0,0
7241,7241,"'  <div class=""dropdown"" id=""testmenu"">'",0.0,0,0,0
7242,7242,"'  <div class=""dropdown"">'",0.0,0,0,0
7243,7243,"'  <div class=""dropdown-menu dropdown-menu-end"">'",0.0,0,0,0
7244,7244,"'  <div class=""dropdown-menu show"">'",0.0,0,0,0
7245,7245,"'  <div class=""fixed"" id=""fixed"" style=""width: 100vw;""></div>'",0.0,0,0,0
7246,7246,"'  <div class=""fixed-top"" id=""fixed1"" style=""padding-right: 0px; width: 100vw""></div>'",0.0,0,0,0
7247,7247,"'  <div class=""fixed-top"" id=""fixed2"" style=""padding-right: 5px; width: 100vw""></div>'",0.0,0,0,0
7248,7248,"'  <div class=""list-group"">'",0.0,0,0,0
7249,7249,"'  <div class=""modal-dialog"">'",0.0,0,0,0
7250,7250,"'  <div class=""modal-dialog""></div>'",0.0,0,0,0
7251,7251,"'  <div class=""nested""></div>'",0.0,0,0,0
7252,7252,"'  <div class=""row"">'",0.0,0,0,0
7253,7253,"'  <div class=""sticky-top"" id=""sticky"" style="" width: 100vw;""></div>'",0.0,0,0,0
7254,7254,"'  <div class=""sticky-top"" id=""sticky"" style=""width: 100vw""></div>'",0.0,0,0,0
7255,7255,"'  <div class=""sticky-top"" style=""margin-right: 10px; padding-right: 20px; width: 100vw; height: 10px""></div>'",0.0,0,0,0
7256,7256,"'  <div class=""tab-content"" id=""page_content"">'",0.0,0,0,0
7257,7257,"'  <div class=""tab-pane active"" id=""home"" role=""tabpanel""></div>'",0.0,0,0,0
7258,7258,"'  <div class=""tab-pane active"" id=""x-tab2"" role=""tabpanel"">Tab2 Content</div>'",0.0,0,0,0
7259,7259,"'  <div class=""tab-pane fade"" id=""2"">'",0.0,0,0,0
7260,7260,"'  <div class=""tab-pane fade"" id=""home"" role=""tabpanel""></div>'",0.0,0,0,0
7261,7261,"'  <div class=""tab-pane fade"" id=""profile"" role=""tabpanel""></div>'",0.0,0,0,0
7262,7262,"'  <div class=""tab-pane"" id=""profile"" role=""tabpanel""></div>'",0.0,0,0,0
7263,7263,"'  <div class=""tab-pane"" id=""x-tab1"" role=""tabpanel"">'",0.0,0,0,0
7264,7264,"'  <div class=""tab-pane"" id=""x-tab3"" role=""tabpanel"">Tab3 Content</div>'",0.0,0,0,0
7265,7265,"'  <div class=""toast-body"">'",0.0,0,0,0
7266,7266,"'  <div class=""topbar"">'",0.0,0,0,0
7267,7267,"'  <div id=""1"" style=""height: 300px;"">test</div>'",0.0,0,0,0
7268,7268,"'  <div id=""childContent""></div>'",0.0,0,0,0
7269,7269,"'  <div id=""childContent"">Tooltip</div>'",0.0,0,0,0
7270,7270,"'  <div id=""collapse1"" class=""collapse""></div>'",0.0,0,0,0
7271,7271,"'  <div id=""collapse2"" class=""collapse show""></div>'",0.0,0,0,0
7272,7272,"'  <div id=""collapseOneOne"" class=""collapse collapseOne"" role=""tabpanel"" data-bs-parent=""#accordion""></div>'",0.0,0,0,0
7273,7273,"'  <div id=""collapseOneTwo"" class=""collapse collapseOne"" role=""tabpanel"" data-bs-parent=""#accordion""></div>'",0.0,0,0,0
7274,7274,"'  <div id=""collapseTwoOne"" class=""collapse collapseTwo"" role=""tabpanel"" data-bs-parent=""#accordion""></div>'",0.0,0,0,0
7275,7275,"'  <div id=""collapseTwoTwo"" class=""collapse collapseTwo"" role=""tabpanel"" data-bs-parent=""#accordion""></div>'",0.0,0,0,0
7276,7276,"'  <div id=""div-1"" style=""height: 100px; padding: 0; margin: 0"">div 1</div>'",0.0,0,0,0
7277,7277,"'  <div id=""div-100-1"" style=""position: relative; height: 100%; padding: 0; margin: 0"">div 1</div>'",0.0,0,0,0
7278,7278,"'  <div id=""div-100-2"" style=""position: relative; height: 100%; padding: 0; margin: 0"">div 2</div>'",0.0,0,0,0
7279,7279,"'  <div id=""div-100-3"" style=""position: relative; height: 100%; padding: 0; margin: 0"">div 3</div>'",0.0,0,0,0
7280,7280,"'  <div id=""div-100-4"" style=""position: relative; height: 100%; padding: 0; margin: 0"">div 4</div>'",0.0,0,0,0
7281,7281,"'  <div id=""div-100-5"" style=""position: relative; height: 100%; padding: 0; margin: 0"">div 5</div>'",0.0,0,0,0
7282,7282,"'  <div id=""div-2"" style=""height: 200px; padding: 0; margin: 0"">div 2</div>'",0.0,0,0,0
7283,7283,"'  <div id=""div-jsm-1"">div 1</div>'",0.0,0,0,0
7284,7284,"'  <div id=""element"" class=""disabled""></div>'",0.0,0,0,0
7285,7285,"'  <div id=""element"" disabled=""disabled""></div>'",0.0,0,0,0
7286,7286,"'  <div id=""element"" disabled=""false""></div>'",0.0,0,0,0
7287,7287,"'  <div id=""element""></div>'",0.0,0,0,0
7288,7288,"'  <div id=""element1"" ></div>'",0.0,0,0,0
7289,7289,"'  <div id=""element1"" disabled=""true""></div>'",0.0,0,0,0
7290,7290,"'  <div id=""element2"" disabled></div>'",0.0,0,0,0
7291,7291,"'  <div id=""home"" role=""tabpanel""></div>'",0.0,0,0,0
7292,7292,"'  <div id=""menu1"" class=""dropdown-menu"">'",0.0,0,0,0
7293,7293,"'  <div id=""menu2"" class=""dropdown-menu"">'",0.0,0,0,0
7294,7294,"'  <div id=""next"" data-bs-target=""#myCarousel"" data-bs-slide-to=""1""></div>'",0.0,0,0,0
7295,7295,"'  <div id=""one"" style=""height: 100px;"">test</div>'",0.0,0,0,0
7296,7296,"'  <div id=""one"" style=""height: 100px;"">text</div>'",0.0,0,0,0
7297,7297,"'  <div id=""one"" style=""height: 300px;"">test</div>'",0.0,0,0,0
7298,7298,"'  <div id=""one-link"">test</div>'",0.0,0,0,0
7299,7299,"'  <div id=""parentContent"" class=""accordion-collapse collapse"" data-bs-parent=""#parentGroup"">'",0.0,0,0,0
7300,7300,"'  <div id=""profile"" role=""tabpanel""></div>'",0.0,0,0,0
7301,7301,"'  <div id=""présentation"">div 1</div>'",0.0,0,0,0
7302,7302,"'  <div id=""scrollspy-example"" style=""height: 100px; overflow: auto;"">'",0.0,0,0,0
7303,7303,"'  <div id=""spacer"" style=""height: 100px;""></div>'",0.0,0,0,0
7304,7304,"'  <div id=""spacer"" style=""height: 100px;"">test</div>'",0.0,0,0,0
7305,7305,"'  <div id=""spacer"" style=""height: 200px;""></div>'",0.0,0,0,0
7306,7306,"'  <div id=""three""  style=""display: none;"">test</div>'",0.0,0,0,0
7307,7307,"'  <div id=""three"" style=""height: 100px;"">test</div>'",0.0,0,0,0
7308,7308,"'  <div id=""three"" style=""height: 100px;"">text</div>'",0.0,0,0,0
7309,7309,"'  <div id=""three"" style=""height: 10px;"">test2</div>'",0.0,0,0,0
7310,7310,"'  <div id=""two"" hidden style=""height: 300px;"">test</div>'",0.0,0,0,0
7311,7311,"'  <div id=""two"" style=""height: 100px;"">test</div>'",0.0,0,0,0
7312,7312,"'  <div id=""two"" style=""height: 100px;"">text</div>'",0.0,0,0,0
7313,7313,"'  <div id=""two"" style=""height: 300px;"">test</div>'",0.0,0,0,0
7314,7314,"'  <div role=""tabpanel"" class=""tab-pane fade show active"" id=""profile"">test 1</div>'",0.0,0,0,0
7315,7315,"'  <div role=""tabpanel"" class=""tab-pane fade"" id=""buzz"">test 2</div>'",0.0,0,0,0
7316,7316,"'  <div role=""tabpanel"" class=""tab-pane fade"" id=""home"">test 1</div>'",0.0,0,0,0
7317,7317,"'  <div role=""tabpanel"" class=""tab-pane fade"" id=""profile"">test 2</div>'",0.0,0,0,0
7318,7318,"'  <div role=""tabpanel"" class=""tab-pane fade"" id=""references"">test 3</div>'",0.0,0,0,0
7319,7319,"'  <div role=""tabpanel"" class=""tab-pane"" id=""home"">test 1</div>'",0.0,0,0,0
7320,7320,"'  <div role=""tabpanel"" class=""tab-pane"" id=""profile"">test 2</div>'",0.0,0,0,0
7321,7321,"'  <div style=""visibility: visible;"">'",0.0,0,0,0
7322,7322,'  <div>',0.0,0,0,0
7323,7323,"'  <input id=""input"" class=""disabled"" disabled=""false"">'",0.0,0,0,0
7324,7324,"'  <input id=""input"" disabled=""disabled"">'",0.0,0,0,0
7325,7325,"'  <input id=""input1"" disabled=""disabled"">'",0.0,0,0,0
7326,7326,"'  <li class=""nav-item"" role=""presentation""><a href=""#home"" class=""nav-link active"" role=""tab"" aria-selected=""true"">Home</a></li>'",0.0,0,0,0
7327,7327,"'  <li class=""nav-item"" role=""presentation""><a href=""#profile"" class=""nav-link disabled"" role=""tab"">Profile</a></li>'",0.0,0,0,0
7328,7328,"'  <li class=""nav-item"" role=""presentation""><button type=""button"" data-bs-target=""#home"" class=""nav-link active"" role=""tab"" aria-selected=""true"">Home</button></li>'",0.0,0,0,0
7329,7329,"'  <li class=""nav-item"" role=""presentation""><button type=""button"" data-bs-target=""#profile"" class=""nav-link"" disabled role=""tab"">Profile</button></li>'",0.0,0,0,0
7330,7330,"'  <li class=""nav-item"" role=""presentation""><button type=""button"" data-bs-target=""#profile"" class=""nav-link"" role=""tab"">Profile</button></li>'",0.0,0,0,0
7331,7331,"'  <li class=""nav-item"" role=""presentation""><button type=""button"" id=""tab-home"" data-bs-target=""#home"" class=""nav-link"" data-bs-toggle=""tab"" role=""tab"">Home</button></li>'",0.0,0,0,0
7332,7332,"'  <li class=""nav-item"" role=""presentation""><button type=""button"" id=""tab-profile"" data-bs-target=""#profile"" class=""nav-link"" data-bs-toggle=""tab"" role=""tab"">Profile</button></li>'",0.0,0,0,0
7333,7333,"'  <li class=""nav-item"" role=""presentation""><button type=""button"" id=""triggerProfile"" data-bs-target=""#profile"" class=""nav-link"" role=""tab"">Profile</button></li>'",0.0,0,0,0
7334,7334,"'  <li class=""nav-item"" role=""presentation""><button type=""button"" id=""triggerProfile"" data-bs-toggle=""tab"" data-bs-target=""#profile"" class=""nav-link"" role=""tab"">Profile</button></li>'",0.0,0,0,0
7335,7335,"'  <li class=""nav-item""><a class=""nav-link active"" href=""#home"" data-bs-toggle=""tab"">Home</a></li>'",0.0,0,0,0
7336,7336,"'  <li class=""nav-item""><a class=""nav-link"" href=""#home"" data-bs-toggle=""tab"">Home</a></li>'",0.0,0,0,0
7337,7337,"'  <li class=""nav-item""><a class=""nav-link"" href=""#profile"" data-bs-toggle=""tab"">Profile</a></li>'",0.0,0,0,0
7338,7338,"'  <li class=""nav-link"" data-bs-target=""#panel2""></li>'",0.0,0,0,0
7339,7339,"'  <li class=""nav-link"" data-bs-toggle=""tab""></li>'",0.0,0,0,0
7340,7340,"'  <li class=""nav-link"" id=""foo"" data-bs-target=""#panel""></li>'",0.0,0,0,0
7341,7341,"'  <li class=""nav-link""></li>'",0.0,0,0,0
7342,7342,"'  <li id=""home"" role=""tabpanel""></li>'",0.0,0,0,0
7343,7343,"'  <li id=""home""></li>'",0.0,0,0,0
7344,7344,"'  <li id=""profile"" role=""tabpanel""></li>'",0.0,0,0,0
7345,7345,'  <li>',0.0,0,0,0
7346,7346,"'  <li><a href=""#home"" role=""tab"">Home</a></li>'",0.0,0,0,0
7347,7347,"'  <li><a id=""triggerProfile"" href=""#profile"" role=""tab"">Profile</a></li>'",0.0,0,0,0
7348,7348,"'  <li><a type=""button"" href=""#test""  class=""active"" role=""tab"" data-bs-toggle=""tab"">Home</a></li>'",0.0,0,0,0
7349,7349,"'  <li><a type=""button"" href=""#test2"" role=""tab"" data-bs-toggle=""tab"">Home</a></li>'",0.0,0,0,0
7350,7350,"'  <li><button type=""button"" data-bs-target=""#home"" role=""tab"">Home</button></li>'",0.0,0,0,0
7351,7351,"'  <li><button type=""button"" data-bs-target=""#profile"" role=""tab"">Profile</button></li>'",0.0,0,0,0
7352,7352,"'  <li><button type=""button"" id=""home"" data-bs-target=""#home"" role=""tab"">Home</button></li>'",0.0,0,0,0
7353,7353,"'  <li><button type=""button"" id=""triggerProfile"" data-bs-target=""#profile"" role=""tab"">Profile</button></li>'",0.0,0,0,0
7354,7354,"'  <li><button type=""button"" id=""triggerProfile"" href=""#profile"" role=""tab"">Profile</button></li>'",0.0,0,0,0
7355,7355,"'  <nav class=""nav"">'",0.0,0,0,0
7356,7356,'  <script>alert(7)</script>',0.0,0,0,0
7357,7357,"'  <select id=""input"" disabled></select>'",0.0,0,0,0
7358,7358,"'  <select id=""input""></select>'",0.0,0,0,0
7359,7359,"'  <select id=""select"" disabled></select>'",0.0,0,0,0
7360,7360,"'  <select id=""select""></select>'",0.0,0,0,0
7361,7361,"'  <span class=""test"">Some content</span>'",0.0,0,0,0
7362,7362,"'  <span id=""nested""></span>'",0.0,0,0,0
7363,7363,"'  <span id=""tab1"" class=""nav-link"" data-bs-toggle=""tab""></span>'",0.0,0,0,0
7364,7364,"'  <span id=""tab2"" class=""nav-link"" data-bs-toggle=""tab"" disabled></span>'",0.0,0,0,0
7365,7365,"'  <span id=""tab2"" class=""nav-link"" data-bs-toggle=""tab""></span>'",0.0,0,0,0
7366,7366,"'  <span id=""tab3"" class=""nav-link disabled"" data-bs-toggle=""tab""></span>'",0.0,0,0,0
7367,7367,"'  <span id=""tab3"" class=""nav-link"" data-bs-toggle=""tab""></span>'",0.0,0,0,0
7368,7368,"'  <span id=""tab4"" class=""nav-link"" data-bs-toggle=""tab""></span>'",0.0,0,0,0
7369,7369,'  <span>Some content</span>',0.0,0,0,0
7370,7370,"'  <summary id=""element-1"">'",0.0,0,0,0
7371,7371,"'  <svg xmlns=""http://www.w3.org/2000/svg"" width=""50"" height=""50"" viewBox=""0 0 100 100"">'",0.0,0,0,0
7372,7372,"'  <ul class=""nav nav-tabs card-header-tabs"" id=""page_tabs"">'",0.0,0,0,0
7373,7373,"'  <ul class=""nav"">'",0.0,0,0,0
7374,7374,"'  <ul class=""navbar-nav"">'",0.0,0,0,0
7375,7375,'  body {',0.0,0,0,0
7376,7376,'  }',0.0,0,0,0
7377,7377,' </div>',0.0,0,0,0
7378,7378,"' <div class=""modal-dialog"">'",0.0,0,0,0
7379,7379,' \n Java\n Script:abc',0.0,0,0,0
7380,7380,' javascript:abc',0.0,0,0,0
7381,7381,' pizza ',0.0,0,0,0
7382,7382,' | ',0.0,0,0,0
7383,7383,"'!!window.next.router.components[""/dashboard""]'",0.0,0,0,0
7384,7384,"'""TestComponent.getInitialProps()"" is defined as an instance method - visit https://nextjs.org/docs/messages/get-initial-props-as-an-instance-method for more information.'",0.0,0,0,0
7385,7385,"'""TestComponent.getInitialProps()"" should resolve to an object. But found ""undefined"" instead.'",0.0,0,0,0
7386,7386,"'""_directionToOrder"" and ""_orderToDirection"" must return the right results when rtl=true'",0.0,0,0,0
7387,7387,"'""_directionToOrder"" and ""_orderToDirection"" must return the right results'",0.0,0,0,0
7388,7388,"'""_slide"" has to call ""_directionToOrder"" and ""_orderToDirection"" when rtl=true'",0.0,0,0,0
7389,7389,"'""_slide"" has to call _directionToOrder and ""_orderToDirection""'",0.0,0,0,0
7390,7390,"'""another""'",0.0,0,0,0
7391,7391,"'""foo""'",0.0,0,0,0
7392,7392,"'""isFallback"":false'",0.0,0,0,0
7393,7393,"'""isFallback"":true'",0.0,0,0,0
7394,7394,"'""next_streaming_data""'",0.0,0,0,0
7395,7395,"'""noindex""'",0.0,0,0,0
7396,7396,"'""pages/404.html""'",0.0,0,0,0
7397,7397,"'""setContent"" should keep the initial template'",0.0,0,0,0
7398,7398,"'""something""'",0.0,0,0,0
7399,7399,'#!/Api%20%E7%BB%84%E4%BB%B6',0.0,0,0,0
7400,7400,'#!/Button',0.0,0,0,0
7401,7401,'#!/Button/1',0.0,0,0,0
7402,7402,'#!/Section',0.0,0,0,0
7403,7403,'#!/Section/1',0.0,0,0,0
7404,7404,'#$b()tn',0.0,0,0,0
7405,7405,'#',0.0,0,0,0
7406,7406,'#/',0.0,0,0,0
7407,7407,'#About',0.0,0,0,0
7408,7408,'#Closed',0.0,0,0,0
7409,7409,'#Opened',0.0,0,0,0
7410,7410,'#_internal',0.0,0,0,0
7411,7411,'#a-2',0.0,0,0,0
7412,7412,'#about-page',0.0,0,0,0
7413,7413,'#absolute-link',0.0,0,0,0
7414,7414,'#add3',0.0,0,0,0
7415,7415,'#after-change',0.0,0,0,0
7416,7416,'#ancestor',0.0,0,0,0
7417,7417,'#anchor',0.0,0,0,0
7418,7418,'#anchor-2',0.0,0,0,0
7419,7419,'#anchor-text',0.0,0,0,0
7420,7420,'#another-middleware',0.0,0,0,0
7421,7421,'#app-client-comp',0.0,0,0,0
7422,7422,'#app-client-layout',0.0,0,0,0
7423,7423,'#app-client-page',0.0,0,0,0
7424,7424,'#app-comp',0.0,0,0,0
7425,7425,'#app-layout',0.0,0,0,0
7426,7426,'#app-legacy-edge-layout',0.0,0,0,0
7427,7427,'#app-legacy-edge-page',0.0,0,0,0
7428,7428,'#app-legacy-layout',0.0,0,0,0
7429,7429,'#app-legacy-page',0.0,0,0,0
7430,7430,'#app-link',0.0,0,0,0
7431,7431,'#app-nested-comp',0.0,0,0,0
7432,7432,'#app-nested-layout',0.0,0,0,0
7433,7433,'#app-nested-page',0.0,0,0,0
7434,7434,'#app-open-sans',0.0,0,0,0
7435,7435,'#app-query',0.0,0,0,0
7436,7436,'#app-url',0.0,0,0,0
7437,7437,'#asPath',0.0,0,0,0
7438,7438,'#audience-home',0.0,0,0,0
7439,7439,'#author-1-post-1',0.0,0,0,0
7440,7440,'#author-2',0.0,0,0,0
7441,7441,'#b_hist',0.0,0,0,0
7442,7442,'#back-button',0.0,0,0,0
7443,7443,'#base-path',0.0,0,0,0
7444,7444,'#basic',0.0,0,0,0
7445,7445,'#before-catchall > .segment',0.0,0,0,0
7446,7446,'#before-catchall > .segments',0.0,0,0,0
7447,7447,'#before-param > .segment',0.0,0,0,0
7448,7448,'#before-param > .segments',0.0,0,0,0
7449,7449,'#before-static > .segment',0.0,0,0,0
7450,7450,'#before-static > .segments',0.0,0,0,0
7451,7451,'#blog-post-page',0.0,0,0,0
7452,7452,'#broken-post',0.0,0,0,0
7453,7453,'#btn',0.0,0,0,0
7454,7454,'#btn2',0.0,0,0,0
7455,7455,'#btnClose',0.0,0,0,0
7456,7456,'#button',0.0,0,0,0
7457,7457,'#button-a',0.0,0,0,0
7458,7458,'#button-b',0.0,0,0,0
7459,7459,'#button-c',0.0,0,0,0
7460,7460,'#button-to-h3-hash-only',0.0,0,0,0
7461,7461,'#button1',0.0,0,0,0
7462,7462,'#button2',0.0,0,0,0
7463,7463,'#cameraOff',0.0,0,0,0
7464,7464,'#carousel',0.0,0,0,0
7465,7465,'#catchall-explicit-object',0.0,0,0,0
7466,7466,'#catchall-explicit-string',0.0,0,0,0
7467,7467,'#catchall-intercept-page',0.0,0,0,0
7468,7468,'#catchall-link',0.0,0,0,0
7469,7469,'#catchall-optional-root',0.0,0,0,0
7470,7470,'#catchall-optional-value',0.0,0,0,0
7471,7471,'#catchall-regular-page',0.0,0,0,0
7472,7472,'#catchall-slug-slug',0.0,0,0,0
7473,7473,'#category-id',0.0,0,0,0
7474,7474,'#category-layout-params',0.0,0,0,0
7475,7475,'#childContent1',0.0,0,0,0
7476,7476,'#childContent2',0.0,0,0,0
7477,7477,'#childElement',0.0,0,0,0
7478,7478,'#children-foo',0.0,0,0,0
7479,7479,'#children-slot',0.0,0,0,0
7480,7480,'#client-comp',0.0,0,0,0
7481,7481,'#client-inc',0.0,0,0,0
7482,7482,'#client-layout',0.0,0,0,0
7483,7483,'#client-page',0.0,0,0,0
7484,7484,'#client-react',0.0,0,0,0
7485,7485,'#client-react-dom',0.0,0,0,0
7486,7486,'#client-react-dom-server',0.0,0,0,0
7487,7487,'#collapse1',0.0,0,0,0
7488,7488,'#collapse2',0.0,0,0,0
7489,7489,'#collapseOne',0.0,0,0,0
7490,7490,'#collapseOneOne',0.0,0,0,0
7491,7491,'#collapseOneTwo',0.0,0,0,0
7492,7492,'#collapseTwo',0.0,0,0,0
7493,7493,'#collapseTwoOne',0.0,0,0,0
7494,7494,'#collapseTwoTwo',0.0,0,0,0
7495,7495,'#collapsediv1',0.0,0,0,0
7496,7496,'#comp-with-fonts-inter',0.0,0,0,0
7497,7497,'#comp-with-fonts-roboto',0.0,0,0,0
7498,7498,'#content',0.0,0,0,0
7499,7499,'#content-that-is-visible',0.0,0,0,0
7500,7500,'#cookie',0.0,0,0,0
7501,7501,'#cookies',0.0,0,0,0
7502,7502,'#data-url-cached',0.0,0,0,0
7503,7503,'#data-url-default-cache',0.0,0,0,0
7504,7504,'#data-url-no-cache',0.0,0,0,0
7505,7505,'#data-value-cached',0.0,0,0,0
7506,7506,'#data-value-default-cache',0.0,0,0,0
7507,7507,'#dec',0.0,0,0,0
7508,7508,'#default-parallel',0.0,0,0,0
7509,7509,'#default-slot',0.0,0,0,0
7510,7510,'#demographics',0.0,0,0,0
7511,7511,'#demographics-link',0.0,0,0,0
7512,7512,'#destroy',0.0,0,0,0
7513,7513,'#div-1',0.0,0,0,0
7514,7514,'#div-100-1',0.0,0,0,0
7515,7515,'#div-100-3',0.0,0,0,0
7516,7516,'#div-100-5',0.0,0,0,0
7517,7517,'#div-2',0.0,0,0,0
7518,7518,'#div-jsm-1',0.0,0,0,0
7519,7519,'#div1',0.0,0,0,0
7520,7520,'#div2',0.0,0,0,0
7521,7521,'#done',0.0,0,0,0
7522,7522,'#double',0.0,0,0,0
7523,7523,'#draft-mode-val',0.0,0,0,0
7524,7524,'#dropdown1',0.0,0,0,0
7525,7525,'#dropdown2',0.0,0,0,0
7526,7526,'#dynamic-first',0.0,0,0,0
7527,7527,'#dynamic-first-second',0.0,0,0,0
7528,7528,'#dynamic-hello',0.0,0,0,0
7529,7529,'#dynamic-layout-params',0.0,0,0,0
7530,7530,'#dynamic-link',0.0,0,0,0
7531,7531,'#dynamic-second',0.0,0,0,0
7532,7532,'#eee',0.0,0,0,0
7533,7533,'#element',0.0,0,0,0
7534,7534,'#element-1',0.0,0,0,0
7535,7535,'#element-2',0.0,0,0,0
7536,7536,'#element1',0.0,0,0,0
7537,7537,'#element2',0.0,0,0,0
7538,7538,'#end',0.0,0,0,0
7539,7539,'#error',0.0,0,0,0
7540,7540,'#error-component',0.0,0,0,0
7541,7541,'#error-route',0.0,0,0,0
7542,7542,'#external-link',0.0,0,0,0
7543,7543,'#fail',0.0,0,0,0
7544,7544,'#final > .segment',0.0,0,0,0
7545,7545,'#final > .segments',0.0,0,0,0
7546,7546,'#first-local-font',0.0,0,0,0
7547,7547,'#first-page',0.0,0,0,0
7548,7548,'#firstIndicator',0.0,0,0,0
7549,7549,'#fixed',0.0,0,0,0
7550,7550,'#fixed1',0.0,0,0,0
7551,7551,'#fixed2',0.0,0,0,0
7552,7552,'#fixture .pointer-event { touch-action: none !important; }',0.0,0,0,0
7553,7553,'#fixture',0.0,0,0,0
7554,7554,'#foo',0.0,0,0,0
7555,7555,'#forward-button',0.0,0,0,0
7556,7556,'#from-navigation',0.0,0,0,0
7557,7557,'#get-header',0.0,0,0,0
7558,7558,'#get-headers',0.0,0,0,0
7559,7559,'#go',0.0,0,0,0
7560,7560,'#goto-home',0.0,0,0,0
7561,7561,'#goto-next-link',0.0,0,0,0
7562,7562,'#goto-streaming-rsc',0.0,0,0,0
7563,7563,'#gsp',0.0,0,0,0
7564,7564,'#gsp-link',0.0,0,0,0
7565,7565,'#gssp',0.0,0,0,0
7566,7566,'#gssp-link',0.0,0,0,0
7567,7567,'#h1',0.0,0,0,0
7568,7568,'#h3',0.0,0,0,0
7569,7569,'#hash-change',0.0,0,0,0
7570,7570,'#header',0.0,0,0,0
7571,7571,'#header-a',0.0,0,0,0
7572,7572,'#header-b',0.0,0,0,0
7573,7573,'#header-c',0.0,0,0,0
7574,7574,'#header-empty',0.0,0,0,0
7575,7575,'#headers',0.0,0,0,0
7576,7576,'#home-link-audience',0.0,0,0,0
7577,7577,'#home-page',0.0,0,0,0
7578,7578,'#id-layout-params',0.0,0,0,0
7579,7579,'#id-page-params',0.0,0,0,0
7580,7580,'#impressions',0.0,0,0,0
7581,7581,'#impressions-link',0.0,0,0,0
7582,7582,'#index',0.0,0,0,0
7583,7583,'#index-gsp',0.0,0,0,0
7584,7584,'#inner-basic-route',0.0,0,0,0
7585,7585,'#input1',0.0,0,0,0
7586,7586,'#intercepted',0.0,0,0,0
7587,7587,'#interception-slot',0.0,0,0,0
7588,7588,'#isAmp',0.0,0,0,0
7589,7589,'#item',0.0,0,0,0
7590,7590,'#item1',0.0,0,0,0
7591,7591,'#item2',0.0,0,0,0
7592,7592,'#item3',0.0,0,0,0
7593,7593,'#layout-message',0.0,0,0,0
7594,7594,'#li-100-1',0.0,0,0,0
7595,7595,'#li-100-3',0.0,0,0,0
7596,7596,'#li-100-5',0.0,0,0,0
7597,7597,'#link-back',0.0,0,0,0
7598,7598,'#link-to-deduping-page',0.0,0,0,0
7599,7599,'#link-to-dummy-query',0.0,0,0,0
7600,7600,'#link-to-h2-with-hash-and-query',0.0,0,0,0
7601,7601,'#link-to-home',0.0,0,0,0
7602,7602,'#link-to-info-123',0.0,0,0,0
7603,7603,'#link-with-rewritten-url',0.0,0,0,0
7604,7604,'#link1',0.0,0,0,0
7605,7605,'#link2',0.0,0,0,0
7606,7606,'#linkTrigger',0.0,0,0,0
7607,7607,'#linkTriggerOne',0.0,0,0,0
7608,7608,'#linkTriggerTwo',0.0,0,0,0
7609,7609,'#loaded',0.0,0,0,0
7610,7610,'#loading-component',0.0,0,0,0
7611,7611,'#loading-layout',0.0,0,0,0
7612,7612,'#loading-page',0.0,0,0,0
7613,7613,'#lvl1-layout',0.0,0,0,0
7614,7614,'#lvl2-layout > div',0.0,0,0,0
7615,7615,'#lvl2-param1',0.0,0,0,0
7616,7616,'#lvl2-params',0.0,0,0,0
7617,7617,'#lvl3-layout > div',0.0,0,0,0
7618,7618,'#lvl3-param1',0.0,0,0,0
7619,7619,'#lvl3-param2',0.0,0,0,0
7620,7620,'#menu1',0.0,0,0,0
7621,7621,'#menu2',0.0,0,0,0
7622,7622,'#message',0.0,0,0,0
7623,7623,'#minus-one',0.0,0,0,0
7624,7624,'#modal1',0.0,0,0,0
7625,7625,'#modal2',0.0,0,0,0
7626,7626,'#mode',0.0,0,0,0
7627,7627,'#myimg',0.0,0,0,0
7628,7628,'#nabla',0.0,0,0,0
7629,7629,'#nav-home',0.0,0,0,0
7630,7630,'#nav1 .dropdown-item',0.0,0,0,0
7631,7631,'#nav1 .dropdown-toggle',0.0,0,0,0
7632,7632,'#nav2 .dropdown-item',0.0,0,0,0
7633,7633,'#nav2 .dropdown-toggle',0.0,0,0,0
7634,7634,'#navBar',0.0,0,0,0
7635,7635,'#navigation',0.0,0,0,0
7636,7636,'#nested',0.0,0,0,0
7637,7637,'#nested-deeper-main',0.0,0,0,0
7638,7638,'#nested-deeper-sidebar',0.0,0,0,0
7639,7639,'#nested-main',0.0,0,0,0
7640,7640,'#nested-route-group',0.0,0,0,0
7641,7641,'#nested-sidebar',0.0,0,0,0
7642,7642,'#nestedCollapseOne',0.0,0,0,0
7643,7643,'#nestedLinkTrigger',0.0,0,0,0
7644,7644,'#next',0.0,0,0,0
7645,7645,'#non-existent-link',0.0,0,0,0
7646,7646,'#non-json',0.0,0,0,0
7647,7647,'#normal',0.0,0,0,0
7648,7648,'#not-a-page',0.0,0,0,0
7649,7649,'#nowhere',0.0,0,0,0
7650,7650,'#offcanvas',0.0,0,0,0
7651,7651,'#offcanvas1',0.0,0,0,0
7652,7652,'#offcanvas2',0.0,0,0,0
7653,7653,'#offcanvasdiv1',0.0,0,0,0
7654,7654,'#one',0.0,0,0,0
7655,7655,'#optional-catchall-intercept-page',0.0,0,0,0
7656,7656,'#optional-catchall-regular-page',0.0,0,0,0
7657,7657,'#other-page',0.0,0,0,0
7658,7658,'#other-page-link',0.0,0,0,0
7659,7659,'#other-page-title',0.0,0,0,0
7660,7660,'#override-with-external-rewrite',0.0,0,0,0
7661,7661,'#page-2',0.0,0,0,0
7662,7662,'#page-layout-segment',0.0,0,0,0
7663,7663,'#page-layout-segments',0.0,0,0,0
7664,7664,'#page-message',0.0,0,0,0
7665,7665,'#page-with-same-font',0.0,0,0,0
7666,7666,'#page2',0.0,0,0,0
7667,7667,'#pages-link',0.0,0,0,0
7668,7668,'#panel',0.0,0,0,0
7669,7669,'#panel2',0.0,0,0,0
7670,7670,'#parallel-foo',0.0,0,0,0
7671,7671,'#parallel-one',0.0,0,0,0
7672,7672,'#parallel-one-inner',0.0,0,0,0
7673,7673,'#parallel-subroute',0.0,0,0,0
7674,7674,'#parallel-two',0.0,0,0,0
7675,7675,'#param-id2',0.0,0,0,0
7676,7676,'#params-and-query',0.0,0,0,0
7677,7677,'#params-first',0.0,0,0,0
7678,7678,'#params-not-real',0.0,0,0,0
7679,7679,'#params-second',0.0,0,0,0
7680,7680,'#params-third',0.0,0,0,0
7681,7681,'#parent',0.0,0,0,0
7682,7682,'#parentContent',0.0,0,0,0
7683,7683,'#photo-intercepted-1',0.0,0,0,0
7684,7684,'#photo-modal-1',0.0,0,0,0
7685,7685,'#photo-modal-2',0.0,0,0,0
7686,7686,'#photo-page-1',0.0,0,0,0
7687,7687,'#photo-page-2',0.0,0,0,0
7688,7688,'#post-page',0.0,0,0,0
7689,7689,'#présentation',0.0,0,0,0
7690,7690,'#pure-client',0.0,0,0,0
7691,7691,'#push',0.0,0,0,0
7692,7692,'#random',0.0,0,0,0
7693,7693,'#redirect',0.0,0,0,0
7694,7694,'#redirect-a',0.0,0,0,0
7695,7695,'#redirect-external',0.0,0,0,0
7696,7696,'#redirect-middleware',0.0,0,0,0
7697,7697,'#refresh-page',0.0,0,0,0
7698,7698,'#refreshed',0.0,0,0,0
7699,7699,'#render-id',0.0,0,0,0
7700,7700,'#render-id-123',0.0,0,0,0
7701,7701,'#replace',0.0,0,0,0
7702,7702,'#reset',0.0,0,0,0
7703,7703,'#resolved-url',0.0,0,0,0
7704,7704,'#result',0.0,0,0,0
7705,7705,'#return-null-layout',0.0,0,0,0
7706,7706,'#return-undefined-layout',0.0,0,0,0
7707,7707,'#rewrite-to-afterfiles-rewrite',0.0,0,0,0
7708,7708,'#rewrite-to-beforefiles-rewrite',0.0,0,0,0
7709,7709,'#root > .segment',0.0,0,0,0
7710,7710,'#root > .segments',0.0,0,0,0
7711,7711,'#root',0.0,0,0,0
7712,7712,'#root-comp',0.0,0,0,0
7713,7713,'#root-layout',0.0,0,0,0
7714,7714,'#root-page',0.0,0,0,0
7715,7715,'#route-group',0.0,0,0,0
7716,7716,'#router-sub-page',0.0,0,0,0
7717,7717,'#scroll-to-name-item-400-no-scroll',0.0,0,0,0
7718,7718,'#scrollspy-example',0.0,0,0,0
7719,7719,'#second-local-font',0.0,0,0,0
7720,7720,'#second-page',0.0,0,0,0
7721,7721,'#secondIndicator',0.0,0,0,0
7722,7722,'#secondItem',0.0,0,0,0
7723,7723,'#secondNav',0.0,0,0,0
7724,7724,'#select',0.0,0,0,0
7725,7725,'#server-inc',0.0,0,0,0
7726,7726,'#setCookie',0.0,0,0,0
7727,7727,'#sibling_descendant',0.0,0,0,0
7728,7728,'#sidebar-main',0.0,0,0,0
7729,7729,'#size-1mb',0.0,0,0,0
7730,7730,'#size-2mb',0.0,0,0,0
7731,7731,'#slow-layout-message',0.0,0,0,0
7732,7732,'#slow-page-message',0.0,0,0,0
7733,7733,'#slow-route',0.0,0,0,0
7734,7734,'#slug-page',0.0,0,0,0
7735,7735,'#something',0.0,0,0,0
7736,7736,'#something-query',0.0,0,0,0
7737,7737,'#ss-target',0.0,0,0,0
7738,7738,'#state_a',0.0,0,0,0
7739,7739,'#state_b',0.0,0,0,0
7740,7740,'#state_b1',0.0,0,0,0
7741,7741,'#state_b2',0.0,0,0,0
7742,7742,'#static-slug2',0.0,0,0,0
7743,7743,'#sticky',0.0,0,0,0
7744,7744,'#submit',0.0,0,0,0
7745,7745,'#subscribers',0.0,0,0,0
7746,7746,'#subscribers-link',0.0,0,0,0
7747,7747,'#success',0.0,0,0,0
7748,7748,'#tab-home',0.0,0,0,0
7749,7749,'#tab-profile',0.0,0,0,0
7750,7750,'#tab1',0.0,0,0,0
7751,7751,'#tab2',0.0,0,0,0
7752,7752,'#tab3',0.0,0,0,0
7753,7753,'#tab4',0.0,0,0,0
7754,7754,'#tabNested2',0.0,0,0,0
7755,7755,'#target',0.0,0,0,0
7756,7756,'#test-link',0.0,0,0,0
7757,7757,'#test.a',0.0,0,0,0
7758,7758,'#test.b',0.0,0,0,0
7759,7759,'#test1',0.0,0,0,0
7760,7760,'#text',0.0,0,0,0
7761,7761,'#there',0.0,0,0,0
7762,7762,'#title',0.0,0,0,0
7763,7763,'#to-a',0.0,0,0,0
7764,7764,'#to-a-b',0.0,0,0,0
7765,7765,'#to-a-trailing-slash',0.0,0,0,0
7766,7766,'#to-about-link',0.0,0,0,0
7767,7767,'#to-another-middleware',0.0,0,0,0
7768,7768,'#to-another-slash',0.0,0,0,0
7769,7769,'#to-basic',0.0,0,0,0
7770,7770,'#to-blog',0.0,0,0,0
7771,7771,'#to-blog-first',0.0,0,0,0
7772,7772,'#to-blog-post',0.0,0,0,0
7773,7773,'#to-blog-slug-1',0.0,0,0,0
7774,7774,'#to-blog-slug-2',0.0,0,0,0
7775,7775,'#to-catch-all',0.0,0,0,0
7776,7776,'#to-catch-all-optional',0.0,0,0,0
7777,7777,'#to-client-component',0.0,0,0,0
7778,7778,'#to-dashboard',0.0,0,0,0
7779,7779,'#to-home',0.0,0,0,0
7780,7780,'#to-index',0.0,0,0,0
7781,7781,'#to-invisible-first-element',0.0,0,0,0
7782,7782,'#to-loading-scroll',0.0,0,0,0
7783,7783,'#to-new',0.0,0,0,0
7784,7784,'#to-new-nl',0.0,0,0,0
7785,7785,'#to-no-query-shallow',0.0,0,0,0
7786,7786,'#to-post-1',0.0,0,0,0
7787,7787,'#to-prefetch-false-result',0.0,0,0,0
7788,7788,'#to-query-shallow',0.0,0,0,0
7789,7789,'#to-result',0.0,0,0,0
7790,7790,'#to-route',0.0,0,0,0
7791,7791,'#to-server-component',0.0,0,0,0
7792,7792,'#to-title',0.0,0,0,0
7793,7793,'#tooltipWithoutTitle',0.0,0,0,0
7794,7794,'#trigger-404-link',0.0,0,0,0
7795,7795,'#trigger-redirect',0.0,0,0,0
7796,7796,'#trigger1',0.0,0,0,0
7797,7797,'#trigger2',0.0,0,0,0
7798,7798,'#trigger3',0.0,0,0,0
7799,7799,'#triggerProfile',0.0,0,0,0
7800,7800,'#unit-image',0.0,0,0,0
7801,7801,'#upload',0.0,0,0,0
7802,7802,'#user-intercept-page',0.0,0,0,0
7803,7803,'#user-page',0.0,0,0,0
7804,7804,'#user-regular-page',0.0,0,0,0
7805,7805,'#value-2',0.0,0,0,0
7806,7806,'#value2',0.0,0,0,0
7807,7807,'#view-duration',0.0,0,0,0
7808,7808,'#view-duration-link',0.0,0,0,0
7809,7809,'#views-home',0.0,0,0,0
7810,7810,'#widget',0.0,0,0,0
7811,7811,'#with-fonts-open-sans',0.0,0,0,0
7812,7812,'#with-html',0.0,0,0,0
7813,7813,'#without-html',0.0,0,0,0
7814,7814,'#wrapper',0.0,0,0,0
7815,7815,'#x-tab1',0.0,0,0,0
7816,7816,'$root',0.0,0,0,0
7817,7817,'&#0000106&#0000097&#0000118&#0000097&#0000115&#0000099&#0000114&#0000105&#0000112&#0000116&#0000058',0.0,0,0,0
7818,7818,'&#106 &#97;&#118;&#97;&#115;&#99;&#114;&#105;&#112;&#116;&#58;',0.0,0,0,0
7819,7819,'&#106&#97;&#118;&#97;&#115;&#99;&#114;&#105;&#112;&#116;&#58;',0.0,0,0,0
7820,7820,'&#106;&#97;&#118;&#97;&#115;&#99;&#114;&#105;&#112;&#116;&#58;',0.0,0,0,0
7821,7821,'&#x6A&#x61&#x76&#x61&#x73&#x63&#x72&#x69&#x70&#x74&#x3A;',0.0,0,0,0
7822,7822,'&',0.0,0,0,0
7823,7823,'&:hover',0.0,0,0,0
7824,7824,'(',0.0,0,0,0
7825,7825,'()=>',0.0,0,0,0
7826,7826,'(app/page.js)',0.0,0,0,0
7827,7827,'(device-width: 768px) and (device-height: 1024px)',0.0,0,0,0
7828,7828,'(group)',0.0,0,0,0
7829,7829,'(new)/custom/page.js',0.0,0,0,0
7830,7830,'(newroot)/dashboard/another',0.0,0,0,0
7831,7831,'(newroot)/dashboard/project/[projectId]',0.0,0,0,0
7832,7832,'(null|element)',0.0,0,0,0
7833,7833,'(pages/page.js)',0.0,0,0,0
7834,7834,'(prefers-color-scheme: dark)',0.0,0,0,0
7835,7835,'(rootonly)/dashboard/changelog',0.0,0,0,0
7836,7836,'(string|element)',0.0,0,0,0
7837,7837,'(undefined|element)',0.0,0,0,0
7838,7838,'*',0.0,0,0,0
7839,7839,'**',0.0,0,0,0
7840,7840,'**.example.com',0.0,0,0,0
7841,7841,'**/*',0.0,0,0,0
7842,7842,'**/*.mdx',0.0,0,0,0
7843,7843,'**/*Button*',0.0,0,0,0
7844,7844,'**/ignored.fixture.js',0.0,0,0,0
7845,7845,'*.js',0.0,0,0,0
7846,7846,'+document.cookie.match(/test-cookie=(\\d+)/)[1]',0.0,0,0,0
7847,7847,'--keepAliveTimeout changes server.keepAliveTimeout when passed',0.0,0,0,0
7848,7848,'--keepAliveTimeout',0.0,0,0,0
7849,7849,'--other ',0.0,0,0,0
7850,7850,'--other --additional',0.0,0,0,0
7851,7851,'--other --inspect --additional',0.0,0,0,0
7852,7852,'--other --inspect',0.0,0,0,0
7853,7853,'--other --inspect-brk --additional',0.0,0,0,0
7854,7854,'--other --inspect-brk=0.0.0.0:1234 --additional',0.0,0,0,0
7855,7855,'--other --inspect=0.0.0.0:1234 --additional',0.0,0,0,0
7856,7856,'-after',0.0,0,0,0
7857,7857,'-after/thing',0.0,0,0,0
7858,7858,'-before',0.0,0,0,0
7859,7859,'. See https://nextjs.org/docs/app/api-reference/functions/generate-metadata#metadatabase',0.0,0,0,0
7860,7860,'.',0.0,0,0,0
7861,7861,'.*',0.0,0,0,0
7862,7862,'../..',0.0,0,0,0
7863,7863,'../../..',0.0,0,0,0
7864,7864,'../../../../examples',0.0,0,0,0
7865,7865,'../../../client',0.0,0,0,0
7866,7866,'../../../client/reactDevtoolsHook',0.0,0,0,0
7867,7867,'../../../client/userImports',0.0,0,0,0
7868,7868,'../../../test',0.0,0,0,0
7869,7869,'../../someF/pathG?fooH=barI#hashJ',0.0,0,0,0
7870,7870,'../../static/favicon.ico',0.0,0,0,0
7871,7871,'../../test/apps/basic/styleguide.config.js',0.0,0,0,0
7872,7872,'../../test/apps/defaults/styleguide.config.js',0.0,0,0,0
7873,7873,'../../test/data/styleguide.config.js',0.0,0,0,0
7874,7874,'../basic',0.0,0,0,0
7875,7875,'../basic/styleguide.config.js',0.0,0,0,0
7876,7876,'../no-webpack',0.0,0,0,0
7877,7877,'../someF/pathG?fooH=barI#hashJ',0.0,0,0,0
7878,7878,'../userImportsLoader',0.0,0,0,0
7879,7879,'./aa',0.0,0,0,0
7880,7880,'./app',0.0,0,0,0
7881,7881,'./app/src/vercel.png',0.0,0,0,0
7882,7882,'./does-not-exist.woff2',0.0,0,0,0
7883,7883,'./font1.woff2',0.0,0,0,0
7884,7884,'./images/animated.webp',0.0,0,0,0
7885,7885,'./images/icon.png',0.0,0,0,0
7886,7886,'./images/test.avif',0.0,0,0,0
7887,7887,'./images/test.ico',0.0,0,0,0
7888,7888,'./images/test.jpg',0.0,0,0,0
7889,7889,'./images/test.png',0.0,0,0,0
7890,7890,'./images/test.svg',0.0,0,0,0
7891,7891,'./not-a-page.js',0.0,0,0,0
7892,7892,'./npm',0.0,0,0,0
7893,7893,'./page.component.jsx',0.0,0,0,0
7894,7894,'./page.js',0.0,0,0,0
7895,7895,'./page.jsx',0.0,0,0,0
7896,7896,'./someF/pathG?fooH=barI#hashJ',0.0,0,0,0
7897,7897,'./test/components/Annotation/Annotation.js',0.0,0,0,0
7898,7898,'./test/components/Button/Readme.md',0.0,0,0,0
7899,7899,'./test/components/Placeholder/Placeholder.js',0.0,0,0,0
7900,7900,'./test/components/Price/Price.js',0.0,0,0,0
7901,7901,'./with-proxy/server.js',0.0,0,0,0
7902,7902,'.48px',0.0,0,0,0
7903,7903,'.A2',0.0,0,0,0
7904,7904,'.\\page.jsx',0.0,0,0,0
7905,7905,'.baz',0.0,0,0,0
7906,7906,'.bs.popover',0.0,0,0,0
7907,7907,'.bs.swipe',0.0,0,0,0
7908,7908,'.bs.tooltip',0.0,0,0,0
7909,7909,'.btn-close',0.0,0,0,0
7910,7910,'.carousel',0.0,0,0,0
7911,7911,'.carousel-control-next',0.0,0,0,0
7912,7912,'.carousel-control-prev',0.0,0,0,0
7913,7913,'.carousel-item.active',0.0,0,0,0
7914,7914,'.collapse',0.0,0,0,0
7915,7915,'.deep',0.0,0,0,0
7916,7916,'.dropdown',0.0,0,0,0
7917,7917,'.dropdown-item',0.0,0,0,0
7918,7918,'.dropdown-menu',0.0,0,0,0
7919,7919,'.dropend',0.0,0,0,0
7920,7920,'.dropstart',0.0,0,0,0
7921,7921,'.dropup',0.0,0,0,0
7922,7922,'.dropup-center',0.0,0,0,0
7923,7923,'.eslintrc.json',0.0,0,0,0
7924,7924,'.first',0.0,0,0,0
7925,7925,'.firstBtn',0.0,0,0,0
7926,7926,'.foo',0.0,0,0,0
7927,7927,'.hidden',0.0,0,0,0
7928,7928,'.idle',0.0,0,0,0
7929,7929,'.initialState returns the initial state',0.0,0,0,0
7930,7930,'.invalid',0.0,0,0,0
7931,7931,'.js',0.0,0,0,0
7932,7932,'.js.map',0.0,0,0,0
7933,7933,'.js.nft.json',0.0,0,0,0
7934,7934,'.modal-body',0.0,0,0,0
7935,7935,'.modal-content',0.0,0,0,0
7936,7936,'.my-collapse',0.0,0,0,0
7937,7937,'.namespace',0.0,0,0,0
7938,7938,'.nav',0.0,0,0,0
7939,7939,'.nav-tab',0.0,0,0,0
7940,7940,'.navbar',0.0,0,0,0
7941,7941,'.nested',0.0,0,0,0
7942,7942,'.next/app-build-manifest.json',0.0,0,0,0
7943,7943,'.next/pages',0.0,0,0,0
7944,7944,'.next/prerender-manifest.json',0.0,0,0,0
7945,7945,'.next/required-server-files.json',0.0,0,0,0
7946,7946,'.next/routes-manifest.json',0.0,0,0,0
7947,7947,'.next/server',0.0,0,0,0
7948,7948,'.next/server/app',0.0,0,0,0
7949,7949,'.next/server/app-paths-manifest.json',0.0,0,0,0
7950,7950,'.next/server/app/another/page.js',0.0,0,0,0
7951,7951,'.next/server/app/api/dynamic.body',0.0,0,0,0
7952,7952,'.next/server/app/api/dynamic.meta',0.0,0,0,0
7953,7953,'.next/server/app/api/hello.json.body',0.0,0,0,0
7954,7954,'.next/server/app/api/hello.json.meta',0.0,0,0,0
7955,7955,'.next/server/app/dashboard/deployments/[id]/page.js.nft.json',0.0,0,0,0
7956,7956,'.next/server/app/metadata-base/unset/opengraph-image2/[[...__metadata_id__]]/route.js.nft.json',0.0,0,0,0
7957,7957,'.next/server/app/opengraph/static/opengraph-image.png.body',0.0,0,0,0
7958,7958,'.next/server/app/opengraph/static/opengraph-image.png.meta',0.0,0,0,0
7959,7959,'.next/server/app/opengraph/static/opengraph-image.png/[[...__metadata_id__]]/route.js',0.0,0,0,0
7960,7960,'.next/server/app/page.js',0.0,0,0,0
7961,7961,'.next/server/app/variable-revalidate/revalidate-360-isr.meta',0.0,0,0,0
7962,7962,'.next/server/client-reference-manifest.json',0.0,0,0,0
7963,7963,'.next/server/functions-config-manifest.json',0.0,0,0,0
7964,7964,'.next/server/middleware-manifest.json',0.0,0,0,0
7965,7965,'.next/server/middleware.js',0.0,0,0,0
7966,7966,'.next/server/pages-manifest.json',0.0,0,0,0
7967,7967,'.next/server/pages/',0.0,0,0,0
7968,7968,'.next/server/pages/404.html',0.0,0,0,0
7969,7969,'.next/server/pages/[id].js',0.0,0,0,0
7970,7970,'.next/server/pages/[id].js.nft.json',0.0,0,0,0
7971,7971,'.next/server/pages/index.js',0.0,0,0,0
7972,7972,'.next/server/pages/index.js.nft.json',0.0,0,0,0
7973,7973,'.next/standalone',0.0,0,0,0
7974,7974,'.next/standalone/.next/server',0.0,0,0,0
7975,7975,'.next/standalone/.next/server/edge-chunks',0.0,0,0,0
7976,7976,'.next/standalone/.next/server/pages/api/og.js',0.0,0,0,0
7977,7977,'.offcanvas',0.0,0,0,0
7978,7978,'.outer',0.0,0,0,0
7979,7979,'.page_config-redirect-after',0.0,0,0,0
7980,7980,'.page_config-redirect-catchall-after_thing',0.0,0,0,0
7981,7981,'.page_config-rewrite-after',0.0,0,0,0
7982,7982,'.page_middleware-redirect-after',0.0,0,0,0
7983,7983,'.page_middleware-rewrite-after',0.0,0,0,0
7984,7984,'.parent',0.0,0,0,0
7985,7985,'.popover',0.0,0,0,0
7986,7986,'.popover-arrow',0.0,0,0,0
7987,7987,'.popover-body',0.0,0,0,0
7988,7988,'.popover-header',0.0,0,0,0
7989,7989,'.refreshed',0.0,0,0,0
7990,7990,'.rsg--root-2:hover',0.0,0,0,0
7991,7991,'.second',0.0,0,0,0
7992,7992,'.secondBtn',0.0,0,0,0
7993,7993,'.show',0.0,0,0,0
7994,7994,'.sibling',0.0,0,0,0
7995,7995,'.sticky-top',0.0,0,0,0
7996,7996,'.success',0.0,0,0,0
7997,7997,'.tab-content .show',0.0,0,0,0
7998,7998,'.target',0.0,0,0,0
7999,7999,'.testParent',0.0,0,0,0
8000,8000,'.text-6xl',0.0,0,0,0
8001,8001,'.three',0.0,0,0,0
8002,8002,'.title',0.0,0,0,0
8003,8003,'.tooltip-arrow',0.0,0,0,0
8004,8004,'.valid',0.0,0,0,0
8005,8005,'.web.js',0.0,0,0,0
8006,8006,'/(group)/dynamic/[size]/apple-icon-48jo90/[[...__metadata_id__]]/route',0.0,0,0,0
8007,8007,'/(group)/group/page',0.0,0,0,0
8008,8008,'/(group)/twitter-image-',0.0,0,0,0
8009,8009,'/(rootonly)/dashboard/hello/page',0.0,0,0,0
8010,8010,'/**\n * @public\n * @returns {Number} - Description\n */\nmethod() {}',0.0,0,0,0
8011,8011,'/**\n * Label\n */\ncolor: PropTypes.string',0.0,0,0,0
8012,8012,'/**\n * Public\n * @public\n * @param {Number} value - Description\n */\nmethod(value) {}',0.0,0,0,0
8013,8013,'/**\n * Public\n * @public\n */\nmethod() {}',0.0,0,0,0
8014,8014,'/../../package.json',0.0,0,0,0
8015,8015,'/../../test',0.0,0,0,0
8016,8016,'/../../test.js',0.0,0,0,0
8017,8017,'// assetPrefix',0.0,0,0,0
8018,8018,'// beforeFiles',0.0,0,0,0
8019,8019,'// output',0.0,0,0,0
8020,8020,'// throw new',0.0,0,0,0
8021,8021,'//**y/\\',0.0,0,0,0
8022,8022,'//google.com',0.0,0,0,0
8023,8023,'/0/0/100/10000/page1',0.0,0,0,0
8024,8024,'/0/0/10000/10000/page1',0.0,0,0,0
8025,8025,'/0/1000/100/1000/page1',0.0,0,0,0
8026,8026,'/10/100/100/1000/page1',0.0,0,0,0
8027,8027,'/10/1000/100/1000/page1',0.0,0,0,0
8028,8028,'/10/10000/100/1000/page1',0.0,0,0,0
8029,8029,'/123',0.0,0,0,0
8030,8030,'/123?hello=world',0.0,0,0,0
8031,8031,'/404',0.0,0,0,0
8032,8032,'/:path*',0.0,0,0,0
8033,8033,'/:path+',0.0,0,0,0
8034,8034,'/:path+/',0.0,0,0,0
8035,8035,'/?test=1',0.0,0,0,0
8036,8036,'/Users/ovidiu/cosmos',0.0,0,0,0
8037,8037,'/Users/ovidiu/cosmos/src',0.0,0,0,0
8038,8038,'/[...rest]',0.0,0,0,0
8039,8039,'/[[blog]]',0.0,0,0,0
8040,8040,'/[category]/[id]',0.0,0,0,0
8041,8041,'/[dynamic]?',0.0,0,0,0
8042,8042,'/[dynamic]?param=1',0.0,0,0,0
8043,8043,'/[id]',0.0,0,0,0
8044,8044,'/[root-slug]',0.0,0,0,0
8045,8045,'/_app',0.0,0,0,0
8046,8046,'/_components',0.0,0,0,0
8047,8047,'/_dashboard',0.0,0,0,0
8048,8048,'/_error',0.0,0,0,0
8049,8049,'/_handlers',0.0,0,0,0
8050,8050,'/_next/data/1234/en/hello.json',0.0,0,0,0
8051,8051,'/_next/data/development/en/hello.json',0.0,0,0,0
8052,8052,'/_next/data/development/hello.json',0.0,0,0,0
8053,8053,'/_next/data/development/index.json',0.0,0,0,0
8054,8054,"'/_next/image?url=%2F_next%2Fstatic%2Fmedia%2Ftest.3f1a293b.png&w=640&q=50 1x, /_next/image?url=%2F_next%2Fstatic%2Fmedia%2Ftest.3f1a293b.png&w=828&q=50 2x'",0.0,0,0,0
8055,8055,"'/_next/image?url=%2F_next%2Fstatic%2Fmedia%2Ftest.3f1a293b.png&w=640&q=55 1x, /_next/image?url=%2F_next%2Fstatic%2Fmedia%2Ftest.3f1a293b.png&w=828&q=55 2x'",0.0,0,0,0
8056,8056,"'/_next/image?url=%2F_next%2Fstatic%2Fmedia%2Ftest.3f1a293b.png&w=640&q=60 1x, /_next/image?url=%2F_next%2Fstatic%2Fmedia%2Ftest.3f1a293b.png&w=828&q=60 2x'",0.0,0,0,0
8057,8057,"'/_next/image?url=%2F_next%2Fstatic%2Fmedia%2Ftest.3f1a293b.png&w=640&q=80 1x, /_next/image?url=%2F_next%2Fstatic%2Fmedia%2Ftest.3f1a293b.png&w=828&q=80 2x'",0.0,0,0,0
8058,8058,"'/_next/image?url=%2F_next%2Fstatic%2Fmedia%2Ftest.3f1a293b.png&w=640&q=85 1x, /_next/image?url=%2F_next%2Fstatic%2Fmedia%2Ftest.3f1a293b.png&w=828&q=85 2x'",0.0,0,0,0
8059,8059,"'/_next/image?url=%2F_next%2Fstatic%2Fmedia%2Ftest.3f1a293b.png&w=640&q=90 1x, /_next/image?url=%2F_next%2Fstatic%2Fmedia%2Ftest.3f1a293b.png&w=828&q=90 2x'",0.0,0,0,0
8060,8060,'/_next/image?url=%2F_next%2Fstatic%2Fmedia%2Ftest.3f1a293b.png&w=828&q=50',0.0,0,0,0
8061,8061,'/_next/image?url=%2F_next%2Fstatic%2Fmedia%2Ftest.3f1a293b.png&w=828&q=55',0.0,0,0,0
8062,8062,'/_next/image?url=%2F_next%2Fstatic%2Fmedia%2Ftest.3f1a293b.png&w=828&q=60',0.0,0,0,0
8063,8063,'/_next/image?url=%2F_next%2Fstatic%2Fmedia%2Ftest.3f1a293b.png&w=828&q=80',0.0,0,0,0
8064,8064,'/_next/image?url=%2F_next%2Fstatic%2Fmedia%2Ftest.3f1a293b.png&w=828&q=85',0.0,0,0,0
8065,8065,'/_next/image?url=%2F_next%2Fstatic%2Fmedia%2Ftest.3f1a293b.png&w=828&q=90',0.0,0,0,0
8066,8066,"'/_next/image?url=%2F_next%2Fstatic%2Fmedia%2Ftest.fab2915d.jpg&w=640&q=65 1x, /_next/image?url=%2F_next%2Fstatic%2Fmedia%2Ftest.fab2915d.jpg&w=828&q=65 2x'",0.0,0,0,0
8067,8067,"'/_next/image?url=%2F_next%2Fstatic%2Fmedia%2Ftest.fab2915d.jpg&w=640&q=70 1x, /_next/image?url=%2F_next%2Fstatic%2Fmedia%2Ftest.fab2915d.jpg&w=828&q=70 2x'",0.0,0,0,0
8068,8068,"'/_next/image?url=%2F_next%2Fstatic%2Fmedia%2Ftest.fab2915d.jpg&w=640&q=75 1x, /_next/image?url=%2F_next%2Fstatic%2Fmedia%2Ftest.fab2915d.jpg&w=828&q=75 2x'",0.0,0,0,0
8069,8069,'/_next/image?url=%2F_next%2Fstatic%2Fmedia%2Ftest.fab2915d.jpg&w=828&q=65',0.0,0,0,0
8070,8070,'/_next/image?url=%2F_next%2Fstatic%2Fmedia%2Ftest.fab2915d.jpg&w=828&q=70',0.0,0,0,0
8071,8071,'/_next/image?url=%2F_next%2Fstatic%2Fmedia%2Ftest.fab2915d.jpg&w=828&q=75',0.0,0,0,0
8072,8072,"'/_next/image?url=%2Ftest.png&w=128&q=50 1x, /_next/image?url=%2Ftest.png&w=256&q=50 2x'",0.0,0,0,0
8073,8073,"'/_next/image?url=%2Ftest.png&w=128&q=75 1x, /_next/image?url=%2Ftest.png&w=256&q=75 2x'",0.0,0,0,0
8074,8074,'/_next/image?url=%2Ftest.png&w=256&q=50',0.0,0,0,0
8075,8075,'/_next/image?url=%2Ftest.png&w=256&q=75',0.0,0,0,0
8076,8076,'/_next/image?url=%2Ftest.png&w=384&q=75 384w',0.0,0,0,0
8077,8077,'/_next/image?url=%2Ftest.png&w=3840&q=75',0.0,0,0,0
8078,8078,"'/_next/image?url=%2Ftest.png&w=640&q=75 640w, /_next/image?url=%2Ftest.png&w=750&q=75 750w, /_next/image?url=%2Ftest.png&w=828&q=75 828w, /_next/image?url=%2Ftest.png&w=1080&q=75 1080w, /_next/image?url=%2Ftest.png&w=1200&q=75 1200w, /_next/image?url=%2Ftest.png&w=1920&q=75 1920w, /_next/image?url=%2Ftest.png&w=2048&q=75 2048w, /_next/image?url=%2Ftest.png&w=3840&q=75 3840w'",0.0,0,0,0
8079,8079,'/_next/static/chunks/pages/_app-non-existent.js',0.0,0,0,0
8080,8080,'/_next/static/media/02205c9944024f15-s.p.woff2',0.0,0,0,0
8081,8081,'/_next/static/media/0812efcfaefec5ea-s.p.woff2',0.0,0,0,0
8082,8082,'/_next/static/media/0812efcfaefec5ea.p.woff2',0.0,0,0,0
8083,8083,'/_next/static/media/1deec1af325840fd-s.p.woff2',0.0,0,0,0
8084,8084,'/_next/static/media/2a931eed088772c9-s.p.woff2',0.0,0,0,0
8085,8085,'/_next/static/media/4a7f86e553ee7e51-s.p.woff2',0.0,0,0,0
8086,8086,'/_next/static/media/4f3dcdf40b3ca86d-s.p.woff2',0.0,0,0,0
8087,8087,'/_next/static/media/560a6db6ac485cb1-s.p.woff2',0.0,0,0,0
8088,8088,'/_next/static/media/568e4c6d8123c4d6-s.p.woff2',0.0,0,0,0
8089,8089,'/_next/static/media/675c25f648fd6a30-s.p.woff2',0.0,0,0,0
8090,8090,'/_next/static/media/686d1702f12625fe-s.p.woff2',0.0,0,0,0
8091,8091,'/_next/static/media/75c5faeeb9c86969-s.p.woff2',0.0,0,0,0
8092,8092,'/_next/static/media/86d92167ff02c708-s.p.woff2',0.0,0,0,0
8093,8093,'/_next/static/media/9a7e84b4dd095b33-s.p.woff2',0.0,0,0,0
8094,8094,'/_next/static/media/9ac01b894b856187-s.p.woff2',0.0,0,0,0
8095,8095,'/_next/static/media/ab6fdae82d1a8d92-s.p.woff2',0.0,0,0,0
8096,8096,'/_next/static/media/ab6fdae82d1a8d92.p.woff2',0.0,0,0,0
8097,8097,'/_next/static/media/b2104791981359ae-s.p.woff2',0.0,0,0,0
8098,8098,'/_next/static/media/b61859a50be14c53-s.p.woff2',0.0,0,0,0
8099,8099,'/_next/static/media/c9baea324111137d-s.p.woff2',0.0,0,0,0
8100,8100,'/_next/static/media/d55edb6f37902ebf-s.p.woff2',0.0,0,0,0
8101,8101,'/_next/static/media/e1053f04babc7571-s.p.woff2',0.0,0,0,0
8102,8102,'/_next/static/media/e9b9dc0d8ba35f48-s.p.woff2',0.0,0,0,0
8103,8103,'/_next/static/media/fb68b4558e2a718e-s.p.woff2',0.0,0,0,0
8104,8104,'/_next/static/media/feab2c68f2a8e9a4-s.p.woff2',0.0,0,0,0
8105,8105,'/_renderer.html',0.0,0,0,0
8106,8106,'/_routable-folder',0.0,0,0,0
8107,8107,'/a',0.0,0,0,0
8108,8108,'/a/',0.0,0,0,0
8109,8109,'/a/b',0.0,0,0,0
8110,8110,'/abc/[[blog]]',0.0,0,0,0
8111,8111,'/abc/[[blog]]/def',0.0,0,0,0
8112,8112,'/abc/def',0.0,0,0,0
8113,8113,'/about/a',0.0,0,0,0
8114,8114,'/about/b',0.0,0,0,0
8115,8115,'/about/me',0.0,0,0,0
8116,8116,'/about?param1=value1',0.0,0,0,0
8117,8117,'/act123/*/pic.jpg',0.0,0,0,0
8118,8118,'/act123/*4/pic.jpg',0.0,0,0,0
8119,8119,'/act123/*sr*/pic.jpg',0.0,0,0,0
8120,8120,'/act123/usr*/pic.jpg',0.0,0,0,0
8121,8121,'/add-header',0.0,0,0,0
8122,8122,'/add-header-no-basepath',0.0,0,0,0
8123,8123,'/advanced/body/json',0.0,0,0,0
8124,8124,'/advanced/body/streaming',0.0,0,0,0
8125,8125,'/advanced/body/text',0.0,0,0,0
8126,8126,'/advanced/query?ping=pong',0.0,0,0,0
8127,8127,'/afterfiles-rewrite-ssg',0.0,0,0,0
8128,8128,'/alternates',0.0,0,0,0
8129,8129,'/alternates/child',0.0,0,0,0
8130,8130,'/alternates/child/123',0.0,0,0,0
8131,8131,'/amp',0.0,0,0,0
8132,8132,'/another-middleware',0.0,0,0,0
8133,8133,'/api',0.0,0,0,0
8134,8134,'/api-docs/[...slug]',0.0,0,0,0
8135,8135,'/api-docs/[...slug].html',0.0,0,0,0
8136,8136,'/api-docs/first',0.0,0,0,0
8137,8137,'/api-docs/second',0.0,0,0,0
8138,8138,'/api/add',0.0,0,0,0
8139,8139,'/api/app/param/data',0.0,0,0,0
8140,8140,'/api/blog/first',0.0,0,0,0
8141,8141,'/api/body_parser_false',0.0,0,0,0
8142,8142,'/api/buffer',0.0,0,0,0
8143,8143,'/api/default',0.0,0,0,0
8144,8144,'/api/draft-mode?status=enable',0.0,0,0,0
8145,8145,'/api/dynamic/[abc]',0.0,0,0,0
8146,8146,'/api/dynamic/[slug]',0.0,0,0,0
8147,8147,'/api/edge-search-params',0.0,0,0,0
8148,8148,'/api/enable',0.0,0,0,0
8149,8149,'/api/globalFetch',0.0,0,0,0
8150,8150,'/api/globalHeaders',0.0,0,0,0
8151,8151,'/api/globalRequest',0.0,0,0,0
8152,8152,'/api/globalResponse',0.0,0,0,0
8153,8153,'/api/id-1',0.0,0,0,0
8154,8154,'/api/import-test',0.0,0,0,0
8155,8155,'/api/manifest',0.0,0,0,0
8156,8156,'/api/non-existent',0.0,0,0,0
8157,8157,'/api/nothing',0.0,0,0,0
8158,8158,'/api/nothing?middleware-handler=formData',0.0,0,0,0
8159,8159,'/api/nothing?middleware-handler=json',0.0,0,0,0
8160,8160,'/api/nothing?middleware-handler=text',0.0,0,0,0
8161,8161,'/api/og',0.0,0,0,0
8162,8162,'/api/og-wrong-runtime',0.0,0,0,0
8163,8163,'/api/pages/param/basic',0.0,0,0,0
8164,8164,'/api/ping',0.0,0,0,0
8165,8165,'/api/preload',0.0,0,0,0
8166,8166,'/api/revalidate-path-node?path=/variable-revalidate/revalidate-360-isr',0.0,0,0,0
8167,8167,'/api/size_limit_5kb',0.0,0,0,0
8168,8168,'/api/size_limit_5mb',0.0,0,0,0
8169,8169,'/api/test-cookie',0.0,0,0,0
8170,8170,'/api/test-cookie-edge',0.0,0,0,0
8171,8171,'/api/unknown-domain',0.0,0,0,0
8172,8172,'/api/unknown-domain-no-await',0.0,0,0,0
8173,8173,'/api/user/any',0.0,0,0,0
8174,8174,'/api/user/login',0.0,0,0,0
8175,8175,'/app',0.0,0,0,0
8176,8176,'/app-dir',0.0,0,0,0
8177,8177,'/app-links',0.0,0,0,0
8178,8178,'/app-valid-runtime',0.0,0,0,0
8179,8179,'/app/param/rsc-fetch',0.0,0,0,0
8180,8180,'/apple',0.0,0,0,0
8181,8181,'/apple-icon',0.0,0,0,0
8182,8182,'/apple-icon-x3.png',0.0,0,0,0
8183,8183,'/apple-icon.png',0.0,0,0,0
8184,8184,'/apples/[ab]/[cd]/ef',0.0,0,0,0
8185,8185,'/async/blog?q=xxx',0.0,0,0,0
8186,8186,'/async/redirect',0.0,0,0,0
8187,8187,'/async/slug',0.0,0,0,0
8188,8188,'/back-forward/1',0.0,0,0,0
8189,8189,'/bad-gssp',0.0,0,0,0
8190,8190,'/bad-ssr',0.0,0,0,0
8191,8191,'/base',0.0,0,0,0
8192,8192,'/base/another',0.0,0,0,0
8193,8193,'/base/another/opengraph-image.png',0.0,0,0,0
8194,8194,'/base/something/another',0.0,0,0,0
8195,8195,'/basic',0.0,0,0,0
8196,8196,'/basic-edge',0.0,0,0,0
8197,8197,'/basic-route',0.0,0,0,0
8198,8198,'/basic/endpoint',0.0,0,0,0
8199,8199,'/basic/vercel/endpoint',0.0,0,0,0
8200,8200,'/basic/vercel/some/other/resource',0.0,0,0,0
8201,8201,'/blocked-create',0.0,0,0,0
8202,8202,'/blocking-fallback-once/[slug]',0.0,0,0,0
8203,8203,'/blocking-fallback-once/test-no-revalidate',0.0,0,0,0
8204,8204,'/blocking-fallback-some/[slug]',0.0,0,0,0
8205,8205,'/blocking-fallback-some/a',0.0,0,0,0
8206,8206,'/blocking-fallback/[slug]',0.0,0,0,0
8207,8207,'/blocking-fallback/a',0.0,0,0,0
8208,8208,'/blocking-fallback/lots-of-data',0.0,0,0,0
8209,8209,'/blocking-fallback/pewpew',0.0,0,0,0
8210,8210,'/blocking-fallback/random-path',0.0,0,0,0
8211,8211,'/blocking-fallback/test-errors-1',0.0,0,0,0
8212,8212,'/blog',0.0,0,0,0
8213,8213,'/blog/@login',0.0,0,0,0
8214,8214,'/blog/[....id]/abc',0.0,0,0,0
8215,8215,'/blog/[...id]/[...id2]',0.0,0,0,0
8216,8216,'/blog/[...id]/abc',0.0,0,0,0
8217,8217,'/blog/[...id]]',0.0,0,0,0
8218,8218,'/blog/[..id]/abc',0.0,0,0,0
8219,8219,'/blog/[[...id]',0.0,0,0,0
8220,8220,'/blog/[[...id]]]',0.0,0,0,0
8221,8221,'/blog/[[[...id]]',0.0,0,0,0
8222,8222,'/blog/[[[...id]]]',0.0,0,0,0
8223,8223,'/blog/[abc]',0.0,0,0,0
8224,8224,'/blog/[author].rsc',0.0,0,0,0
8225,8225,'/blog/[author]/[slug].rsc',0.0,0,0,0
8226,8226,'/blog/[cid]',0.0,0,0,0
8227,8227,'/blog/[helloworld]',0.0,0,0,0
8228,8228,'/blog/[helloworld]/[hello-world]',0.0,0,0,0
8229,8229,'/blog/[id]',0.0,0,0,0
8230,8230,'/blog/[id]/[...id]',0.0,0,0,0
8231,8231,'/blog/[id]/comments/[cid]',0.0,0,0,0
8232,8232,'/blog/[id]/comments/[id]',0.0,0,0,0
8233,8233,'/blog/[post]',0.0,0,0,0
8234,8234,'/blog/[post].html',0.0,0,0,0
8235,8235,'/blog/[post]/[comment]',0.0,0,0,0
8236,8236,'/blog/[post]/[comment].html',0.0,0,0,0
8237,8237,'/blog/a',0.0,0,0,0
8238,8238,'/blog/abc',0.0,0,0,0
8239,8239,'/blog/abc/[id]',0.0,0,0,0
8240,8240,'/blog/abc/post',0.0,0,0,0
8241,8241,'/blog/first',0.0,0,0,0
8242,8242,'/blog/first/',0.0,0,0,0
8243,8243,'/blog/icon',0.0,0,0,0
8244,8244,'/blog/login',0.0,0,0,0
8245,8245,'/blog/opengraph-image',0.0,0,0,0
8246,8246,'/blog/post-1/comment-1',0.0,0,0,0
8247,8247,'/blog/post-100',0.0,0,0,0
8248,8248,'/blog/post-1?another=value',0.0,0,0,0
8249,8249,'/blog/post-1?post=something-else',0.0,0,0,0
8250,8250,'/blog/post-2',0.0,0,0,0
8251,8251,'/blog/post-2/comment-2',0.0,0,0,0
8252,8252,'/blog/post-3',0.0,0,0,0
8253,8253,'/blog/seb',0.0,0,0,0
8254,8254,'/blog/seb.rsc',0.0,0,0,0
8255,8255,'/blog/seb/second-post',0.0,0,0,0
8256,8256,'/blog/seb/second-post.rsc',0.0,0,0,0
8257,8257,'/blog/second',0.0,0,0,0
8258,8258,'/blog/second/',0.0,0,0,0
8259,8259,'/blog/styfle',0.0,0,0,0
8260,8260,'/blog/styfle.rsc',0.0,0,0,0
8261,8261,'/blog/styfle/first-post',0.0,0,0,0
8262,8262,'/blog/styfle/first-post.rsc',0.0,0,0,0
8263,8263,'/blog/styfle/second-post',0.0,0,0,0
8264,8264,'/blog/styfle/second-post.rsc',0.0,0,0,0
8265,8265,'/blog/test-1',0.0,0,0,0
8266,8266,'/blog/tim',0.0,0,0,0
8267,8267,'/blog/tim.rsc',0.0,0,0,0
8268,8268,'/blog/tim/first-post',0.0,0,0,0
8269,8269,'/blog/tim/first-post.rsc',0.0,0,0,0
8270,8270,'/buffer',0.0,0,0,0
8271,8271,'/button',0.0,0,0,0
8272,8272,'/cache-deduping',0.0,0,0,0
8273,8273,'/cache-deduping/navigating',0.0,0,0,0
8274,8274,'/catch-all-edge/hello123',0.0,0,0,0
8275,8275,'/catch-all-link',0.0,0,0,0
8276,8276,'/catch-all/first',0.0,0,0,0
8277,8277,'/catchall-explicit/[...slug]',0.0,0,0,0
8278,8278,'/catchall-explicit/[first]/[second]',0.0,0,0,0
8279,8279,'/catchall-explicit/[third]/[fourth]',0.0,0,0,0
8280,8280,'/catchall-explicit/another/value',0.0,0,0,0
8281,8281,'/catchall-explicit/notreturnedinpaths',0.0,0,0,0
8282,8282,'/catchall-explicit/second',0.0,0,0,0
8283,8283,'/catchall-explicity/test-manual-1',0.0,0,0,0
8284,8284,'/catchall-optional/[[...slug]]',0.0,0,0,0
8285,8285,'/catchall/[...slug]',0.0,0,0,0
8286,8286,'/catchall/[...slug].html',0.0,0,0,0
8287,8287,'/catchall/another/value',0.0,0,0,0
8288,8288,'/catchall/delayby3s',0.0,0,0,0
8289,8289,'/catchall/delayby3s/nested',0.0,0,0,0
8290,8290,'/catchall/first',0.0,0,0,0
8291,8291,'/catchall/notreturnedinpaths',0.0,0,0,0
8292,8292,'/catchall/notreturnedinpaths/nested',0.0,0,0,0
8293,8293,'/catchall/something/another',0.0,0,0,0
8294,8294,'/chunk-loading/server',0.0,0,0,0
8295,8295,'/classname-pass-through',0.0,0,0,0
8296,8296,'/client-component-page?search=hello',0.0,0,0,0
8297,8297,'/client-component-without-searchparams?search=hello',0.0,0,0,0
8298,8298,'/client-component?search=hello',0.0,0,0,0
8299,8299,'/client-dep',0.0,0,0,0
8300,8300,'/client-nested',0.0,0,0,0
8301,8301,'/consumer',0.0,0,0,0
8302,8302,'/cosmos/eyJwYXRoIjoiL3BhdGgvdG8vZml4dHVyZS5qcyIsIm5hbWUiOiJmaXJzdCJ9',0.0,0,0,0
8303,8303,'/cosmos/eyJwYXRoIjoiL3BhdGgvdG8vZml4dHVyZS5qcyIsIm5hbWUiOiJmaXJzdCJ9?locked=true',0.0,0,0,0
8304,8304,'/cosmos/index',0.0,0,0,0
8305,8305,'/cosmos/renderer.html',0.0,0,0,0
8306,8306,'/cosmos/renderer.html?fixtureId=%7B%22path%22%3A%22%2Fpath%2Fto%2Ffixture.js%22%2C%22name%22%3A%22first%22%7D&locked=true',0.0,0,0,0
8307,8307,'/cosmos/renderer.html?fixtureId=%7B%22path%22%3A%22%2Fpath%2Fto%2Ffixture.js%22%2C%22name%22%3A%22first%22%7D',0.0,0,0,0
8308,8308,'/country',0.0,0,0,0
8309,8309,'/csp',0.0,0,0,0
8310,8310,'/css-in-js',0.0,0,0,0
8311,8311,'/css-in-js/edge',0.0,0,0,0
8312,8312,'/css-in-js/suspense',0.0,0,0,0
8313,8313,'/css-modules',0.0,0,0,0
8314,8314,'/css-modules/page1',0.0,0,0,0
8315,8315,'/css-pageextensions',0.0,0,0,0
8316,8316,'/css/a',0.0,0,0,0
8317,8317,'/css/css-client',0.0,0,0,0
8318,8318,'/css/css-client/inner',0.0,0,0,0
8319,8319,'/css/css-conflict-layers',0.0,0,0,0
8320,8320,'/css/css-duplicate-2/server',0.0,0,0,0
8321,8321,'/css/css-external',0.0,0,0,0
8322,8322,'/css/css-nested',0.0,0,0,0
8323,8323,'/css/css-page',0.0,0,0,0
8324,8324,'/css/modules',0.0,0,0,0
8325,8325,'/css/sass-client/inner',0.0,0,0,0
8326,8326,'/css/sass/inner',0.0,0,0,0
8327,8327,'/css2?family=Oswald:wght@200..700&display=swap',0.0,0,0,0
8328,8328,'/dashboard#abc',0.0,0,0,0
8329,8329,'/dashboard',0.0,0,0,0
8330,8330,'/dashboard/_next/static/media/0812efcfaefec5ea-s.p.woff2',0.0,0,0,0
8331,8331,'/dashboard/another',0.0,0,0,0
8332,8332,'/dashboard/changelog',0.0,0,0,0
8333,8333,'/dashboard/deployments',0.0,0,0,0
8334,8334,'/dashboard/deployments/123',0.0,0,0,0
8335,8335,'/dashboard/deployments/breakdown',0.0,0,0,0
8336,8336,'/dashboard/hello',0.0,0,0,0
8337,8337,'/dashboard/index',0.0,0,0,0
8338,8338,'/dashboard/integrations',0.0,0,0,0
8339,8339,'/dashboard/page',0.0,0,0,0
8340,8340,'/dashboard/project/123',0.0,0,0,0
8341,8341,'/data.txt',0.0,0,0,0
8342,8342,'/default',0.0,0,0,0
8343,8343,'/default-revalidate',0.0,0,0,0
8344,8344,'/default/about',0.0,0,0,0
8345,8345,'/demographics',0.0,0,0,0
8346,8346,'/dns-prefetch-url',0.0,0,0,0
8347,8347,'/docs',0.0,0,0,0
8348,8348,'/docs-proxy',0.0,0,0,0
8349,8349,'/docs/abc/',0.0,0,0,0
8350,8350,'/does-not-exist',0.0,0,0,0
8351,8351,'/dynamic',0.0,0,0,0
8352,8352,'/dynamic-catchall/slug',0.0,0,0,0
8353,8353,'/dynamic-client/category-1/id-2?query1=value2',0.0,0,0,0
8354,8354,'/dynamic-client/first/second',0.0,0,0,0
8355,8355,'/dynamic-error/[id]',0.0,0,0,0
8356,8356,'/dynamic-error/[id].rsc',0.0,0,0,0
8357,8357,'/dynamic-error/static-bailout-1',0.0,0,0,0
8358,8358,'/dynamic-pages-route-app-overlap',0.0,0,0,0
8359,8359,'/dynamic-pages-route-app-overlap/app-dir',0.0,0,0,0
8360,8360,'/dynamic/[first]',0.0,0,0,0
8361,8361,'/dynamic/[second]',0.0,0,0,0
8362,8362,'/dynamic/big',0.0,0,0,0
8363,8363,'/dynamic/big/apple-icon-48jo90/0',0.0,0,0,0
8364,8364,'/dynamic/big/apple-icon-48jo90/1',0.0,0,0,0
8365,8365,'/dynamic/big/icon-48jo90/medium',0.0,0,0,0
8366,8366,'/dynamic/big/icon-48jo90/small',0.0,0,0,0
8367,8367,'/dynamic/big/opengraph-image',0.0,0,0,0
8368,8368,'/dynamic/books/hello-world',0.0,0,0,0
8369,8369,'/dynamic/category-1/id-2?query1=value2',0.0,0,0,0
8370,8370,'/dynamic/second',0.0,0,0,0
8371,8371,'/dynamic/small',0.0,0,0,0
8372,8372,'/dynamic?query=true',0.0,0,0,0
8373,8373,'/early-request-end',0.0,0,0,0
8374,8374,'/edge',0.0,0,0,0
8375,8375,'/edge-apis/cookies',0.0,0,0,0
8376,8376,'/edge-pages-react',0.0,0,0,0
8377,8377,'/edge/advanced/body/json',0.0,0,0,0
8378,8378,'/edge/advanced/body/streaming',0.0,0,0,0
8379,8379,'/edge/advanced/body/text',0.0,0,0,0
8380,8380,'/edge/advanced/query?ping=pong',0.0,0,0,0
8381,8381,'/edge/dynamic',0.0,0,0,0
8382,8382,'/edge/foo',0.0,0,0,0
8383,8383,'/edge/headers',0.0,0,0,0
8384,8384,'/en/api/blog/first',0.0,0,0,0
8385,8385,'/en/api/non-existent',0.0,0,0,0
8386,8386,'/en/hello',0.0,0,0,0
8387,8387,'/en/ssg.json',0.0,0,0,0
8388,8388,'/en/to-new',0.0,0,0,0
8389,8389,'/enable',0.0,0,0,0
8390,8390,'/enable-and-redirect',0.0,0,0,0
8391,8391,'/enoent',0.0,0,0,0
8392,8392,'/error/client-component',0.0,0,0,0
8393,8393,'/error/global-error-boundary/client',0.0,0,0,0
8394,8394,'/error/global-error-boundary/server',0.0,0,0,0
8395,8395,'/error/server-component',0.0,0,0,0
8396,8396,'/error/ssr-error-client-component',0.0,0,0,0
8397,8397,'/es',0.0,0,0,0
8398,8398,'/es/',0.0,0,0,0
8399,8399,'/es/bar',0.0,0,0,0
8400,8400,'/escaping-rsc',0.0,0,0,0
8401,8401,'/esm-client-ref',0.0,0,0,0
8402,8402,'/esm/client',0.0,0,0,0
8403,8403,'/esm/edge-server',0.0,0,0,0
8404,8404,'/esm/server',0.0,0,0,0
8405,8405,'/exists-but-not-routed',0.0,0,0,0
8406,8406,'/external-imports/server',0.0,0,0,0
8407,8407,'/external-rewrite-body',0.0,0,0,0
8408,8408,'/eyJwYXRoIjoiL3BhdGgvdG8vZml4dHVyZS5qcyIsIm5hbWUiOiJmaXJzdCJ9',0.0,0,0,0
8409,8409,'/eyJwYXRoIjoiL3BhdGgvdG8vZml4dHVyZS5qcyIsIm5hbWUiOiJmaXJzdCJ9?locked=true',0.0,0,0,0
8410,8410,'/fallback-only/[slug]',0.0,0,0,0
8411,8411,'/fallback-only/[slug].html',0.0,0,0,0
8412,8412,'/fallback-only/first%2Fpost',0.0,0,0,0
8413,8413,'/fallback-only/some-fallback-post',0.0,0,0,0
8414,8414,'/fallback-true-blog/first.json',0.0,0,0,0
8415,8415,'/fallback-true-blog/first?hello=world',0.0,0,0,0
8416,8416,'/fallback-true-blog/rewritten',0.0,0,0,0
8417,8417,'/fallback-true-blog/second',0.0,0,0,0
8418,8418,'/file',0.0,0,0,0
8419,8419,'/flight/foo/bar',0.0,0,0,0
8420,8420,'/folder1/file1',0.0,0,0,0
8421,8421,'/font',0.0,0,0,0
8422,8422,'/font-without-preloadable-subsets',0.0,0,0,0
8423,8423,'/foo',0.0,0,0,0
8424,8424,'/foo/[d]/bar/baz/[f]',0.0,0,0,0
8425,8425,'/foo/bar',0.0,0,0,0
8426,8426,'/force-cache.rsc',0.0,0,0,0
8427,8427,'/force-dynamic-catch-all/slug/a',0.0,0,0,0
8428,8428,'/force-static/[slug].rsc',0.0,0,0,0
8429,8429,'/force-static/first.rsc',0.0,0,0,0
8430,8430,'/force-static/second',0.0,0,0,0
8431,8431,'/force-static/second.rsc',0.0,0,0,0
8432,8432,'/fr',0.0,0,0,0
8433,8433,'/fr/api/hello',0.0,0,0,0
8434,8434,'/framer-motion',0.0,0,0,0
8435,8435,'/gen-params-dynamic-revalidate/[slug].rsc',0.0,0,0,0
8436,8436,'/gen-params-dynamic-revalidate/one.rsc',0.0,0,0,0
8437,8437,'/generate/foo',0.0,0,0,0
8438,8438,'/global-css',0.0,0,0,0
8439,8439,'/global-scss',0.0,0,0,0
8440,8440,'/group',0.0,0,0,0
8441,8441,'/gsp',0.0,0,0,0
8442,8442,'/gsp/sitemap/[__metadata_id__]/route',0.0,0,0,0
8443,8443,'/handler',0.0,0,0,0
8444,8444,'/has-tags',0.0,0,0,0
8445,8445,'/hash',0.0,0,0,0
8446,8446,'/hash-changes',0.0,0,0,0
8447,8447,'/hash-link-back-to-same-page',0.0,0,0,0
8448,8448,'/hash-with-scroll-offset',0.0,0,0,0
8449,8449,'/header',0.0,0,0,0
8450,8450,'/header/edge',0.0,0,0,0
8451,8451,'/header?name=test&constructor=FormData&hidden-info=hi',0.0,0,0,0
8452,8452,'/header?result=122',0.0,0,0,0
8453,8453,'/header?result=6',0.0,0,0,0
8454,8454,'/headers',0.0,0,0,0
8455,8455,'/hello.txt',0.0,0,0,0
8456,8456,'/hihi',0.0,0,0,0
8457,8457,'/hmr/import',0.0,0,0,0
8458,8458,'/hooks/cookies',0.0,0,0,0
8459,8459,'/hooks/headers',0.0,0,0,0
8460,8460,'/hooks/json',0.0,0,0,0
8461,8461,'/hooks/not-found',0.0,0,0,0
8462,8462,'/hooks/redirect',0.0,0,0,0
8463,8463,'/hooks/redirect/response',0.0,0,0,0
8464,8464,'/hooks/use-draft-mode',0.0,0,0,0
8465,8465,'/hooks/use-pathname/[slug].rsc',0.0,0,0,0
8466,8466,'/hooks/use-pathname/slug.rsc',0.0,0,0,0
8467,8467,'/hooks/use-router',0.0,0,0,0
8468,8468,'/hooks/use-search-params.rsc',0.0,0,0,0
8469,8469,'/hooks/use-search-params/force-static.rsc',0.0,0,0,0
8470,8470,'/hooks/use-search-params/with-suspense.rsc',0.0,0,0,0
8471,8471,'/hooks/use-search-params/with-suspense?first=value&second=other&third',0.0,0,0,0
8472,8472,'/hooks/use-search-params?first=value&second=other%20value&third',0.0,0,0,0
8473,8473,'/hooks/use-search-params?first=value&second=other&third',0.0,0,0,0
8474,8474,'/hooks/use-selected-layout-segment/first/slug2/second/a/b',0.0,0,0,0
8475,8475,'/html-links',0.0,0,0,0
8476,8476,'/icon',0.0,0,0,0
8477,8477,'/icon.png',0.0,0,0,0
8478,8478,'/icon.svg?90699bff34adba1f',0.0,0,0,0
8479,8479,'/icon2.png',0.0,0,0,0
8480,8480,'/icons',0.0,0,0,0
8481,8481,'/icons/descriptor',0.0,0,0,0
8482,8482,'/icons/static',0.0,0,0,0
8483,8483,'/icons/static/dynamic-routes/123',0.0,0,0,0
8484,8484,'/icons/static/icon.png',0.0,0,0,0
8485,8485,'/icons/static/nested',0.0,0,0,0
8486,8486,'/icons/static/nested/apple-icon.png',0.0,0,0,0
8487,8487,'/icons/string',0.0,0,0,0
8488,8488,'/id-pass-through',0.0,0,0,0
8489,8489,'/import',0.0,0,0,0
8490,8490,'/impressions',0.0,0,0,0
8491,8491,'/index',0.0,0,0,0
8492,8492,'/index.rsc',0.0,0,0,0
8493,8493,'/instrumentation',0.0,0,0,0
8494,8494,'/inter',0.0,0,0,0
8495,8495,'/intercepting-parallel-modal/vercel',0.0,0,0,0
8496,8496,'/intercepting-routes-dynamic-catchall/photos',0.0,0,0,0
8497,8497,'/intercepting-routes-dynamic/photos',0.0,0,0,0
8498,8498,'/intercepting-routes/feed',0.0,0,0,0
8499,8499,'/intercepting-routes/feed/nested',0.0,0,0,0
8500,8500,'/invalid-keys',0.0,0,0,0
8501,8501,'/invalid/first',0.0,0,0,0
8502,8502,'/lang/[lang]/about',0.0,0,0,0
8503,8503,'/lang/en/about.json',0.0,0,0,0
8504,8504,'/large-page-data',0.0,0,0,0
8505,8505,'/layout-with-fonts',0.0,0,0,0
8506,8506,'/legacy',0.0,0,0,0
8507,8507,'/legacy-edge-runtime',0.0,0,0,0
8508,8508,'/legacy-extension',0.0,0,0,0
8509,8509,'/legacy-runtime-config',0.0,0,0,0
8510,8510,'/link-external/push',0.0,0,0,0
8511,8511,'/link-external/replace',0.0,0,0,0
8512,8512,'/link-hard-push/123',0.0,0,0,0
8513,8513,'/link-hard-replace/123',0.0,0,0,0
8514,8514,'/link-soft-push',0.0,0,0,0
8515,8515,'/link-to-rewritten-path',0.0,0,0,0
8516,8516,'/link-with-as',0.0,0,0,0
8517,8517,'/linking/about',0.0,0,0,0
8518,8518,'/loading-bug/electronics',0.0,0,0,0
8519,8519,'/loading-bug/hi',0.0,0,0,0
8520,8520,'/local-font',0.0,0,0,0
8521,8521,'/manifest.webmanifest',0.0,0,0,0
8522,8522,'/mdx',0.0,0,0,0
8523,8523,'/metadata-base/unset',0.0,0,0,0
8524,8524,'/metadata-base/url',0.0,0,0,0
8525,8525,'/metadata-base/url-instance',0.0,0,0,0
8526,8526,'/methods/head',0.0,0,0,0
8527,8527,'/methods/options',0.0,0,0,0
8528,8528,'/middleware-external-rewrite-body',0.0,0,0,0
8529,8529,'/middleware-redirect-external-with',0.0,0,0,0
8530,8530,'/middleware-redirect-external-without',0.0,0,0,0
8531,8531,'/middleware-response-body',0.0,0,0,0
8532,8532,'/middleware.js',0.0,0,0,0
8533,8533,'/middleware/works',0.0,0,0,0
8534,8534,'/missing-tags',0.0,0,0,0
8535,8535,'/mock-renderer.html',0.0,0,0,0
8536,8536,'/modules',0.0,0,0,0
8537,8537,'/multi',0.0,0,0,0
8538,8538,'/multi-byte',0.0,0,0,0
8539,8539,'/multiple-children',0.0,0,0,0
8540,8540,'/my-path',0.0,0,0,0
8541,8541,'/my/path/name',0.0,0,0,0
8542,8542,'/native-module',0.0,0,0,0
8543,8543,'/nav/about',0.0,0,0,0
8544,8544,'/navigation',0.0,0,0,0
8545,8545,'/navigation/refresh/navigate-then-refresh-bug',0.0,0,0,0
8546,8546,'/nested',0.0,0,0,0
8547,8547,'/nested-link',0.0,0,0,0
8548,8548,'/nested-navigation',0.0,0,0,0
8549,8549,'/next-api/image-legacy',0.0,0,0,0
8550,8550,'/next-api/image-new',0.0,0,0,0
8551,8551,'/nl/to-new',0.0,0,0,0
8552,8552,'/no-preconnect',0.0,0,0,0
8553,8553,'/no-preload',0.0,0,0,0
8554,8554,'/node-ssr',0.0,0,0,0
8555,8555,'/non-conflict',0.0,0,0,0
8556,8556,'/non-conflict-pages',0.0,0,0,0
8557,8557,'/non-existent',0.0,0,0,0
8558,8558,'/non-existent-child',0.0,0,0,0
8559,8559,'/non-json',0.0,0,0,0
8560,8560,'/non-json-blocking/[p]',0.0,0,0,0
8561,8561,'/non-json-blocking/foobar',0.0,0,0,0
8562,8562,'/non-json/[p]',0.0,0,0,0
8563,8563,'/non-json/[p].html',0.0,0,0,0
8564,8564,'/non-json/direct',0.0,0,0,0
8565,8565,'/non-json/foobar',0.0,0,0,0
8566,8566,'/noop-layout/page-1',0.0,0,0,0
8567,8567,'/normal',0.0,0,0,0
8568,8568,'/not-found',0.0,0,0,0
8569,8569,'/not-found/client-side',0.0,0,0,0
8570,8570,'/not-found/clientcomponent',0.0,0,0,0
8571,8571,'/not-found/first',0.0,0,0,0
8572,8572,'/not-found/servercomponent',0.0,0,0,0
8573,8573,'/not-found/suspense',0.0,0,0,0
8574,8574,'/noto-sans-v27-latin-regular.ttf',0.0,0,0,0
8575,8575,'/object',0.0,0,0,0
8576,8576,'/object/slug',0.0,0,0,0
8577,8577,'/og',0.0,0,0,0
8578,8578,'/og-node',0.0,0,0,0
8579,8579,'/opengraph',0.0,0,0,0
8580,8580,'/opengraph-image',0.0,0,0,0
8581,8581,'/opengraph/article',0.0,0,0,0
8582,8582,'/opengraph/static',0.0,0,0,0
8583,8583,'/optional-catchall',0.0,0,0,0
8584,8584,'/optional-catchall/something/another',0.0,0,0,0
8585,8585,'/ordering',0.0,0,0,0
8586,8586,'/other-page',0.0,0,0,0
8587,8587,'/other-touch-icon.png',0.0,0,0,0
8588,8588,'/p/[...rest]',0.0,0,0,0
8589,8589,'/p1/[[...incl]]',0.0,0,0,0
8590,8590,'/p2/[...rest]',0.0,0,0,0
8591,8591,'/p2/[id]',0.0,0,0,0
8592,8592,'/p2/[id]/abc',0.0,0,0,0
8593,8593,'/p3/[[...rest]]',0.0,0,0,0
8594,8594,'/p3/[id]',0.0,0,0,0
8595,8595,'/p3/[id]/abc',0.0,0,0,0
8596,8596,'/page',0.0,0,0,0
8597,8597,'/page-with-fonts',0.0,0,0,0
8598,8598,'/page-with-h1',0.0,0,0,0
8599,8599,'/page-with-loading',0.0,0,0,0
8600,8600,'/page.ts',0.0,0,0,0
8601,8601,'/page1',0.0,0,0,0
8602,8602,'/page1.md',0.0,0,0,0
8603,8603,'/pages',0.0,0,0,0
8604,8604,'/pages-edge',0.0,0,0,0
8605,8605,'/pages-linking',0.0,0,0,0
8606,8606,'/pages-react-edge',0.0,0,0,0
8607,8607,'/pages/_app.css',0.0,0,0,0
8608,8608,'/pages/import',0.0,0,0,0
8609,8609,'/pages/param/getServerSideProps',0.0,0,0,0
8610,8610,'/pages/param/getStaticProps',0.0,0,0,0
8611,8611,'/parallel-catchall',0.0,0,0,0
8612,8612,'/parallel-dynamic/foo/bar',0.0,0,0,0
8613,8613,'/parallel-layout',0.0,0,0,0
8614,8614,'/parallel-no-page/foo',0.0,0,0,0
8615,8615,'/parallel-non-intercepting',0.0,0,0,0
8616,8616,'/parallel-prefetch-false',0.0,0,0,0
8617,8617,'/parallel-scroll',0.0,0,0,0
8618,8618,'/parallel-side-bar/nested/deeper',0.0,0,0,0
8619,8619,'/parallel-tab-bar',0.0,0,0,0
8620,8620,'/parallel/nested',0.0,0,0,0
8621,8621,'/parallel/nested-2',0.0,0,0,0
8622,8622,'/param-and-query/params?slug=query',0.0,0,0,0
8623,8623,'/partial-gen-params-no-additional-lang/[lang]/[slug].rsc',0.0,0,0,0
8624,8624,'/partial-gen-params-no-additional-lang/de/first',0.0,0,0,0
8625,8625,'/partial-gen-params-no-additional-lang/en',0.0,0,0,0
8626,8626,'/partial-gen-params-no-additional-lang/en/RAND',0.0,0,0,0
8627,8627,'/partial-gen-params-no-additional-lang/en/RAND.rsc',0.0,0,0,0
8628,8628,'/partial-gen-params-no-additional-lang/en/first',0.0,0,0,0
8629,8629,'/partial-gen-params-no-additional-lang/en/first.rsc',0.0,0,0,0
8630,8630,'/partial-gen-params-no-additional-lang/en/non-existent',0.0,0,0,0
8631,8631,'/partial-gen-params-no-additional-lang/en/second',0.0,0,0,0
8632,8632,'/partial-gen-params-no-additional-lang/en/second.rsc',0.0,0,0,0
8633,8633,'/partial-gen-params-no-additional-lang/fr/RAND',0.0,0,0,0
8634,8634,'/partial-gen-params-no-additional-lang/fr/RAND.rsc',0.0,0,0,0
8635,8635,'/partial-gen-params-no-additional-lang/fr/first',0.0,0,0,0
8636,8636,'/partial-gen-params-no-additional-lang/fr/first.rsc',0.0,0,0,0
8637,8637,'/partial-gen-params-no-additional-lang/fr/second',0.0,0,0,0
8638,8638,'/partial-gen-params-no-additional-lang/fr/second.rsc',0.0,0,0,0
8639,8639,'/partial-gen-params-no-additional-slug/[lang]/[slug].rsc',0.0,0,0,0
8640,8640,'/partial-gen-params-no-additional-slug/de/first',0.0,0,0,0
8641,8641,'/partial-gen-params-no-additional-slug/en',0.0,0,0,0
8642,8642,'/partial-gen-params-no-additional-slug/en/RAND',0.0,0,0,0
8643,8643,'/partial-gen-params-no-additional-slug/en/RAND.rsc',0.0,0,0,0
8644,8644,'/partial-gen-params-no-additional-slug/en/first',0.0,0,0,0
8645,8645,'/partial-gen-params-no-additional-slug/en/first.rsc',0.0,0,0,0
8646,8646,'/partial-gen-params-no-additional-slug/en/non-existent',0.0,0,0,0
8647,8647,'/partial-gen-params-no-additional-slug/en/second',0.0,0,0,0
8648,8648,'/partial-gen-params-no-additional-slug/en/second.rsc',0.0,0,0,0
8649,8649,'/partial-gen-params-no-additional-slug/fr/RAND',0.0,0,0,0
8650,8650,'/partial-gen-params-no-additional-slug/fr/RAND.rsc',0.0,0,0,0
8651,8651,'/partial-gen-params-no-additional-slug/fr/first',0.0,0,0,0
8652,8652,'/partial-gen-params-no-additional-slug/fr/first.rsc',0.0,0,0,0
8653,8653,'/partial-gen-params-no-additional-slug/fr/second',0.0,0,0,0
8654,8654,'/partial-gen-params-no-additional-slug/fr/second.rsc',0.0,0,0,0
8655,8655,'/partial-gen-params/en/first',0.0,0,0,0
8656,8656,'/partial-hydration',0.0,0,0,0
8657,8657,'/path/page.tsx',0.0,0,0,0
8658,8658,'/path/to/file',0.0,0,0,0
8659,8659,'/pizza',0.0,0,0,0
8660,8660,'/pizza?foo=bar',0.0,0,0,0
8661,8661,'/preconnect-url',0.0,0,0,0
8662,8662,'/prefered',0.0,0,0,0
8663,8663,'/prefetch-false/initial',0.0,0,0,0
8664,8664,'/product/shirts_and_tops/mens_ua_playoff_polo_2.0/1327037',0.0,0,0,0
8665,8665,'/product/shirts_and_tops/mens_ua_playoff_polo_2.0/1327037.html',0.0,0,0,0
8666,8666,'/promise/mutate-res',0.0,0,0,0
8667,8667,'/promise/mutate-res-no-streaming',0.0,0,0,0
8668,8668,'/promise/mutate-res-props',0.0,0,0,0
8669,8669,'/random-content',0.0,0,0,0
8670,8670,'/random-non-existing-path',0.0,0,0,0
8671,8671,'/react-cache',0.0,0,0,0
8672,8672,'/react-cache/client-component',0.0,0,0,0
8673,8673,'/react-cache/server-component',0.0,0,0,0
8674,8674,'/react-fetch',0.0,0,0,0
8675,8675,'/react-fetch/server-component',0.0,0,0,0
8676,8676,'/react-server',0.0,0,0,0
8677,8677,'/react-server/3rd-party-package',0.0,0,0,0
8678,8678,'/react-server/optout',0.0,0,0,0
8679,8679,'/redirect-1',0.0,0,0,0
8680,8680,'/redirect-dest',0.0,0,0,0
8681,8681,'/redirect-me',0.0,0,0,0
8682,8682,'/redirect-middleware-to-dashboard',0.0,0,0,0
8683,8683,'/redirect-no-basepath',0.0,0,0,0
8684,8684,'/redirect-to-somewhere',0.0,0,0,0
8685,8685,'/redirect-to-somewhere/',0.0,0,0,0
8686,8686,'/redirect-with-basepath',0.0,0,0,0
8687,8687,'/redirect/a',0.0,0,0,0
8688,8688,'/redirect/client-side',0.0,0,0,0
8689,8689,'/redirect/clientcomponent',0.0,0,0,0
8690,8690,'/redirect/external',0.0,0,0,0
8691,8691,'/redirect/next-config-redirect',0.0,0,0,0
8692,8692,'/redirect/next-middleware-redirect',0.0,0,0,0
8693,8693,'/redirect/servercomponent',0.0,0,0,0
8694,8694,'/redirect/suspense',0.0,0,0,0
8695,8695,'/refresh',0.0,0,0,0
8696,8696,'/renderer.html',0.0,0,0,0
8697,8697,'/renderer.html?fixtureId=%7B%22path%22%3A%22%2Fpath%2Fto%2Ffixture.js%22%2C%22name%22%3A%22first%22%7D&locked=true',0.0,0,0,0
8698,8698,'/renderer.html?fixtureId=%7B%22path%22%3A%22%2Fpath%2Fto%2Ffixture.js%22%2C%22name%22%3A%22first%22%7D',0.0,0,0,0
8699,8699,'/requests',0.0,0,0,0
8700,8700,'/response-url',0.0,0,0,0
8701,8701,'/return-null/component',0.0,0,0,0
8702,8702,'/return-null/layout',0.0,0,0,0
8703,8703,'/return-null/page',0.0,0,0,0
8704,8704,'/return-undefined/component',0.0,0,0,0
8705,8705,'/return-undefined/layout',0.0,0,0,0
8706,8706,'/return-undefined/page',0.0,0,0,0
8707,8707,'/rewrite-1',0.0,0,0,0
8708,8708,'/rewrite-3',0.0,0,0,0
8709,8709,'/rewrite-3/',0.0,0,0,0
8710,8710,'/rewrite-me',0.0,0,0,0
8711,8711,'/rewrite-me-dynamic',0.0,0,0,0
8712,8712,'/rewrite-me-dynamic?hello=world',0.0,0,0,0
8713,8713,'/rewrite-me?hello=world',0.0,0,0,0
8714,8714,'/rewrite-no-basePath',0.0,0,0,0
8715,8715,'/rewrite-no-basepath',0.0,0,0,0
8716,8716,'/rewrite-to-config-rewrite',0.0,0,0,0
8717,8717,'/rewrite-to-config-rewrite/',0.0,0,0,0
8718,8718,'/rewrite-to-dynamic',0.0,0,0,0
8719,8719,'/rewrite-to-dynamic/',0.0,0,0,0
8720,8720,'/rewrite/edge',0.0,0,0,0
8721,8721,'/rewrites',0.0,0,0,0
8722,8722,'/rewritten-to-dashboard',0.0,0,0,0
8723,8723,'/rewritten-use-search-params?first=a&second=b&third=c',0.0,0,0,0
8724,8724,'/roboto',0.0,0,0,0
8725,8725,'/robots',0.0,0,0,0
8726,8726,'/robots.txt',0.0,0,0,0
8727,8727,'/robots.txt/route',0.0,0,0,0
8728,8728,'/root-layout-a',0.0,0,0,0
8729,8729,'/root-test',0.0,0,0,0
8730,8730,'/root/es/bar',0.0,0,0,0
8731,8731,'/root/example',0.0,0,0,0
8732,8732,'/route',0.0,0,0,0
8733,8733,'/route-group',0.0,0,0,0
8734,8734,'/route-handler/static-cookies/route',0.0,0,0,0
8735,8735,'/route/second/inner',0.0,0,0,0
8736,8736,'/router',0.0,0,0,0
8737,8737,'/s/oswald/v49/TK3iWkUHHAIjg752FD8Gl-1PK62t.woff2',0.0,0,0,0
8738,8738,'/s/oswald/v49/TK3iWkUHHAIjg752Fj8Gl-1PK62t.woff2',0.0,0,0,0
8739,8739,'/s/oswald/v49/TK3iWkUHHAIjg752Fz8Gl-1PK62t.woff2',0.0,0,0,0
8740,8740,'/s/oswald/v49/TK3iWkUHHAIjg752GT8Gl-1PKw.woff2',0.0,0,0,0
8741,8741,'/s/oswald/v49/TK3iWkUHHAIjg752HT8Gl-1PK62t.woff2',0.0,0,0,0
8742,8742,'/same-layout/first',0.0,0,0,0
8743,8743,'/script',0.0,0,0,0
8744,8744,'/scss-modules',0.0,0,0,0
8745,8745,'/search-params-prop-middleware-rewrite',0.0,0,0,0
8746,8746,'/search-params-prop-rewrite',0.0,0,0,0
8747,8747,'/search-params-prop-server-middleware-rewrite',0.0,0,0,0
8748,8748,'/search-params-prop-server-rewrite',0.0,0,0,0
8749,8749,'/search-params-prop/server?first=value&second=other%20value&third',0.0,0,0,0
8750,8750,'/search-params-prop?first=value&second=other%20value&third',0.0,0,0,0
8751,8751,'/search-params?name=名',0.0,0,0,0
8752,8752,'/searchparams-normalization-bug',0.0,0,0,0
8753,8753,'/segment-name/param1/different-segment',0.0,0,0,0
8754,8754,'/segment-name/param1/segment-name2/different-value/value3/value4',0.0,0,0,0
8755,8755,'/segment-name/param1/segment-name2/value2/different/random/paths',0.0,0,0,0
8756,8756,'/send-url',0.0,0,0,0
8757,8757,'/send-url/',0.0,0,0,0
8758,8758,'/server',0.0,0,0,0
8759,8759,'/server-component-page?search=hello',0.0,0,0,0
8760,8760,'/server-component-without-searchparams?search=hello',0.0,0,0,0
8761,8761,'/server/edge',0.0,0,0,0
8762,8762,'/sha',0.0,0,0,0
8763,8763,'/sha/',0.0,0,0,0
8764,8764,'/shared',0.0,0,0,0
8765,8765,'/shared-component-route',0.0,0,0,0
8766,8766,'/shared-esm-dep',0.0,0,0,0
8767,8767,'/shortcut-icon.png',0.0,0,0,0
8768,8768,'/should-not-serve-client',0.0,0,0,0
8769,8769,'/should-not-serve-client.client',0.0,0,0,0
8770,8770,'/should-not-serve-client.client.js',0.0,0,0,0
8771,8771,'/should-not-serve-server',0.0,0,0,0
8772,8772,'/should-not-serve-server.server',0.0,0,0,0
8773,8773,'/should-not-serve-server.server.js',0.0,0,0,0
8774,8774,'/sitemap.xml',0.0,0,0,0
8775,8775,'/sitemap.xml/route',0.0,0,0,0
8776,8776,'/slow-layout-and-page-with-loading/slow',0.0,0,0,0
8777,8777,'/slow-layout-with-loading/slow',0.0,0,0,0
8778,8778,'/slow-page-no-loading/page',0.0,0,0,0
8779,8779,'/slow-page-with-loading',0.0,0,0,0
8780,8780,'/slow-page-with-loading/page',0.0,0,0,0
8781,8781,'/some-other-page',0.0,0,0,0
8782,8782,'/some/path',0.0,0,0,0
8783,8783,'/some/path?amp=1&page=10',0.0,0,0,0
8784,8784,'/some/path?amp=1',0.0,0,0,0
8785,8785,'/some/path?page=10&amp=1&last=here',0.0,0,0,0
8786,8786,'/some/path?page=10&amp=1',0.0,0,0,0
8787,8787,'/some/path?page=10&last=here',0.0,0,0,0
8788,8788,'/some/path?page=10',0.0,0,0,0
8789,8789,'/someA/someF/pathG',0.0,0,0,0
8790,8790,'/somewhere',0.0,0,0,0
8791,8791,'/somewhere/',0.0,0,0,0
8792,8792,'/source-match',0.0,0,0,0
8793,8793,'/src1',0.0,0,0,0
8794,8794,'/ssg',0.0,0,0,0
8795,8795,'/ssg-draft-mode',0.0,0,0,0
8796,8796,'/ssg-draft-mode.rsc',0.0,0,0,0
8797,8797,'/ssg-draft-mode/[[...route]].rsc',0.0,0,0,0
8798,8798,'/ssg-draft-mode/test',0.0,0,0,0
8799,8799,'/ssg-draft-mode/test-2',0.0,0,0,0
8800,8800,'/ssg-draft-mode/test-2.rsc',0.0,0,0,0
8801,8801,'/ssg-draft-mode/test.rsc',0.0,0,0,0
8802,8802,'/ssg/[slug]',0.0,0,0,0
8803,8803,'/ssg/first',0.0,0,0,0
8804,8804,'/ssg/first/',0.0,0,0,0
8805,8805,'/ssr',0.0,0,0,0
8806,8806,'/ssr-auto/cache-no-store',0.0,0,0,0
8807,8807,'/ssr-only/nested',0.0,0,0,0
8808,8808,'/ssr-only/slow',0.0,0,0,0
8809,8809,'/ssr-page',0.0,0,0,0
8810,8810,'/start',0.0,0,0,0
8811,8811,'/state',0.0,0,0,0
8812,8812,'/static-missing-tags/slug',0.0,0,0,0
8813,8813,'/static-mpa-navigation/slug1',0.0,0,0,0
8814,8814,'/static-only/nested',0.0,0,0,0
8815,8815,'/static-page',0.0,0,0,0
8816,8816,'/static-to-dynamic-error-forced',0.0,0,0,0
8817,8817,'/static-to-dynamic-error-forced/[id]',0.0,0,0,0
8818,8818,'/static-to-dynamic-error-forced/[id].rsc',0.0,0,0,0
8819,8819,'/static-to-dynamic-error-forced/static-bailout-1',0.0,0,0,0
8820,8820,'/static/opengraph-image',0.0,0,0,0
8821,8821,'/status/405',0.0,0,0,0
8822,8822,'/status/500',0.0,0,0,0
8823,8823,'/status/500/next',0.0,0,0,0
8824,8824,'/streaming-rsc',0.0,0,0,0
8825,8825,'/string',0.0,0,0,0
8826,8826,'/styleguide/#!/FooBar',0.0,0,0,0
8827,8827,'/styleguide/#!/FooBar/0',0.0,0,0,0
8828,8828,'/styleguide/#!/FooBar/3',0.0,0,0,0
8829,8829,'/styleguide/#foobar',0.0,0,0,0
8830,8830,'/styleguide/',0.0,0,0,0
8831,8831,'/styleguide/?nochrome#!/FooBar',0.0,0,0,0
8832,8832,'/subscribers',0.0,0,0,0
8833,8833,'/suspensey-css',0.0,0,0,0
8834,8834,'/sv/static',0.0,0,0,0
8835,8835,'/sv/static?param=1',0.0,0,0,0
8836,8836,'/temp/hello',0.0,0,0,0
8837,8837,'/temp2/hello',0.0,0,0,0
8838,8838,'/template/clientcomponent',0.0,0,0,0
8839,8839,'/template/servercomponent',0.0,0,0,0
8840,8840,'/test-middleware',0.0,0,0,0
8841,8841,'/test-page/page',0.0,0,0,0
8842,8842,'/test-pages',0.0,0,0,0
8843,8843,'/test-pages-esm',0.0,0,0,0
8844,8844,'/testabc',0.0,0,0,0
8845,8845,'/this-path-does-not-exist',0.0,0,0,0
8846,8846,'/throw',0.0,0,0,0
8847,8847,'/title',0.0,0,0,0
8848,8848,'/title-template',0.0,0,0,0
8849,8849,'/title-template/extra',0.0,0,0,0
8850,8850,'/title-template/extra/inner',0.0,0,0,0
8851,8851,'/title-template/extra/inner/deep',0.0,0,0,0
8852,8852,'/title-template/use-layout-title',0.0,0,0,0
8853,8853,'/title/robots.txt',0.0,0,0,0
8854,8854,'/title/sitemap.xml',0.0,0,0,0
8855,8855,'/to-blog/first',0.0,0,0,0
8856,8856,'/to-ssg.json',0.0,0,0,0
8857,8857,'/to/some/404/path',0.0,0,0,0
8858,8858,'/trigger-404',0.0,0,0,0
8859,8859,'/trigger-error',0.0,0,0,0
8860,8860,'/twitter',0.0,0,0,0
8861,8861,'/twitter-image',0.0,0,0,0
8862,8862,'/twitter-image/route',0.0,0,0,0
8863,8863,'/twitter-image2',0.0,0,0,0
8864,8864,'/twitter/app',0.0,0,0,0
8865,8865,'/twitter/large-image',0.0,0,0,0
8866,8866,'/twitter/player',0.0,0,0,0
8867,8867,'/url-prop',0.0,0,0,0
8868,8868,'/use-params-pages',0.0,0,0,0
8869,8869,'/user/[user]/profile',0.0,0,0,0
8870,8870,'/user/[user]/profile.html',0.0,0,0,0
8871,8871,'/user/user-1/profile',0.0,0,0,0
8872,8872,'/variable-config-revalidate/revalidate-3.rsc',0.0,0,0,0
8873,8873,'/variable-font-without-weight-range',0.0,0,0,0
8874,8874,'/variable-revalidate/authorization.rsc',0.0,0,0,0
8875,8875,'/variable-revalidate/cookie.rsc',0.0,0,0,0
8876,8876,'/variable-revalidate/encoding.rsc',0.0,0,0,0
8877,8877,'/variable-revalidate/headers-instance.rsc',0.0,0,0,0
8878,8878,'/variable-revalidate/post-method.rsc',0.0,0,0,0
8879,8879,'/variable-revalidate/revalidate-3.rsc',0.0,0,0,0
8880,8880,'/variable-revalidate/revalidate-360',0.0,0,0,0
8881,8881,'/variable-revalidate/revalidate-360-isr.rsc',0.0,0,0,0
8882,8882,'/variables',0.0,0,0,0
8883,8883,'/vercel-user',0.0,0,0,0
8884,8884,'/verification',0.0,0,0,0
8885,8885,'/very-large-data-fetch',0.0,0,0,0
8886,8886,'/view-duration',0.0,0,0,0
8887,8887,'/wildcard',0.0,0,0,0
8888,8888,'/with-cookies',0.0,0,0,0
8889,8889,'/with-fallback',0.0,0,0,0
8890,8890,'/with-fonts',0.0,0,0,0
8891,8891,'/with-google-fonts',0.0,0,0,0
8892,8892,'/with-id',0.0,0,0,0
8893,8893,'/with-local-fonts',0.0,0,0,0
8894,8894,'/with-middleware',0.0,0,0,0
8895,8895,'/with-parallel-routes',0.0,0,0,0
8896,8896,'/without-fonts',0.0,0,0,0
8897,8897,'/world',0.0,0,0,0
8898,8898,'0%',0.0,0,0,0
8899,8899,"'0, 255, 255'",0.0,0,0,0
8900,8900,'0.05s',0.0,0,0,0
8901,8901,'0.15s',0.0,0,0,0
8902,8902,'0/my/id',0.0,0,0,0
8903,8903,'0px 0px -50%',0.0,0,0,0
8904,8904,'0px',0.0,0,0,0
8905,8905,'0s',0.0,0,0,0
8906,8906,'1.0.0',0.0,0,0,0
8907,8907,'1.js',0.0,0,0,0
8908,8908,'100.3%',0.0,0,0,0
8909,8909,'1001',0.0,0,0,0
8910,8910,'101.1%',0.0,0,0,0
8911,8911,'103.26%',0.0,0,0,0
8912,8912,'107.4%',0.0,0,0,0
8913,8913,'10px',0.0,0,0,0
8914,8914,'11.2.3',0.0,0,0,0
8915,8915,'114x114',0.0,0,0,0
8916,8916,'115.45%',0.0,0,0,0
8917,8917,'116.03%',0.0,0,0,0
8918,8918,'1234',0.0,0,0,0
8919,8919,'127.0.0.1',0.0,0,0,0
8920,8920,'180x180',0.0,0,0,0
8921,8921,'1px',0.0,0,0,0
8922,8922,'2.js',0.0,0,0,0
8923,8923,'2023-01-01T00:00:00.000Z',0.0,0,0,0
8924,8924,'21.98%',0.0,0,0,0
8925,8925,'22.09%',0.0,0,0,0
8926,8926,'22.48%',0.0,0,0,0
8927,8927,'24.34%',0.0,0,0,0
8928,8928,'3001',0.0,0,0,0
8929,8929,'32x32',0.0,0,0,0
8930,8930,'4',0.0,0,0,0
8931,8931,'42',0.0,0,0,0
8932,8932,'5',0.0,0,0,0
8933,8933,'50.85%',0.0,0,0,0
8934,8934,'50px',0.0,0,0,0
8935,8935,'51.94%',0.0,0,0,0
8936,8936,'512x512',0.0,0,0,0
8937,8937,'6',0.0,0,0,0
8938,8938,'64x64',0.0,0,0,0
8939,8939,'72x72',0.0,0,0,0
8940,8940,'7px',0.0,0,0,0
8941,8941,'80',0.0,0,0,0
8942,8942,'80px',0.0,0,0,0
8943,8943,'84.29%',0.0,0,0,0
8944,8944,'84.71%',0.0,0,0,0
8945,8945,'89',0.0,0,0,0
8946,8946,'90.2%',0.0,0,0,0
8947,8947,'900',0.0,0,0,0
8948,8948,'92.49%',0.0,0,0,0
8949,8949,'94%',0.0,0,0,0
8950,8950,'96.02%',0.0,0,0,0
8951,8951,':scope > li > .active',0.0,0,0,0
8952,8952,'; ',0.0,0,0,0
8953,8953,';',0.0,0,0,0
8954,8954,'<!-- Comment-->',0.0,0,0,0
8955,8955,'</a>',0.0,0,0,0
8956,8956,'</body></html>',0.0,0,0,0
8957,8957,'</details>',0.0,0,0,0
8958,8958,'</div> */}',0.0,0,0,0
8959,8959,'</nav>',0.0,0,0,0
8960,8960,'</style>',0.0,0,0,0
8961,8961,"'<?xml version=""1.0"" encoding=""UTF-8""?>'",0.0,0,0,0
8962,8962,"'<a data-bs-toggle=""modal"" href=""#"" data-bs-target=""#exampleModal"" style=""display: none;""></a>'",0.0,0,0,0
8963,8963,"'<a data-bs-toggle=""modal"" href=""#"" data-bs-target=""#exampleModal""></a>'",0.0,0,0,0
8964,8964,"'<a href=""#"" data-bs-content="""" title="""">Nice link</a>'",0.0,0,0,0
8965,8965,"'<a href=""#"" data-bs-content="""" title=""Title which does not require content"">Nice link</a>'",0.0,0,0,0
8966,8966,"'<a href=""#"" data-bs-toggle=""offcanvas"" data-bs-target=""#offcanvasdiv1"" class=""disabled""></a>'",0.0,0,0,0
8967,8967,"'<a href=""#"" id=""outside"">outside</a>'",0.0,0,0,0
8968,8968,"'<a href=""#"" id=""tooltipEl"" rel=""tooltip"" title=""Nice and short title""></a>'",0.0,0,0,0
8969,8969,"'<a href=""#"" rel=""tooltip"" aria-label=""Different label"" title=""Another tooltip""></a>'",0.0,0,0,0
8970,8970,"'<a href=""#"" rel=""tooltip"" data-bs-offset=""10,20"" title=""Another tooltip""></a>'",0.0,0,0,0
8971,8971,"'<a href=""#"" rel=""tooltip"" data-bs-sanitize=""false"" title=""Another tooltip""></a>'",0.0,0,0,0
8972,8972,"'<a href=""#"" rel=""tooltip"" data-bs-title=""Another tooltip""></a>'",0.0,0,0,0
8973,8973,"'<a href=""#"" rel=""tooltip"" title=""""></a>'",0.0,0,0,0
8974,8974,"'<a href=""#"" rel=""tooltip"" title=""A tooltip""><span>    </span></a>'",0.0,0,0,0
8975,8975,"'<a href=""#"" rel=""tooltip"" title=""Another tooltip"" data-bs-custom-class=""custom-class""></a>'",0.0,0,0,0
8976,8976,"'<a href=""#"" rel=""tooltip"" title=""Another tooltip"" data-bs-delay=\'{""show"":0,""hide"":150}\'>'",0.0,0,0,0
8977,8977,"'<a href=""#"" rel=""tooltip"" title=""Another tooltip"" data-bs-placement=""top"" style=""position:fixed;left:50%;top:50%;"">Trigger</a>'",0.0,0,0,0
8978,8978,"'<a href=""#"" rel=""tooltip"" title=""Another tooltip"">'",0.0,0,0,0
8979,8979,"'<a href=""#"" rel=""tooltip"" title=""Another tooltip""></a>'",0.0,0,0,0
8980,8980,"'<a href=""#"" rel=""tooltip"" title=""Another tooltip"">text content</a>'",0.0,0,0,0
8981,8981,"'<a href=""#"" rel=""tooltip"" title=""Offset from function""></a>'",0.0,0,0,0
8982,8982,"'<a href=""#"" rel=""tooltip""></a>'",0.0,0,0,0
8983,8983,"'<a href=""#"" style=""display: none"" rel=""tooltip"" title=""Another tooltip""></a>'",0.0,0,0,0
8984,8984,"'<a href=""#"" title=""Popover"" data-bs-content=""https://twitter.com/getbootstrap"" data-bs-custom-class=""custom-class"">BS twitter</a>'",0.0,0,0,0
8985,8985,"'<a href=""#"" title=""Popover"" data-bs-content=""https://twitter.com/getbootstrap"">BS twitter</a>'",0.0,0,0,0
8986,8986,"'<a href=""#"" title=""Popover"">BS twitter</a>'",0.0,0,0,0
8987,8987,"'<a href=""#"">BS twitter</a>'",0.0,0,0,0
8988,8988,"'<a href=""#"">Nice link</a>'",0.0,0,0,0
8989,8989,"'<a href=""test.com"" id=""preserve-my-id"" class=""preserve-my-class"">Something</a>'",0.0,0,0,0
8990,8990,"'<a id=""link1"" role=""button"" data-bs-toggle=""collapse"" class=""collapsed"" href=""#"" data-bs-target=""#test1""></a>'",0.0,0,0,0
8991,8991,"'<a id=""link1"" role=""button"" data-bs-toggle=""collapse"" href=""#"" data-bs-target=""#test1""></a>'",0.0,0,0,0
8992,8992,"'<a id=""link2"" role=""button"" data-bs-toggle=""collapse"" class=""collapsed"" href=""#"" data-bs-target=""#test1""></a>'",0.0,0,0,0
8993,8993,"'<a id=""link2"" role=""button"" data-bs-toggle=""collapse"" href=""#"" data-bs-target=""#test1""></a>'",0.0,0,0,0
8994,8994,"'<a id=""test"" data-bs-target=""#"" href="".target""></a>'",0.0,0,0,0
8995,8995,"'<a id=""test"" data-bs-target=""#"" href=""foo/bar.html""></a>'",0.0,0,0,0
8996,8996,"'<a id=""test"" data-bs-target=""#"" href=""foo/bar.html#target""></a>'",0.0,0,0,0
8997,8997,"'<a id=""test"" href="".target""></a>'",0.0,0,0,0
8998,8998,"'<a id=""trigger1"" role=""button"" data-bs-toggle=""collapse"" href=""#test1""></a>'",0.0,0,0,0
8999,8999,"'<a id=""trigger2"" role=""button"" data-bs-toggle=""collapse"" href=""#0/my/id""></a>'",0.0,0,0,0
9000,9000,"'<a id=""trigger3"" role=""button"" data-bs-toggle=""collapse"" href="".multi""></a>'",0.0,0,0,0
9001,9001,"'<a role=""button"" data-bs-toggle=""collapse"" class=""collapsed"" href=""#collapse"">'",0.0,0,0,0
9002,9002,"'<a role=""button"" data-bs-toggle=""collapse"" class=""collapsed"" href="".multi""></a>'",0.0,0,0,0
9003,9003,"'<a role=""button"" data-bs-toggle=""collapse"" href="".multi""></a>'",0.0,0,0,0
9004,9004,'<a>lorem</a>',0.0,0,0,0
9005,9005,'<b>Trigger</b>',0.0,0,0,0
9006,9006,"'<button class=""btn testParent"" data-bs-toggle=""button""><div class=""test""></div></button>'",0.0,0,0,0
9007,9007,"'<button class=""btn"" data-bs-toggle=""button"" aria-pressed=""false""></button>'",0.0,0,0,0
9008,9008,"'<button class=""btn"" data-bs-toggle=""button""></button>'",0.0,0,0,0
9009,9009,"'<button class=""btn"" data-bs-toggle=""button"">btn</button>'",0.0,0,0,0
9010,9010,"'<button data-bs-toggle=""button"">Placeholder</button>'",0.0,0,0,0
9011,9011,"'<button data-bs-toggle=""modal""  data-bs-target=""#modal2""></button>'",0.0,0,0,0
9012,9012,"'<button disabled=""true"">lorem</button>'",0.0,0,0,0
9013,9013,"'<button id=""btn"" data-bs-toggle=""offcanvas"" data-bs-target=""#offcanvas""></button>'",0.0,0,0,0
9014,9014,"'<button id=""btn2"" data-bs-toggle=""offcanvas"" data-bs-target=""#offcanvas2""></button>'",0.0,0,0,0
9015,9015,"'<button id=""outside-focusable"">outside focusable</button>'",0.0,0,0,0
9016,9016,"'<button style=""display:none;"">lorem</button>'",0.0,0,0,0
9017,9017,"'<button tabindex=""-1"">lorem</button>'",0.0,0,0,0
9018,9018,"'<button type=""button"" data-bs-dismiss=""modal"" data-bs-target=""#modal1""></button>'",0.0,0,0,0
9019,9019,"'<button type=""button"" data-bs-toggle=""modal"" data-bs-target=""#exampleModal""></button>'",0.0,0,0,0
9020,9020,'<button',0.0,0,0,0
9021,9021,'<button>OK</button>',0.0,0,0,0
9022,9022,'<button>Shadow Button</button>',0.0,0,0,0
9023,9023,'<button>lorem</button>',0.0,0,0,0
9024,9024,"'<details id=""element""></details>'",0.0,0,0,0
9025,9025,'<details open>',0.0,0,0,0
9026,9026,'<details>',0.0,0,0,0
9027,9027,'<details>lorem</details>',0.0,0,0,0
9028,9028,"'<div aria-pressed=""true"">'",0.0,0,0,0
9029,9029,"'<div class=""""><div class=""nav-link""></div></div>'",0.0,0,0,0
9030,9030,"'<div class=""accordion"" id=""accordionExample"">'",0.0,0,0,0
9031,9031,"'<div class=""alert fade""></div>'",0.0,0,0,0
9032,9032,"'<div class=""alert"">'",0.0,0,0,0
9033,9033,"'<div class=""alert""></div>'",0.0,0,0,0
9034,9034,"'<div class=""btn-group"">'",0.0,0,0,0
9035,9035,"'<div class=""card"" id=""accordion1"">'",0.0,0,0,0
9036,9036,"'<div class=""card"" id=""accordion2"">'",0.0,0,0,0
9037,9037,"'<div class=""card-body"">'",0.0,0,0,0
9038,9038,"'<div class=""card-header d-block d-inline-block"">'",0.0,0,0,0
9039,9039,"'<div class=""carousel"" data-bs-ride=""true""></div>'",0.0,0,0,0
9040,9040,"'<div class=""carousel"">'",0.0,0,0,0
9041,9041,"'<div class=""carousel""></div>'",0.0,0,0,0
9042,9042,"'<div class=""collapse collapse-horizontal"" style=""width: 0px;""></div>'",0.0,0,0,0
9043,9043,"'<div class=""collapse show""></div>'",0.0,0,0,0
9044,9044,"'<div class=""collapse"" style=""height: 0px;""></div>'",0.0,0,0,0
9045,9045,"'<div class=""collapse""></div>'",0.0,0,0,0
9046,9046,"'<div class=""container"">'",0.0,0,0,0
9047,9047,"'<div class=""content"" data-bs-target=""#navBar"" style=""overflow-y: auto"">'",0.0,0,0,0
9048,9048,"'<div class=""content"" style=""overflow: auto; height: 50px"">'",0.0,0,0,0
9049,9049,"'<div class=""content"" style=""position: relative; overflow: auto; height: 100px"">'",0.0,0,0,0
9050,9050,"'<div class=""deep""></div>'",0.0,0,0,0
9051,9051,"'<div class=""dropdown"">'",0.0,0,0,0
9052,9052,"'<div class=""dropdown-center"">'",0.0,0,0,0
9053,9053,"'<div class=""dropend"">'",0.0,0,0,0
9054,9054,"'<div class=""dropstart"">'",0.0,0,0,0
9055,9055,"'<div class=""dropup"">'",0.0,0,0,0
9056,9056,"'<div class=""dropup-center"">'",0.0,0,0,0
9057,9057,"'<div class=""first dropdown"">'",0.0,0,0,0
9058,9058,"'<div class=""inner"">'",0.0,0,0,0
9059,9059,"'<div class=""list-group"" role=""tablist"">'",0.0,0,0,0
9060,9060,"'<div class=""modal fade"">'",0.0,0,0,0
9061,9061,"'<div class=""modal fade""><div class=""modal-dialog""></div></div>'",0.0,0,0,0
9062,9062,"'<div class=""modal"" data-bs-show=""false""><div class=""modal-dialog""></div></div>'",0.0,0,0,0
9063,9063,"'<div class=""modal"">'",0.0,0,0,0
9064,9064,"'<div class=""modal""><div class=""modal-dialog"" style=""transition-duration: 20ms;""></div></div>'",0.0,0,0,0
9065,9065,"'<div class=""modal""><div class=""modal-dialog"" style=""transition-duration: 50ms;""></div></div>'",0.0,0,0,0
9066,9066,"'<div class=""modal""><div class=""modal-dialog""></div></div>'",0.0,0,0,0
9067,9067,"'<div class=""modal-dialog""></div>'",0.0,0,0,0
9068,9068,"'<div class=""my-collapse"">'",0.0,0,0,0
9069,9069,"'<div class=""my-collapse""></div>'",0.0,0,0,0
9070,9070,"'<div class=""nav"">'",0.0,0,0,0
9071,9071,"'<div class=""nav""><div class=""nav-link""></div></div>'",0.0,0,0,0
9072,9072,"'<div class=""nested"">'",0.0,0,0,0
9073,9073,"'<div class=""offcanvas show""></div>'",0.0,0,0,0
9074,9074,"'<div class=""offcanvas"" data-bs-scroll=""true"" data-bs-backdrop=""false"" data-bs-keyboard=""false""></div>'",0.0,0,0,0
9075,9075,"'<div class=""offcanvas"">'",0.0,0,0,0
9076,9076,"'<div class=""offcanvas""></div>'",0.0,0,0,0
9077,9077,"'<div class=""offcanvas-lg""></div>'",0.0,0,0,0
9078,9078,"'<div class=""outer"">'",0.0,0,0,0
9079,9079,"'<div class=""parent"">'",0.0,0,0,0
9080,9080,"'<div class=""second dropdown"">'",0.0,0,0,0
9081,9081,"'<div class=""show""></div>'",0.0,0,0,0
9082,9082,"'<div class=""sibling""></div>'",0.0,0,0,0
9083,9083,"'<div class=""sticky-top"" style=""margin-right: 0px; padding-right: 0px; width: 50vw""></div>'",0.0,0,0,0
9084,9084,"'<div class=""tab-content"">'",0.0,0,0,0
9085,9085,"'<div class=""tabs"">'",0.0,0,0,0
9086,9086,"'<div class=""test""></div><button class=""btn""></button>'",0.0,0,0,0
9087,9087,"'<div class=""toast"" data-bs-autohide=""false"" data-bs-animation=""false"">'",0.0,0,0,0
9088,9088,"'<div class=""toast"" data-bs-delay=""0"" data-bs-autohide=""false"">'",0.0,0,0,0
9089,9089,"'<div class=""toast"" data-bs-delay=""1"" data-bs-animation=""false"">'",0.0,0,0,0
9090,9090,"'<div class=""toast"" data-bs-delay=""1"" data-bs-autohide=""false"" data-bs-animation=""false"">'",0.0,0,0,0
9091,9091,"'<div class=""toast"" data-bs-delay=""1"" data-bs-autohide=""false"">'",0.0,0,0,0
9092,9092,"'<div class=""toast"" data-bs-delay=""1"">'",0.0,0,0,0
9093,9093,"'<div class=""toast"">'",0.0,0,0,0
9094,9094,"'<div class=""toast""></div>'",0.0,0,0,0
9095,9095,"'<div contenteditable=""true"">lorem</div>'",0.0,0,0,0
9096,9096,"'<div data-bs-key=""value"" data-key-bs=""postfixed"" data-key=""value""></div>'",0.0,0,0,0
9097,9097,"'<div data-bs-key=""value"" data-test-bs=""postFixed"" data-toggle=""tab""></div>'",0.0,0,0,0
9098,9098,"'<div data-bs-ride=""carousel""></div>'",0.0,0,0,0
9099,9099,"'<div data-bs-test-key=""value"" ></div>'",0.0,0,0,0
9100,9100,"'<div data-bs-test-key=""value""></div>'",0.0,0,0,0
9101,9101,"'<div data-bs-test=""false"" ></div>'",0.0,0,0,0
9102,9102,"'<div data-bs-test=\'{""delay"":{""show"":100,""hide"":10}}\'></div>'",0.0,0,0,0
9103,9103,"'<div data-bs-toggle=""tabs"" data-bs-target=""#element"" data-another=""value"" data-target-bs=""#element"" data-in-bs-out=""in-between""></div>'",0.0,0,0,0
9104,9104,"'<div data-bs-toggle=""tabs"" data-bs-target=""#element"" data-bs-config=\'{""testBool"":false}\'></div>'",0.0,0,0,0
9105,9105,"'<div id=""0/my/id"" class=""multi""></div>'",0.0,0,0,0
9106,9106,"'<div id=""accordion"">'",0.0,0,0,0
9107,9107,"'<div id=""bar"" class=""test""></div>'",0.0,0,0,0
9108,9108,"'<div id=""bar""></div>'",0.0,0,0,0
9109,9109,"'<div id=""carousel"" class=""carousel slide"">'",0.0,0,0,0
9110,9110,"'<div id=""childContent"">'",0.0,0,0,0
9111,9111,"'<div id=""childContent"">Tooltip</div>'",0.0,0,0,0
9112,9112,"'<div id=""collapse"" class=""collapse""></div>'",0.0,0,0,0
9113,9113,"'<div id=""collapse1"" class=""collapse multi show""></div>'",0.0,0,0,0
9114,9114,"'<div id=""collapse1"" class=""collapse multi""></div>'",0.0,0,0,0
9115,9115,"'<div id=""collapse2"" class=""collapse multi show""></div>'",0.0,0,0,0
9116,9116,"'<div id=""collapse2"" class=""collapse multi""></div>'",0.0,0,0,0
9117,9117,"'<div id=""collapsediv1""></div>'",0.0,0,0,0
9118,9118,"'<div id=""content"" data-bs-threshold=""0,0.2,1"">'",0.0,0,0,0
9119,9119,"'<div id=""content"" style=""height: 150px; overflow-y: auto;"">'",0.0,0,0,0
9120,9120,"'<div id=""content"" style=""height: 200px; overflow-y: auto;"">'",0.0,0,0,0
9121,9121,"'<div id=""content"">'",0.0,0,0,0
9122,9122,"'<div id=""div1"">'",0.0,0,0,0
9123,9123,"'<div id=""exampleModal"" class=""modal"" style=""display: none;""><div class=""modal-dialog""></div></div>'",0.0,0,0,0
9124,9124,"'<div id=""exampleModal"" class=""modal""><div class=""modal-dialog""></div></div>'",0.0,0,0,0
9125,9125,"'<div id=""focustrap"" tabindex=""-1"">'",0.0,0,0,0
9126,9126,"'<div id=""focustrap"" tabindex=""-1""></div>'",0.0,0,0,0
9127,9127,"'<div id=""foo"" class=""test"">'",0.0,0,0,0
9128,9128,"'<div id=""foo"" class=""test""></div>'",0.0,0,0,0
9129,9129,"'<div id=""foo""></div>'",0.0,0,0,0
9130,9130,"'<div id=""header"" style=""height: 500px;""></div>'",0.0,0,0,0
9131,9131,"'<div id=""modal1"" class=""modal fade"">'",0.0,0,0,0
9132,9132,"'<div id=""modal1"" class=""modal fade""><div class=""modal-dialog""></div></div>'",0.0,0,0,0
9133,9133,"'<div id=""modal2"" class=""modal""><div class=""modal-dialog""></div></div>'",0.0,0,0,0
9134,9134,"'<div id=""myCarousel"" class=""carousel slide"" data-bs-keyboard=""false"">'",0.0,0,0,0
9135,9135,"'<div id=""myCarousel"" class=""carousel slide"" data-bs-pause=""false"">'",0.0,0,0,0
9136,9136,"'<div id=""myCarousel"" class=""carousel slide"" data-bs-ride=""carousel""></div>'",0.0,0,0,0
9137,9137,"'<div id=""myCarousel"" class=""carousel slide"" data-bs-ride=""true"">'",0.0,0,0,0
9138,9138,"'<div id=""myCarousel"" class=""carousel slide"" data-bs-ride=""true""></div>'",0.0,0,0,0
9139,9139,"'<div id=""myCarousel"" class=""carousel slide"">'",0.0,0,0,0
9140,9140,"'<div id=""myCarousel"" class=""carousel slide""></div>'",0.0,0,0,0
9141,9141,"'<div id=""myCarousel"" class=""slide"">'",0.0,0,0,0
9142,9142,"'<div id=""nav""></div>'",0.0,0,0,0
9143,9143,"'<div id=""offcanvas"" class=""offcanvas""></div>'",0.0,0,0,0
9144,9144,"'<div id=""offcanvas1"" class=""offcanvas""></div>'",0.0,0,0,0
9145,9145,"'<div id=""offcanvas2"" class=""offcanvas""></div>'",0.0,0,0,0
9146,9146,"'<div id=""offcanvasdiv1"" class=""offcanvas""></div>'",0.0,0,0,0
9147,9147,"'<div id=""panel""></div>'",0.0,0,0,0
9148,9148,"'<div id=""panel2""></div>'",0.0,0,0,0
9149,9149,"'<div id=""parentGroup"" class=""accordion"">'",0.0,0,0,0
9150,9150,"'<div id=""root"" class=""active"" style=""display: block"">'",0.0,0,0,0
9151,9151,"'<div id=""target""></div>'",0.0,0,0,0
9152,9152,"'<div id=""test"" data-bs-config=""foo"" data-bs-test-int=""8""></div>'",0.0,0,0,0
9153,9153,"'<div id=""test"" data-bs-config=\'{""testBool"":false,""testInt"":50,""testInt2"":100}\' data-bs-test-int=""8"" data-bs-test-string-1=""bar""></div>'",0.0,0,0,0
9154,9154,"'<div id=""test"" data-bs-target="".target""></div>'",0.0,0,0,0
9155,9155,"'<div id=""test"" data-bs-test-bool=""false"" data-bs-test-int=""8"" data-bs-test-string-1=""bar""></div>'",0.0,0,0,0
9156,9156,"'<div id=""test"" data-bs-test-bool=""false"" data-bs-test-int=""8"" data-bs-test-string1=""bar""></div>'",0.0,0,0,0
9157,9157,"'<div id=""test""></div>'",0.0,0,0,0
9158,9158,"'<div id=""test1"" class=""multi""></div>'",0.0,0,0,0
9159,9159,"'<div id=""test1"" class=""show""></div>'",0.0,0,0,0
9160,9160,"'<div id=""test1""></div>'",0.0,0,0,0
9161,9161,"'<div id=""wrapper"" data-bs-spy=""scroll"" data-bs-target=""#nav"" style=""overflow-y: auto""></div>'",0.0,0,0,0
9162,9162,"'<div id=""wrapper""></div>'",0.0,0,0,0
9163,9163,"'<div style=""display: none;"">'",0.0,0,0,0
9164,9164,"'<div style=""display: none;""></div>'",0.0,0,0,0
9165,9165,"'<div style=""height: 110vh"">'",0.0,0,0,0
9166,9166,"'<div style=""height: 110vh; width: 100%"">'",0.0,0,0,0
9167,9167,"'<div style=""height: 110vh; width: 100%""></div>'",0.0,0,0,0
9168,9168,"'<div style=""transition: all 300ms ease-out;""></div>'",0.0,0,0,0
9169,9169,"'<div style=""visibility: hidden;"">'",0.0,0,0,0
9170,9170,"'<div style=""visibility: hidden;""></div>'",0.0,0,0,0
9171,9171,"'<div tabindex=""0"">lorem</div>'",0.0,0,0,0
9172,9172,"'<div tabindex=""10"">lorem</div>'",0.0,0,0,0
9173,9173,'<div tabindex>lorem</div>',0.0,0,0,0
9174,9174,'<div',0.0,0,0,0
9175,9175,'<div>',0.0,0,0,0
9176,9176,'<div></div>',0.0,0,0,0
9177,9177,'<div>lorem</div>',0.0,0,0,0
9178,9178,'<h1>Hello world!</h2>',0.0,0,0,0
9179,9179,'<h1>Hello!</h1>',0.0,0,0,0
9180,9180,'<h1>Hello</h1>',0.0,0,0,0
9181,9181,'<h1>Test Page</h1>',0.0,0,0,0
9182,9182,'<html />',0.0,0,0,0
9183,9183,"'<html id=""__next_error__"">'",0.0,0,0,0
9184,9184,"'<img src=""test.jpg"">'",0.0,0,0,0
9185,9185,"'<input type=""checkbox"" data-bs-toggle=""collapse"" data-bs-target=""#collapsediv1"">'",0.0,0,0,0
9186,9186,"'<input type=""checkbox"" data-bs-toggle=""offcanvas"" data-bs-target=""#offcanvasdiv1"">'",0.0,0,0,0
9187,9187,"'<input type=""text"">'",0.0,0,0,0
9188,9188,'<input>',0.0,0,0,0
9189,9189,"'<link rel=""preload"" as=""script"" href=""/test1.js""/>'",0.0,0,0,0
9190,9190,"'<link rel=""preload"" as=""script"" href=""/test2.js""/>'",0.0,0,0,0
9191,9191,"'<link rel=""preload"" as=""script"" href=""/test3.js""/>'",0.0,0,0,0
9192,9192,"'<meta charSet=""utf-8""/>'",0.0,0,0,0
9193,9193,"'<meta http-equiv=""refresh"" content=""0;url=/redirect/result""/>'",0.0,0,0,0
9194,9194,"'<meta name=""robots"" content=""noindex""/>'",0.0,0,0,0
9195,9195,"'<meta name=""viewport"" content=""width=device-width, initial-scale=1""/>'",0.0,0,0,0
9196,9196,"'<nav class=""nav nav-tabs"" role=""tablist"">'",0.0,0,0,0
9197,9197,"'<nav class=""nav"">'",0.0,0,0,0
9198,9198,"'<nav class=""navbar navbar-expand-md bg-light"">'",0.0,0,0,0
9199,9199,"'<nav class=""navbar"">'",0.0,0,0,0
9200,9200,"'<nav id=""navBar"" class=""navbar"">'",0.0,0,0,0
9201,9201,"'<nav id=""navigation"" class=""navbar"">'",0.0,0,0,0
9202,9202,"'<ol class=""nav nav-pills"">'",0.0,0,0,0
9203,9203,'<ol>',0.0,0,0,0
9204,9204,'<p>Edge!</p>',0.0,0,0,0
9205,9205,'<p>pages-edge-ssr</p>',0.0,0,0,0
9206,9206,'<p>search params suspense</p>',0.0,0,0,0
9207,9207,"'<script rel=""preload"" as=""script"" src=""/test4.js""/>'",0.0,0,0,0
9208,9208,"'<script src=""playground.bundle.js""></script>'",0.0,0,0,0
9209,9209,'<script>',0.0,0,0,0
9210,9210,'<script></script>',0.0,0,0,0
9211,9211,'<select></select>',0.0,0,0,0
9212,9212,"'<span id=""tooltipWithTitle"" rel=""tooltip"" title=""tooltipTitle""></span>'",0.0,0,0,0
9213,9213,"'<span id=""tooltipWithoutTitle"" rel=""tooltip"" data-bs-title=""tooltipTitle""></span>'",0.0,0,0,0
9214,9214,'<span></span>',0.0,0,0,0
9215,9215,'<span>lorem</span>',0.0,0,0,0
9216,9216,'<style>',0.0,0,0,0
9217,9217,'<textarea></textarea>',0.0,0,0,0
9218,9218,'<title>React Cosmos</title>',0.0,0,0,0
9219,9219,"'<ul class=""nav nav-tabs"" id=""nav1"">'",0.0,0,0,0
9220,9220,"'<ul class=""nav nav-tabs"" id=""nav2"">'",0.0,0,0,0
9221,9221,"'<ul class=""nav nav-tabs"" role=""tablist"">'",0.0,0,0,0
9222,9222,"'<ul class=""nav nav-tabs"">'",0.0,0,0,0
9223,9223,"'<ul class=""nav"" role=""tablist"">'",0.0,0,0,0
9224,9224,"'<ul class=""nav"">'",0.0,0,0,0
9225,9225,"'<ul id=""navigation"" class=""navbar"">'",0.0,0,0,0
9226,9226,'<ul>',0.0,0,0,0
9227,9227,"'<urlset xmlns=""http://www.sitemaps.org/schemas/sitemap/0.9"">'",0.0,0,0,0
9228,9228,'=',0.0,0,0,0
9229,9229,'?componentName=FooComponent',0.0,0,0,0
9230,9230,'?foo=1&bar=2#h1',0.0,0,0,0
9231,9231,'?foo=1&bar=2#h3',0.0,0,0,0
9232,9232,'?foo=1&bar=2',0.0,0,0,0
9233,9233,'?foo=bar',0.0,0,0,0
9234,9234,'?here=ok#h1',0.0,0,0,0
9235,9235,'?here=ok#h2',0.0,0,0,0
9236,9236,'?override=external',0.0,0,0,0
9237,9237,'?override=internal',0.0,0,0,0
9238,9238,'@global body',0.0,0,0,0
9239,9239,'@next/font',0.0,0,0,0
9240,9240,'@propsBtn',0.0,0,0,0
9241,9241,'@viewCodeBtn',0.0,0,0,0
9242,9242,'A alt txt for og',0.0,0,0,0
9243,9243,'A alt txt for twitter',0.0,0,0,0
9244,9244,'A page',0.0,0,0,0
9245,9245,'A required parameter (slug) was not provided as a string received object',0.0,0,0,0
9246,9246,'A separate worker must be used for each render',0.0,0,0,0
9247,9247,'A tooltip',0.0,0,0,0
9248,9248,'A.A3',0.0,0,0,0
9249,9249,'A.B',0.0,0,0,0
9250,9250,'A2_child',0.0,0,0,0
9251,9251,'A2a',0.0,0,0,0
9252,9252,'A3',0.0,0,0,0
9253,9253,'A5',0.0,0,0,0
9254,9254,'ABSOLUTE_TACK',0.0,0,0,0
9255,9255,'ACTION',0.0,0,0,0
9256,9256,'ADD',0.0,0,0,0
9257,9257,'ANY_EVENT',0.0,0,0,0
9258,9258,'API Docs',0.0,0,0,0
9259,9259,'AS_STRINGS',0.0,0,0,0
9260,9260,'AUTH',0.0,0,0,0
9261,9261,'A_EVENT',0.0,0,0,0
9262,9262,'A_P',0.0,0,0,0
9263,9263,'A_S',0.0,0,0,0
9264,9264,'About Additional Children',0.0,0,0,0
9265,9265,'About Bypassed Page',0.0,0,0,0
9266,9266,'About Page',0.0,0,0,0
9267,9267,'About: en',0.0,0,0,0
9268,9268,'AboutB',0.0,0,0,0
9269,9269,'Additional Children',0.0,0,0,0
9270,9270,'After events on test machines are not supported',0.0,0,0,0
9271,9271,'An error occurred in the Server Components render. The specific message is omitted in production builds to avoid leaking sensitive details. A digest property is included on this error instance which may provide additional details about the nature of the error.',0.0,0,0,0
9272,9272,'An error occurred',0.0,0,0,0
9273,9273,'An error occurred: this is a test',0.0,0,0,0
9274,9274,'An example components load via next/dynamic',0.0,0,0,0
9275,9275,'AnchorText: About',0.0,0,0,0
9276,9276,'Annotation',0.0,0,0,0
9277,9277,'Another tooltip',0.0,0,0,0
9278,9278,'Api 组件',0.0,0,0,0
9279,9279,'App Page',0.0,0,0,0
9280,9280,'Apple Web App',0.0,0,0,0
9281,9281,'Application error: a client-side exception has occurred (see the browser console for more information).',0.0,0,0,0
9282,9282,'Application error: a server-side exception has occurred (see the server logs for more information).',0.0,0,0,0
9283,9283,'Array',0.0,0,0,0
9284,9284,"'Array.from(document.fonts.values()).find(font => font.family.includes(""Fraunces_Fallback"")).ascentOverride'",0.0,0,0,0
9285,9285,"'Array.from(document.fonts.values()).find(font => font.family.includes(""Fraunces_Fallback"")).descentOverride'",0.0,0,0,0
9286,9286,"'Array.from(document.fonts.values()).find(font => font.family.includes(""Fraunces_Fallback"")).lineGapOverride'",0.0,0,0,0
9287,9287,"'Array.from(document.fonts.values()).find(font => font.family.includes(""Fraunces_Fallback"")).sizeAdjust'",0.0,0,0,0
9288,9288,"'Array.from(document.fonts.values()).find(font => font.family.includes(""Indie_Flower_Fallback"")).ascentOverride'",0.0,0,0,0
9289,9289,"'Array.from(document.fonts.values()).find(font => font.family.includes(""Indie_Flower_Fallback"")).descentOverride'",0.0,0,0,0
9290,9290,"'Array.from(document.fonts.values()).find(font => font.family.includes(""Indie_Flower_Fallback"")).lineGapOverride'",0.0,0,0,0
9291,9291,"'Array.from(document.fonts.values()).find(font => font.family.includes(""Indie_Flower_Fallback"")).sizeAdjust'",0.0,0,0,0
9292,9292,"'Array.from(document.fonts.values()).find(font => font.family.includes(""Inter_Fallback"")).ascentOverride'",0.0,0,0,0
9293,9293,"'Array.from(document.fonts.values()).find(font => font.family.includes(""Inter_Fallback"")).descentOverride'",0.0,0,0,0
9294,9294,"'Array.from(document.fonts.values()).find(font => font.family.includes(""Inter_Fallback"")).lineGapOverride'",0.0,0,0,0
9295,9295,"'Array.from(document.fonts.values()).find(font => font.family.includes(""Inter_Fallback"")).sizeAdjust'",0.0,0,0,0
9296,9296,"'Array.from(document.fonts.values()).find(font => font.family.includes(""myFont1_Fallback"")).ascentOverride'",0.0,0,0,0
9297,9297,"'Array.from(document.fonts.values()).find(font => font.family.includes(""myFont1_Fallback"")).descentOverride'",0.0,0,0,0
9298,9298,"'Array.from(document.fonts.values()).find(font => font.family.includes(""myFont1_Fallback"")).lineGapOverride'",0.0,0,0,0
9299,9299,"'Array.from(document.fonts.values()).find(font => font.family.includes(""myFont1_Fallback"")).sizeAdjust'",0.0,0,0,0
9300,9300,"'Array.from(document.fonts.values()).find(font => font.family.includes(""myFont2_Fallback"")).ascentOverride'",0.0,0,0,0
9301,9301,"'Array.from(document.fonts.values()).find(font => font.family.includes(""myFont2_Fallback"")).descentOverride'",0.0,0,0,0
9302,9302,"'Array.from(document.fonts.values()).find(font => font.family.includes(""myFont2_Fallback"")).lineGapOverride'",0.0,0,0,0
9303,9303,"'Array.from(document.fonts.values()).find(font => font.family.includes(""myFont2_Fallback"")).sizeAdjust'",0.0,0,0,0
9304,9304,"'Array.from(document.fonts.values()).find(font => font.family.includes(""robotoVar1_Fallback"")).ascentOverride'",0.0,0,0,0
9305,9305,"'Array.from(document.fonts.values()).find(font => font.family.includes(""robotoVar1_Fallback"")).descentOverride'",0.0,0,0,0
9306,9306,"'Array.from(document.fonts.values()).find(font => font.family.includes(""robotoVar1_Fallback"")).lineGapOverride'",0.0,0,0,0
9307,9307,"'Array.from(document.fonts.values()).find(font => font.family.includes(""robotoVar1_Fallback"")).sizeAdjust'",0.0,0,0,0
9308,9308,"'Array.from(document.fonts.values()).find(font => font.family.includes(""robotoVar2_Fallback"")).ascentOverride'",0.0,0,0,0
9309,9309,"'Array.from(document.fonts.values()).find(font => font.family.includes(""robotoVar2_Fallback"")).descentOverride'",0.0,0,0,0
9310,9310,"'Array.from(document.fonts.values()).find(font => font.family.includes(""robotoVar2_Fallback"")).lineGapOverride'",0.0,0,0,0
9311,9311,"'Array.from(document.fonts.values()).find(font => font.family.includes(""robotoVar2_Fallback"")).sizeAdjust'",0.0,0,0,0
9312,9312,"'Array.from(document.fonts.values()).find(font => font.family.includes(""roboto_Fallback"")).ascentOverride'",0.0,0,0,0
9313,9313,"'Array.from(document.fonts.values()).find(font => font.family.includes(""roboto_Fallback"")).descentOverride'",0.0,0,0,0
9314,9314,"'Array.from(document.fonts.values()).find(font => font.family.includes(""roboto_Fallback"")).lineGapOverride'",0.0,0,0,0
9315,9315,"'Array.from(document.fonts.values()).find(font => font.family.includes(""roboto_Fallback"")).sizeAdjust'",0.0,0,0,0
9316,9316,'Audience home',0.0,0,0,0
9317,9317,'B',0.0,0,0,0
9318,9318,'B.B3',0.0,0,0,0
9319,9319,'B.bar',0.0,0,0,0
9320,9320,'B2.Buffer === B.Buffer',0.0,0,0,0
9321,9321,'B3',0.0,0,0,0
9322,9322,'BAD_COND',0.0,0,0,0
9323,9323,'BUILD_ID',0.0,0,0,0
9324,9324,'B_EVENT',0.0,0,0,0
9325,9325,'Bad Request',0.0,0,0,0
9326,9326,'Bar',0.0,0,0,0
9327,9327,'Bar.js',0.0,0,0,0
9328,9328,'Basic route',0.0,0,0,0
9329,9329,'Baz',0.0,0,0,0
9330,9330,'Biography',0.0,0,0,0
9331,9331,'Blink',0.0,0,0,0
9332,9332,'Blog post a-post',0.0,0,0,0
9333,9333,'Body exceeded 1mb limit',0.0,0,0,0
9334,9334,'Body exceeded 5kb limit',0.0,0,0,0
9335,9335,'Body exceeded 5mb limit',0.0,0,0,0
9336,9336,'Books',0.0,0,0,0
9337,9337,'Boolean input',0.0,0,0,0
9338,9338,'Browser',0.0,0,0,0
9339,9339,'Buffer === B.Buffer',0.0,0,0,0
9340,9340,'Buffer',0.0,0,0,0
9341,9341,'Button label.',0.0,0,0,0
9342,9342,'Button — My Style Guide',0.0,0,0,0
9343,9343,'Button',0.0,0,0,0
9344,9344,'Button.fixture',0.0,0,0,0
9345,9345,'ButtonModule',0.0,0,0,0
9346,9346,'C1',0.0,0,0,0
9347,9347,'C3',0.0,0,0,0
9348,9348,'CANCEL',0.0,0,0,0
9349,9349,'CHECK',0.0,0,0,0
9350,9350,'CHILD',0.0,0,0,0
9351,9351,'CHILD_DONE',0.0,0,0,0
9352,9352,'CHILD_UPDATED',0.0,0,0,0
9353,9353,'CJS package: cjs-lib',0.0,0,0,0
9354,9354,'CJS-ESM Compat package: cjs-esm-compat/index.mjs',0.0,0,0,0
9355,9355,'CLICKED_CLOSE',0.0,0,0,0
9356,9356,'CLICK_BAD',0.0,0,0,0
9357,9357,'CLICK_GOOD',0.0,0,0,0
9358,9358,'CLOSE',0.0,0,0,0
9359,9359,'CODE',0.0,0,0,0
9360,9360,'C_EVENT',0.0,0,0,0
9361,9361,'C_SIMILAR',0.0,0,0,0
9362,9362,'Cannot find module for page: /',0.0,0,0,0
9363,9363,'Cannot parse modifiers',0.0,0,0,0
9364,9364,'Cannot parse',0.0,0,0,0
9365,9365,'Chrome',0.0,0,0,0
9366,9366,'CleanWebpackPlugin',0.0,0,0,0
9367,9367,'Client Nested. Count: 0',0.0,0,0,0
9368,9368,'Client Nested. Count: 1',0.0,0,0,0
9369,9369,'Client subpath: subpath.default',0.0,0,0,0
9370,9370,'Client: <!-- -->full',0.0,0,0,0
9371,9371,'Client: index.default',0.0,0,0,0
9372,9372,'Client: index.default:react.full:dep.default',0.0,0,0,0
9373,9373,'Clothing',0.0,0,0,0
9374,9374,'Cmpnt',0.0,0,0,0
9375,9375,'Component',0.0,0,0,0
9376,9376,'ComponentOne',0.0,0,0,0
9377,9377,'Components',0.0,0,0,0
9378,9378,'ContextFrom accepts a model type',0.0,0,0,0
9379,9379,'Converts foo to bar',0.0,0,0,0
9380,9380,'Custom dashboard',0.0,0,0,0
9381,9381,'D2 Exit',0.0,0,0,0
9382,9382,'DAVID',0.0,0,0,0
9383,9383,'DEACTIVATE',0.0,0,0,0
9384,9384,'DEEP_CMR',0.0,0,0,0
9385,9385,'DEEP_EVENT',0.0,0,0,0
9386,9386,'DEEP_MR',0.0,0,0,0
9387,9387,'DEEP_POWER',0.0,0,0,0
9388,9388,'DELETE',0.0,0,0,0
9389,9389,"'DELETE, GET, HEAD, OPTIONS, POST'",0.0,0,0,0
9390,9390,'DESTROY',0.0,0,0,0
9391,9391,'DISABLED',0.0,0,0,0
9392,9392,'DOMContentLoaded',0.0,0,0,0
9393,9393,'DONE',0.0,0,0,0
9394,9394,'D_EVENT',0.0,0,0,0
9395,9395,'D_P',0.0,0,0,0
9396,9396,'D_S',0.0,0,0,0
9397,9397,'Dashboard Hello World',0.0,0,0,0
9398,9398,'Dashboard.fixture',0.0,0,0,0
9399,9399,'Declare the type.',0.0,0,0,0
9400,9400,'Default',0.0,0,0,0
9401,9401,'DefaultType',0.0,0,0,0
9402,9402,'DefinePlugin',0.0,0,0,0
9403,9403,'Delayed actions on test machines are not supported',0.0,0,0,0
9404,9404,'Demographics',0.0,0,0,0
9405,9405,'Deployments hello',0.0,0,0,0
9406,9406,'Detected a full page navigation',0.0,0,0,0
9407,9407,'Did you mean',0.0,0,0,0
9408,9408,'Different label',0.0,0,0,0
9409,9409,'Disabled SWC as replacement for Babel because of custom Babel configuration',0.0,0,0,0
9410,9410,'Do not Throw exception if not parent',0.0,0,0,0
9411,9411,'Do not use an `<a>` element to navigate to `/`. Use `<Link />` from `next/link` instead. See: https://nextjs.org/docs/messages/no-html-link-for-pages',0.0,0,0,0
9412,9412,'Do not use an `<a>` element to navigate to `/list/foo/`. Use `<Link />` from `next/link` instead. See: https://nextjs.org/docs/messages/no-html-link-for-pages',0.0,0,0,0
9413,9413,'Do not use an `<a>` element to navigate to `/list/foo/bar/`. Use `<Link />` from `next/link` instead. See: https://nextjs.org/docs/messages/no-html-link-for-pages',0.0,0,0,0
9414,9414,'Do not use an `<a>` element to navigate to `/list/lorem-ipsum/`. Use `<Link />` from `next/link` instead. See: https://nextjs.org/docs/messages/no-html-link-for-pages',0.0,0,0,0
9415,9415,'Do not use.',0.0,0,0,0
9416,9416,'Don’t use!',0.0,0,0,0
9417,9417,'DuckDuckBot/1.0; (+http://duckduckgo.com/duckduckbot.html)',0.0,0,0,0
9418,9418,'Dynamic catch-all route',0.0,0,0,0
9419,9419,'EACH',0.0,0,0,0
9420,9420,'EB',0.0,0,0,0
9421,9421,'ECONNREFUSED',0.0,0,0,0
9422,9422,'ECONNRESET',0.0,0,0,0
9423,9423,'ENABLED',0.0,0,0,0
9424,9424,'ENOENT',0.0,0,0,0
9425,9425,'ENTER_DIRECTION',0.0,0,0,0
9426,9426,'ENTER_P',0.0,0,0,0
9427,9427,'ENTER_PARALLEL',0.0,0,0,0
9428,9428,'ENTER_Q',0.0,0,0,0
9429,9429,'ENTER_R',0.0,0,0,0
9430,9430,'ENTER_S',0.0,0,0,0
9431,9431,'ERR_HTTP_HEADERS_SENT',0.0,0,0,0
9432,9432,'ESC',0.0,0,0,0
9433,9433,'ETag',0.0,0,0,0
9434,9434,'EVEN',0.0,0,0,0
9435,9435,'EVENT1',0.0,0,0,0
9436,9436,'EVENT2',0.0,0,0,0
9437,9437,'EVENT3',0.0,0,0,0
9438,9438,'EVENT_1',0.0,0,0,0
9439,9439,'EVENT_2',0.0,0,0,0
9440,9440,'EVENT_DEEP',0.0,0,0,0
9441,9441,'EVENT_OUTER1_B',0.0,0,0,0
9442,9442,'EVENT_STATE_NTJ0_WORK',0.0,0,0,0
9443,9443,'EXIT',0.0,0,0,0
9444,9444,'EXIT_DIRECTION',0.0,0,0,0
9445,9445,'EXPR',0.0,0,0,0
9446,9446,'EXTERNAL',0.0,0,0,0
9447,9447,"'Each child in a list should have a unique ""key"" prop'",0.0,0,0,0
9448,9448,'Edge - finished: true',0.0,0,0,0
9449,9449,'Edge!',0.0,0,0,0
9450,9450,'Education',0.0,0,0,0
9451,9451,'Electronics',0.0,0,0,0
9452,9452,'Empty',0.0,0,0,0
9453,9453,'Error Happened!',0.0,0,0,0
9454,9454,'Error during SSR',0.0,0,0,0
9455,9455,'Error message: Client error',0.0,0,0,0
9456,9456,'Error serializing `.time` returned from `getServerSideProps`',0.0,0,0,0
9457,9457,'Error serializing',0.0,0,0,0
9458,9458,'Error: Body exceeded 1.5mb limit',0.0,0,0,0
9459,9459,'Error: Invalid <Link> with <a> child. Please remove <a> or use <Link legacyBehavior>',0.0,0,0,0
9460,9460,'Error: Unauthorized request',0.0,0,0,0
9461,9461,'Event in event executor should contain payload from case',0.0,0,0,0
9462,9462,'EventFrom accepts a model type',0.0,0,0,0
9463,9463,"'Export All: one, two, two'",0.0,0,0,0
9464,9464,'Extra Page | Layout',0.0,0,0,0
9465,9465,'FAILED',0.0,0,0,0
9466,9466,'FAILURE',0.0,0,0,0
9467,9467,'FAKE_EVENT',0.0,0,0,0
9468,9468,'FETCH',0.0,0,0,0
9469,9469,'FILL_5',0.0,0,0,0
9470,9470,'FINISH_CHILD',0.0,0,0,0
9471,9471,'FIRE',0.0,0,0,0
9472,9472,'FIRED',0.0,0,0,0
9473,9473,'FIRE_DELAY',0.0,0,0,0
9474,9474,'FOOBAR',0.0,0,0,0
9475,9475,'FOO_EVENT',0.0,0,0,0
9476,9476,'FORBIDDEN_EVENT',0.0,0,0,0
9477,9477,'FORWARD_DEC',0.0,0,0,0
9478,9478,'FTP://abc',0.0,0,0,0
9479,9479,'Failed to copy traced files',0.0,0,0,0
9480,9480,'Failed to download `Inter` from Google Fonts. Using fallback font instead.',0.0,0,0,0
9481,9481,'Failed to fetch `Inter` from Google Fonts.',0.0,0,0,0
9482,9482,'Failed to load static props',0.0,0,0,0
9483,9483,'Failed to update prerender cache',0.0,0,0,0
9484,9484,'Failure',0.0,0,0,0
9485,9485,'Feed for vercel',0.0,0,0,0
9486,9486,'Fetch',0.0,0,0,0
9487,9487,'Fiction',0.0,0,0,0
9488,9488,'File name: hello.txt size: 5',0.0,0,0,0
9489,9489,'Findfilecaseinsensitive.Spec.JS',0.0,0,0,0
9490,9490,'Foo _bar_',0.0,0,0,0
9491,9491,'Foo `<bar>` baz',0.0,0,0,0
9492,9492,'Foo.js',0.0,0,0,0
9493,9493,'Foo:',0.0,0,0,0
9494,9494,'FooComponent',0.0,0,0,0
9495,9495,'Fraunces',0.0,0,0,0
9496,9496,'FunctionalComponent',0.0,0,0,0
9497,9497,'G',0.0,0,0,0
9498,9498,'GB',0.0,0,0,0
9499,9499,'GIVE_ANSWER',0.0,0,0,0
9500,9500,'GO_TO_WAITING',0.0,0,0,0
9501,9501,'GO_TO_WAITING_MACHINE',0.0,0,0,0
9502,9502,'General',0.0,0,0,0
9503,9503,'Get back',0.0,0,0,0
9504,9504,'Go to the about page',0.0,0,0,0
9505,9505,'Going from inactive to active',0.0,0,0,0
9506,9506,'Googlebot',0.0,0,0,0
9507,9507,'HEAD',0.0,0,0,0
9508,9508,'HEADER',0.0,0,0,0
9509,9509,'HTTP://abc',0.0,0,0,0
9510,9510,'HTTPS://abc',0.0,0,0,0
9511,9511,'Header value: a',0.0,0,0,0
9512,9512,'Header value: b',0.0,0,0,0
9513,9513,'Header value: c',0.0,0,0,0
9514,9514,'Header value: empty',0.0,0,0,0
9515,9515,'Hello *world*!',0.0,0,0,0
9516,9516,'Hello Other',0.0,0,0,0
9517,9517,'Hello from /about/me',0.0,0,0,0
9518,9518,'Hello from /middleware/works',0.0,0,0,0
9519,9519,'Hello from 1',0.0,0,0,0
9520,9520,'Hello from 2',0.0,0,0,0
9521,9521,'Hello from import-test.js',0.0,0,0,0
9522,9522,'Hello world!',0.0,0,0,0
9523,9523,'Hello world',0.0,0,0,0
9524,9524,'Hello!',0.0,0,0,0
9525,9525,'Hello',0.0,0,0,0
9526,9526,"'Hello, cruel world.'",0.0,0,0,0
9527,9527,"'Hello, from text-file.txt!'",0.0,0,0,0
9528,9528,"'Hello, world.'",0.0,0,0,0
9529,9529,'Home Page',0.0,0,0,0
9530,9530,'Home!',0.0,0,0,0
9531,9531,'HotModuleReplacementPlugin',0.0,0,0,0
9532,9532,'HtmlWebpackPlugin',0.0,0,0,0
9533,9533,'I am deprecated',0.0,0,0,0
9534,9534,'IGNORE',0.0,0,0,0
9535,9535,'INACTIVATE',0.0,0,0,0
9536,9536,'INC_TWICE',0.0,0,0,0
9537,9537,'INERT',0.0,0,0,0
9538,9538,'INITIALIZE_SYNC_SEQUENCE',0.0,0,0,0
9539,9539,'INT1',0.0,0,0,0
9540,9540,'INT2',0.0,0,0,0
9541,9541,'INTERNAL',0.0,0,0,0
9542,9542,'INVALID',0.0,0,0,0
9543,9543,'Ignore event with query param',0.0,0,0,0
9544,9544,'Ignore event without query param',0.0,0,0,0
9545,9545,'ImageModule',0.0,0,0,0
9546,9546,'Impressions',0.0,0,0,0
9547,9547,'Indie flower',0.0,0,0,0
9548,9548,'Inline worker script through children is modified by Partytown to execute on a worker thread',0.0,0,0,0
9549,9549,'Inline worker script through dangerouslySetInnerHtml is modified by Partytown to execute on a worker thread',0.0,0,0,0
9550,9550,'Inner Page | Extra Layout',0.0,0,0,0
9551,9551,'Inner basic route',0.0,0,0,0
9552,9552,'Input',0.0,0,0,0
9553,9553,'Intercepted Page',0.0,0,0,0
9554,9554,'Invalid URL',0.0,0,0,0
9555,9555,'Invalid hook call',0.0,0,0,0
9556,9556,'Invalid resolve.alias',0.0,0,0,0
9557,9557,'Invocations on test machines are not supported',0.0,0,0,0
9558,9558,'Iron Man',0.0,0,0,0
9559,9559,'It should be able to navigate app -> pages and go back and forward',0.0,0,0,0
9560,9560,'It should be able to navigate app -> pages',0.0,0,0,0
9561,9561,'It should be able to navigate pages -> app and go back an forward',0.0,0,0,0
9562,9562,'It should be able to navigate pages -> app',0.0,0,0,0
9563,9563,'It should tighten service types when using model.createMachine',0.0,0,0,0
9564,9564,'JSON.stringify(next.router.query)',0.0,0,0,0
9565,9565,'JSX not only in the last expression',0.0,0,0,0
9566,9566,'JavaScript:abc',0.0,0,0,0
9567,9567,'KEEP_GOING',0.0,0,0,0
9568,9568,'L',0.0,0,0,0
9569,9569,'Laptops',0.0,0,0,0
9570,9570,'Loading layout...',0.0,0,0,0
9571,9571,'Loading page...',0.0,0,0,0
9572,9572,'Loading',0.0,0,0,0
9573,9573,'Loading...',0.0,0,0,0
9574,9574,'M',0.0,0,0,0
9575,9575,'MACRO',0.0,0,0,0
9576,9576,'MAILTO:me@example.com',0.0,0,0,0
9577,9577,'MAX-AGE=9999',0.0,0,0,0
9578,9578,'MB',0.0,0,0,0
9579,9579,'MICRO',0.0,0,0,0
9580,9580,'MODULE_NOT_FOUND',0.0,0,0,0
9581,9581,'Mac OS',0.0,0,0,0
9582,9582,'Menu',0.0,0,0,0
9583,9583,'Method Not Allowed',0.0,0,0,0
9584,9584,'MiniHtmlWebpackPlugin',0.0,0,0,0
9585,9585,'Minimum recommended TypeScript version is',0.0,0,0,0
9586,9586,'Mozilla',0.0,0,0,0
9587,9587,"'Mozilla/5.0 (Linux; Android 6.0.1; Nexus 5X Build/MMB29P) AppleWebKit/537.36 (KHTML, like Gecko) Chrome/W.X.Y.Z Mobile Safari/537.36 (compatible; Googlebot/2.1; +http://www.google.com/bot.html)'",0.0,0,0,0
9588,9588,"'Mozilla/5.0 (Macintosh; Intel Mac OS X 10_15_7) AppleWebKit/537.36 (KHTML, like Gecko) Chrome/93.0.4577.82 Safari/537.36'",0.0,0,0,0
9589,9589,"'Mozilla/5.0 (Macintosh; Intel Mac OS X 11_2_3) AppleWebKit/537.36 (KHTML, like Gecko) Chrome/89.0.4389.90 Safari/537.36'",0.0,0,0,0
9590,9590,'Mozilla/5.0 (compatible; Baiduspider/2.0; +http://www.baidu.com/search/spider.html)',0.0,0,0,0
9591,9591,'Mozilla/5.0 (compatible; Bingbot/2.0; +http://www.bing.com/bingbot.htm)',0.0,0,0,0
9592,9592,'Mozilla/5.0 (compatible; Googlebot/2.1; +http://www.google.com/bot.html)',0.0,0,0,0
9593,9593,'Mozilla/5.0 (compatible; Yahoo! Slurp; http://help.yahoo.com/help/us/ysearch/slurp)',0.0,0,0,0
9594,9594,'Mozilla/5.0 (compatible; YandexBot/3.0; +http://yandex.com/bots)',0.0,0,0,0
9595,9595,'My Style Guide',0.0,0,0,0
9596,9596,'My custom site name',0.0,0,0,0
9597,9597,'My custom title | Layout open graph title',0.0,0,0,0
9598,9598,'My title',0.0,0,0,0
9599,9599,'MyPlugin',0.0,0,0,0
9600,9600,'N',0.0,0,0,0
9601,9601,'N/A',0.0,0,0,0
9602,9602,'NEXT_A',0.0,0,0,0
9603,9603,'NEXT_ASSIGNER',0.0,0,0,0
9604,9604,'NEXT_B',0.0,0,0,0
9605,9605,'NEXT_FN',0.0,0,0,0
9606,9606,'NEXT_RSC_UNION_QUERY query name is _rsc',0.0,0,0,0
9607,9607,'NOEXPR',0.0,0,0,0
9608,9608,'NONE',0.0,0,0,0
9609,9609,'NOT_FOUND',0.0,0,0,0
9610,9610,'Nested deeper page',0.0,0,0,0
9611,9611,'Nested deeper sidebar here',0.0,0,0,0
9612,9612,'Nested page',0.0,0,0,0
9613,9613,'Nested route group',0.0,0,0,0
9614,9614,'Nested sections',0.0,0,0,0
9615,9615,'Nested sidebar here',0.0,0,0,0
9616,9616,'Nested.md',0.0,0,0,0
9617,9617,'New',0.0,0,0,0
9618,9618,'NewsFeed',0.0,0,0,0
9619,9619,'Next-Router-Prefetch',0.0,0,0,0
9620,9620,'Next.js Middleware',0.0,0,0,0
9621,9621,'Next.js Static Manifest',0.0,0,0,0
9622,9622,'No ESLint configuration detected. Run next lint to begin setup',0.0,0,0,0
9623,9623,'No components',0.0,0,0,0
9624,9624,'No searchParams used',0.0,0,0,0
9625,9625,'No sections',0.0,0,0,0
9626,9626,'Node - finished: true',0.0,0,0,0
9627,9627,'Not Found!',0.0,0,0,0
9628,9628,'Not a page',0.0,0,0,0
9629,9629,'O',0.0,0,0,0
9630,9630,'ONE',0.0,0,0,0
9631,9631,'OPTIONS',0.0,0,0,0
9632,9632,'Object.keys(window.next.router.components)',0.0,0,0,0
9633,9633,'Onclick prevent default',0.0,0,0,0
9634,9634,'One inner',0.0,0,0,0
9635,9635,'One',0.0,0,0,0
9636,9636,'Open Graph',0.0,0,0,0
9637,9637,'Open fixture',0.0,0,0,0
9638,9638,'P',0.0,0,0,0
9639,9639,'P31',0.0,0,0,0
9640,9640,'P32',0.0,0,0,0
9641,9641,'PARALLEL_DEEP_HISTORY',0.0,0,0,0
9642,9642,'PARALLEL_HISTORY',0.0,0,0,0
9643,9643,'PARALLEL_SOME_HISTORY',0.0,0,0,0
9644,9644,'PARENT',0.0,0,0,0
9645,9645,'PARENT_EVENT',0.0,0,0,0
9646,9646,'PB',0.0,0,0,0
9647,9647,'PED_COUNTDOWN',0.0,0,0,0
9648,9648,'PED_WAIT',0.0,0,0,0
9649,9649,'POWER_OUTAGE',0.0,0,0,0
9650,9650,'Page',0.0,0,0,0
9651,9651,'PageNotFoundError: Cannot find module for page',0.0,0,0,0
9652,9652,'Pages Page',0.0,0,0,0
9653,9653,'Pages',0.0,0,0,0
9654,9654,"'Param found: shirts_and_tops, mens_ua_playoff_polo_2.0, 1327037'",0.0,0,0,0
9655,9655,"'Param found: shirts_and_tops, mens_ua_playoff_polo_2.0, 1327037.html'",0.0,0,0,0
9656,9656,'Parameter: hello',0.0,0,0,0
9657,9657,"'Params: {""slug"":""abc""}'",0.0,0,0,0
9658,9658,'Particles',0.0,0,0,0
9659,9659,'Partytown config script is overwritten',0.0,0,0,0
9660,9660,'Partytown snippet is not injected to head if not enabled in configuration',0.0,0,0,0
9661,9661,'Partytown snippets are injected to head if enabled in configuration',0.0,0,0,0
9662,9662,"'Pattern should define hostname but found\n{""protocol"":""https""}'",0.0,0,0,0
9663,9663,'Phones',0.0,0,0,0
9664,9664,'Photo INTERCEPTED 1',0.0,0,0,0
9665,9665,'Photo MODAL 1',0.0,0,0,0
9666,9666,'Photo MODAL 2',0.0,0,0,0
9667,9667,'Photo PAGE 1',0.0,0,0,0
9668,9668,'Photo PAGE 2',0.0,0,0,0
9669,9669,'Pizza Style Guide',0.0,0,0,0
9670,9670,'Please use show on visible elements',0.0,0,0,0
9671,9671,'Post: random-path',0.0,0,0,0
9672,9672,"'Prefix: HELLO, WORLD'",0.0,0,0,0
9673,9673,'Private method by default.',0.0,0,0,0
9674,9674,'Profile',0.0,0,0,0
9675,9675,'Promise',0.0,0,0,0
9676,9676,'PromiseLike',0.0,0,0,0
9677,9677,'Prop name',0.0,0,0,0
9678,9678,'Public',0.0,0,0,0
9679,9679,'Push Me',0.0,0,0,0
9680,9680,'PushButton',0.0,0,0,0
9681,9681,'Q',0.0,0,0,0
9682,9682,'R',0.0,0,0,0
9683,9683,'RECHECK',0.0,0,0,0
9684,9684,'REENTER',0.0,0,0,0
9685,9685,'REQUEST_SECRET',0.0,0,0,0
9686,9686,'RESET',0.0,0,0,0
9687,9687,'RESET_TO_CENTER',0.0,0,0,0
9688,9688,'REVALIDATED',0.0,0,0,0
9689,9689,'RIGHT_CLICK',0.0,0,0,0
9690,9690,'RIGHT_CLICK_EXTERNAL',0.0,0,0,0
9691,9691,'RSC',0.0,0,0,0
9692,9692,"'RSC, Next-Router-State-Tree, Next-Router-Prefetch'",0.0,0,0,0
9693,9693,"'RSC, Next-Router-State-Tree, Next-Router-Prefetch, Accept-Encoding'",0.0,0,0,0
9694,9694,'RandomButtom',0.0,0,0,0
9695,9695,"'Reaches state ""d"": EVENT → EVENT → EVENT'",0.0,0,0,0
9696,9696,"'Reaches state ""e"": EVENT → EVENT → EVENT_2'",0.0,0,0,0
9697,9697,'React Style Guide Example',0.0,0,0,0
9698,9698,'Readme.md',0.0,0,0,0
9699,9699,'ReferenceError',0.0,0,0,0
9700,9700,'Refreshed page successfully!',0.0,0,0,0
9701,9701,'RegExp should fuzzy match a string',0.0,0,0,0
9702,9702,'RegExp should ignore non-alphanumeric characters',0.0,0,0,0
9703,9703,'RegExp should not match when string is different',0.0,0,0,0
9704,9704,'Regular Page',0.0,0,0,0
9705,9705,'Renderer connected',0.0,0,0,0
9706,9706,'Result Page!',0.0,0,0,0
9707,9707,'Result Page',0.0,0,0,0
9708,9708,'Result page',0.0,0,0,0
9709,9709,'Returns foo from bar',0.0,0,0,0
9710,9710,'Roboto multiple weights and styles - variable 1',0.0,0,0,0
9711,9711,'Roboto multiple weights and styles - variable 2',0.0,0,0,0
9712,9712,'Roboto multiple weights and styles',0.0,0,0,0
9713,9713,'Route Cancelled',0.0,0,0,0
9714,9714,'Route group',0.0,0,0,0
9715,9715,'S-MAXAGE=9999',0.0,0,0,0
9716,9716,'SET_COMPLETE',0.0,0,0,0
9717,9717,'SET_MAYBE',0.0,0,0,0
9718,9718,'SGVsbG8sIHdvcmxkIQ==',0.0,0,0,0
9719,9719,'SIGKILL',0.0,0,0,0
9720,9720,'SINGLE',0.0,0,0,0
9721,9721,'SINGLE_EVENT',0.0,0,0,0
9722,9722,'SIP:me@example.com',0.0,0,0,0
9723,9723,'SKIP',0.0,0,0,0
9724,9724,'SOME_ACTION',0.0,0,0,0
9725,9725,'SPAWN',0.0,0,0,0
9726,9726,'START',0.0,0,0,0
9727,9727,'STARTED',0.0,0,0,0
9728,9728,'START_CB',0.0,0,0,0
9729,9729,'STATE_IDLE_1',0.0,0,0,0
9730,9730,'STATE_ON_SIMPLE',0.0,0,0,0
9731,9731,'STATE_WORKING_0',0.0,0,0,0
9732,9732,'STOP',0.0,0,0,0
9733,9733,'STOPPED',0.0,0,0,0
9734,9734,'STOP_CHILD',0.0,0,0,0
9735,9735,'STOP_ONE',0.0,0,0,0
9736,9736,'SWITCH',0.0,0,0,0
9737,9737,'SWITCH_TURBO',0.0,0,0,0
9738,9738,'Script is injected server-side',0.0,0,0,0
9739,9739,'Section content file not found',0.0,0,0,0
9740,9740,'Section',0.0,0,0,0
9741,9741,'SelectedActivity',0.0,0,0,0
9742,9742,'Server subpath: subpath.default',0.0,0,0,0
9743,9743,'Server subpath: subpath.react-server',0.0,0,0,0
9744,9744,'Server: <!-- -->subset',0.0,0,0,0
9745,9745,'Server: index.default',0.0,0,0,0
9746,9746,'Server: index.react-server:react.subset:dep.server',0.0,0,0,0
9747,9747,'Shoes',0.0,0,0,0
9748,9748,'Shorts',0.0,0,0,0
9749,9749,'Should allow setting objects which do not have defaults',0.0,0,0,0
9750,9750,'Should apply scroll when loading.js is used',0.0,0,0,0
9751,9751,'Should assign object defaults deeply to customConfig',0.0,0,0,0
9752,9752,'Should assign object defaults deeply to user config',0.0,0,0,0
9753,9753,'Should be served',0.0,0,0,0
9754,9754,'Should bubble up errors in the child component',0.0,0,0,0
9755,9755,'Should dedup simple path paths',0.0,0,0,0
9756,9756,'Should error if it encounters a promise in a state',0.0,0,0,0
9757,9757,'Should error if it encounters a promise in an event',0.0,0,0,0
9758,9758,'Should find a path to a non-initial target state',0.0,0,0,0
9759,9759,'Should find a path to an initial target state',0.0,0,0,0
9760,9760,'Should get the configuration',0.0,0,0,0
9761,9761,'Should have failed',0.0,0,0,0
9762,9762,'Should not append /index to the / page',0.0,0,0,0
9763,9763,'Should not find page /index when using /',0.0,0,0,0
9764,9764,'Should not hide a modal',0.0,0,0,0
9765,9765,'Should not let you declare after on your test machine',0.0,0,0,0
9766,9766,'Should not let you declare invocations on your test machine',0.0,0,0,0
9767,9767,'Should not let you delayed actions on your machine',0.0,0,0,0
9768,9768,'Should not pass the customConfig when it is null',0.0,0,0,0
9769,9769,'Should not receive START action here.',0.0,0,0,0
9770,9770,'Should not throw an error when two versions of next.config.js are present',0.0,0,0,0
9771,9771,'Should only follow that path',0.0,0,0,0
9772,9772,'Should override defaults for arrays from user arrays',0.0,0,0,0
9773,9773,'Should pass the customConfig correctly',0.0,0,0,0
9774,9774,'Should pass the defaultConfig correctly',0.0,0,0,0
9775,9775,'Should pass the phase correctly',0.0,0,0,0
9776,9776,'Should prepend / when a page does not have it',0.0,0,0,0
9777,9777,'Should require /index.js when using /index',0.0,0,0,0
9778,9778,'Should require /world.js when using /world',0.0,0,0,0
9779,9779,'Should scroll to the top of the layout when the first child is display none',0.0,0,0,0
9780,9780,'Should succeed if it encounters no promises',0.0,0,0,0
9781,9781,'Should throw an error when next.config.js is not present',0.0,0,0,0
9782,9782,'Should throw error with ENOENT code',0.0,0,0,0
9783,9783,'Should throw on /../../test.js',0.0,0,0,0
9784,9784,'Should throw when an invalid target is provided',0.0,0,0,0
9785,9785,'Should throw when using /../../test.js',0.0,0,0,0
9786,9786,'Should throw when using non existent pages like /non-existent.js',0.0,0,0,0
9787,9787,'Should throw with paths containing ../',0.0,0,0,0
9788,9788,'Should turn / into /index',0.0,0,0,0
9789,9789,'Should turn /abc into /abc',0.0,0,0,0
9790,9790,'Should turn /abc/def into /abc/def',0.0,0,0,0
9791,9791,'Should turn _error into /_error',0.0,0,0,0
9792,9792,'Should write a readable description including the target state and the path',0.0,0,0,0
9793,9793,'SlowBuffer',0.0,0,0,0
9794,9794,'Space',0.0,0,0,0
9795,9795,"'Static generation failed due to dynamic usage on /force-static, reason: headers'",0.0,0,0,0
9796,9796,"'Static generation failed due to dynamic usage on /ssr-auto/cache-no-store, reason: no-store fetch'",0.0,0,0,0
9797,9797,'Styled(Heading)',0.0,0,0,0
9798,9798,'Styled-component test\n',0.0,0,0,0
9799,9799,'Subscribers',0.0,0,0,0
9800,9800,'Success',0.0,0,0,0
9801,9801,'Super Hero',0.0,0,0,0
9802,9802,'Super Man',0.0,0,0,0
9803,9803,'T',0.0,0,0,0
9804,9804,'T1',0.0,0,0,0
9805,9805,'T2',0.0,0,0,0
9806,9806,'TACK',0.0,0,0,0
9807,9807,'TARGETLESS_ARRAY',0.0,0,0,0
9808,9808,'TARGETLESS_OBJECT',0.0,0,0,0
9809,9809,'TARGET_INVALID',0.0,0,0,0
9810,9810,'TB',0.0,0,0,0
9811,9811,'TEL:123-123-1234',0.0,0,0,0
9812,9812,'THREE_EVENT',0.0,0,0,0
9813,9813,'TICK',0.0,0,0,0
9814,9814,'TIMER_COND_OBJ',0.0,0,0,0
9815,9815,"'TOGGLE_BOLD, TOGGLE_ITALICS'",0.0,0,0,0
9816,9816,'TOKEN',0.0,0,0,0
9817,9817,'TO_B',0.0,0,0,0
9818,9818,'TO_BAR',0.0,0,0,0
9819,9819,'TO_C',0.0,0,0,0
9820,9820,'TO_FINAL',0.0,0,0,0
9821,9821,'TRIGGER',0.0,0,0,0
9822,9822,'TS: should compile for any event',0.0,0,0,0
9823,9823,'TURN_OFF',0.0,0,0,0
9824,9824,'TWO',0.0,0,0,0
9825,9825,'Tab bar page (@children)',0.0,0,0,0
9826,9826,'Tablets',0.0,0,0,0
9827,9827,'Test Cosmos plugin',0.0,0,0,0
9828,9828,'Test description',0.0,0,0,0
9829,9829,'Test endCallback',0.0,0,0,0
9830,9830,'Test leftCallback',0.0,0,0,0
9831,9831,'Test rightCallback',0.0,0,0,0
9832,9832,'Test',0.0,0,0,0
9833,9833,'Text',0.0,0,0,0
9834,9834,"'The NextURL configuration includes no locale ""foo""'",0.0,0,0,0
9835,9835,'The only true button.',0.0,0,0,0
9836,9836,'This Is The Not Found Page',0.0,0,0,0
9837,9837,'This is MDX!',0.0,0,0,0
9838,9838,'This is a paragraph',0.0,0,0,0
9839,9839,'This is a title',0.0,0,0,0
9840,9840,'This is the post page',0.0,0,0,0
9841,9841,'This page could not be found.',0.0,0,0,0
9842,9842,'This should also run the middleware',0.0,0,0,0
9843,9843,'This should be impossible.',0.0,0,0,0
9844,9844,'This should not be called.',0.0,0,0,0
9845,9845,'This should run the middleware',0.0,0,0,0
9846,9846,'To App Page',0.0,0,0,0
9847,9847,'To Pages Page',0.0,0,0,0
9848,9848,"'To configure the body size limit for Server Actions, see'",0.0,0,0,0
9849,9849,"'To use Server Actions, please enable the feature flag in your Next.js config.'",0.0,0,0,0
9850,9850,'Tooltip should not be shown',0.0,0,0,0
9851,9851,'Tops',0.0,0,0,0
9852,9852,'Trigger Error!',0.0,0,0,0
9853,9853,'Turn off',0.0,0,0,0
9854,9854,'Turn on',0.0,0,0,0
9855,9855,'Twitter - Next.js App',0.0,0,0,0
9856,9856,'Twitter - This is a Next.js App',0.0,0,0,0
9857,9857,'Twitter Description',0.0,0,0,0
9858,9858,'Twitter Title',0.0,0,0,0
9859,9859,'Twitter',0.0,0,0,0
9860,9860,'Two',0.0,0,0,0
9861,9861,'TypeError: fetch failed',0.0,0,0,0
9862,9862,'UNKNOWN',0.0,0,0,0
9863,9863,'UNKNOWN_EVENT',0.0,0,0,0
9864,9864,'UNMATCHED',0.0,0,0,0
9865,9865,'UPDATE_BUTTON_CLICKED',0.0,0,0,0
9866,9866,'Unknown config option',0.0,0,0,0
9867,9867,"'Unknown language: ""pizza""'",0.0,0,0,0
9868,9868,'Unknown',0.0,0,0,0
9869,9869,'Updates headers',0.0,0,0,0
9870,9870,'Use *another* method',0.0,0,0,0
9871,9871,'User-Agent',0.0,0,0,0
9872,9872,'User-Agent: *\nDisallow:',0.0,0,0,0
9873,9873,'User-agent: *\nAllow: /\n\nSitemap: https://www.example.com/sitemap.xml',0.0,0,0,0
9874,9874,'Value = 0',0.0,0,0,0
9875,9875,'Value = 1',0.0,0,0,0
9876,9876,'Value = 2',0.0,0,0,0
9877,9877,'Variable font without weight range',0.0,0,0,0
9878,9878,'Vercel',0.0,0,0,0
9879,9879,'View duration',0.0,0,0,0
9880,9880,'Views home',0.0,0,0,0
9881,9881,'Visit About',0.0,0,0,0
9882,9882,'Visit',0.0,0,0,0
9883,9883,'Vite',0.0,0,0,0
9884,9884,'WAK1',0.0,0,0,0
9885,9885,'WAK2',0.0,0,0,0
9886,9886,'WHATEVER',0.0,0,0,0
9887,9887,'WIN',0.0,0,0,0
9888,9888,'WIN_MIX',0.0,0,0,0
9889,9889,'WIN_PROP',0.0,0,0,0
9890,9890,'WIN_STATIC',0.0,0,0,0
9891,9891,'Warning: data for page',0.0,0,0,0
9892,9892,"'Warning: fetch for https://next-data-api-endpoint.vercel.app/api/random?d4 on /force-cache specified ""cache: force-cache"" and ""revalidate: 3"", only one should be specified.'",0.0,0,0,0
9893,9893,'Warning: unstable_getImgProps() is experimental and may change or be removed at any time. Use at your own risk.',0.0,0,0,0
9894,9894,'Webpack',0.0,0,0,0
9895,9895,'Welcome Page A',0.0,0,0,0
9896,9896,'Welcome Page B',0.0,0,0,0
9897,9897,'Welcome home',0.0,0,0,0
9898,9898,'Welcome to a /dynamic/[slug]: new',0.0,0,0,0
9899,9899,'Welcome to the dashboard',0.0,0,0,0
9900,9900,'Worker scripts are modified by Partytown to execute on a worker thread',0.0,0,0,0
9901,9901,'WrappedButton',0.0,0,0,0
9902,9902,'Wrong type',0.0,0,0,0
9903,9903,'Y',0.0,0,0,0
9904,9904,'YB',0.0,0,0,0
9905,9905,'Your fixtures are ready to use.',0.0,0,0,0
9906,9906,'Your page app/(group)/page.js did not have a root layout. We created app/(group)/layout.js for you.',0.0,0,0,0
9907,9907,'Your page app/(group)/route/second/inner/page.js did not have a root layout. We created app/(group)/route/second/layout.js for you.',0.0,0,0,0
9908,9908,'Your page app/page.tsx did not have a root layout. We created app/layout.tsx for you.',0.0,0,0,0
9909,9909,'Your page app/route/page.js did not have a root layout. We created app/layout.js for you.',0.0,0,0,0
9910,9910,'YourComponent.js',0.0,0,0,0
9911,9911,'Z',0.0,0,0,0
9912,9912,'Z1',0.0,0,0,0
9913,9913,'ZB',0.0,0,0,0
9914,9914,"'[""first"",""second"",""third""]'",0.0,0,0,0
9915,9915,"'[""something"",""another""]'",0.0,0,0,0
9916,9916,'[Cosmos] Config not found at path: subdir/cosmos.config.json',0.0,0,0,0
9917,9917,'[Cosmos] Dir not found at path: subdir',0.0,0,0,0
9918,9918,'[Cosmos] Export complete!',0.0,0,0,0
9919,9919,'[Cosmos] Found 1 plugin: Test Cosmos plugin',0.0,0,0,0
9920,9920,'[Cosmos] Invalid config file type: subdir/cosmos.config.js (must be .json)',0.0,0,0,0
9921,9921,'[Cosmos] Using cosmos config found at cosmos.config.json',0.0,0,0,0
9922,9922,'[Pizza](http://example.com)',0.0,0,0,0
9923,9923,'[abc]',0.0,0,0,0
9924,9924,'[app] supports node:buffer',0.0,0,0,0
9925,9925,"'[contenteditable=""true""]'",0.0,0,0,0
9926,9926,"'[data-bs-dismiss=""modal""]'",0.0,0,0,0
9927,9927,"'[data-bs-dismiss=""test""]'",0.0,0,0,0
9928,9928,"'[data-bs-target=""#childContent1""]'",0.0,0,0,0
9929,9929,"'[data-bs-target=""#childContent2""]'",0.0,0,0,0
9930,9930,"'[data-bs-target=""#parentContent""]'",0.0,0,0,0
9931,9931,"'[data-bs-toggle=""modal""]'",0.0,0,0,0
9932,9932,'[data-next-shallow-push]',0.0,0,0,0
9933,9933,"'[data-query-hello=""goodbye""]'",0.0,0,0,0
9934,9934,"'[data-query-hello=""world""]'",0.0,0,0,0
9935,9935,"'[href=""#detail""]'",0.0,0,0,0
9936,9936,"'[href=""#div-jsm-1""]'",0.0,0,0,0
9937,9937,"'[href=""#présentation""]'",0.0,0,0,0
9938,9938,"'[href=""#test2""]'",0.0,0,0,0
9939,9939,"'[href=""/feed""]'",0.0,0,0,0
9940,9940,"'[href=""/foo""]'",0.0,0,0,0
9941,9941,"'[href=""/foo/bar""]'",0.0,0,0,0
9942,9942,"'[href=""/intercepting-parallel-modal/photo/1""]'",0.0,0,0,0
9943,9943,"'[href=""/intercepting-parallel-modal/photo/2""]'",0.0,0,0,0
9944,9944,"'[href=""/intercepting-routes-dynamic-catchall/photos/catchall/123""]'",0.0,0,0,0
9945,9945,"'[href=""/intercepting-routes-dynamic-catchall/photos/optional-catchall/123""]'",0.0,0,0,0
9946,9946,"'[href=""/intercepting-routes-dynamic/photos/next/123""]'",0.0,0,0,0
9947,9947,"'[href=""/intercepting-routes/feed/photos/1""]'",0.0,0,0,0
9948,9948,"'[href=""/nested""]'",0.0,0,0,0
9949,9949,"'[href=""/parallel-catchall/foo""]'",0.0,0,0,0
9950,9950,"'[href=""/parallel-layout/subroute""]'",0.0,0,0,0
9951,9951,"'[href=""/parallel-non-intercepting/foo""]'",0.0,0,0,0
9952,9952,"'[href=""/parallel-prefetch-false/foo""]'",0.0,0,0,0
9953,9953,"'[href=""/parallel-scroll/nav""]'",0.0,0,0,0
9954,9954,"'[href=""/parallel-side-bar""]'",0.0,0,0,0
9955,9955,"'[href=""/parallel-side-bar/nested""]'",0.0,0,0,0
9956,9956,"'[href=""/photos""]'",0.0,0,0,0
9957,9957,'[href]',0.0,0,0,0
9958,9958,"'[http://example.com](http://example.com ""http&#x3A;//example.com"")'",0.0,0,0,0
9959,9959,'[id]',0.0,0,0,0
9960,9960,'[name].js',0.0,0,0,0
9961,9961,'[pages/api] supports node:buffer',0.0,0,0,0
9962,9962,'[slug]',0.0,0,0,0
9963,9963,"'[tabindex=""0""]'",0.0,0,0,0
9964,9964,"'[tabindex=""10""]'",0.0,0,0,0
9965,9965,'[tabindex]',0.0,0,0,0
9966,9966,'[unsafe]',0.0,0,0,0
9967,9967,'[very deep]',0.0,0,0,0
9968,9968,'\\',0.0,0,0,0
9969,9969,'\\page.js',0.0,0,0,0
9970,9970,'\\path\\page.tsx',0.0,0,0,0
9971,9971,'\u2028\u2029',0.0,0,0,0
9972,9972,"'^(?:\\/(_next\\/data\\/[^/]{1,}))?\\/middleware\\/another-path(.json)?[\\/#\\?]?$'",0.0,0,0,0
9973,9973,"'^(?:\\/(_next\\/data\\/[^/]{1,}))?\\/middleware\\/path(.json)?[\\/#\\?]?$'",0.0,0,0,0
9974,9974,'^/.*$',0.0,0,0,0
9975,9975,'^/api/edge$',0.0,0,0,0
9976,9976,'^/api/hello$',0.0,0,0,0
9977,9977,'^/blog/([^/]+?)/([^/]+?)(?:/)?$',0.0,0,0,0
9978,9978,'^/blog/([^/]+?)/([^/]+?)\\.rsc$',0.0,0,0,0
9979,9979,'^/group$',0.0,0,0,0
9980,9980,'^\\/blocking\\-fallback\\-once\\/([^\\/]+?)(?:\\/)?$',0.0,0,0,0
9981,9981,'^\\/blocking\\-fallback\\-some\\/([^\\/]+?)(?:\\/)?$',0.0,0,0,0
9982,9982,'^\\/blocking\\-fallback\\/([^\\/]+?)(?:\\/)?$',0.0,0,0,0
9983,9983,'^\\/blog\\/([^\\/]+?)(?:\\/)?$',0.0,0,0,0
9984,9984,'^\\/blog\\/([^\\/]+?)\\.rsc$',0.0,0,0,0
9985,9985,'^\\/blog\\/([^\\/]+?)\\/([^\\/]+?)(?:\\/)?$',0.0,0,0,0
9986,9986,'^\\/catchall\\-explicit\\/(.+?)(?:\\/)?$',0.0,0,0,0
9987,9987,'^\\/catchall\\-optional(?:\\/(.+?))?(?:\\/)?$',0.0,0,0,0
9988,9988,'^\\/catchall\\/(.+?)(?:\\/)?$',0.0,0,0,0
9989,9989,'^\\/dynamic\\-error\\/([^\\/]+?)(?:\\/)?$',0.0,0,0,0
9990,9990,'^\\/dynamic\\-error\\/([^\\/]+?)\\.rsc$',0.0,0,0,0
9991,9991,'^\\/fallback\\-only\\/([^\\/]+?)(?:\\/)?$',0.0,0,0,0
9992,9992,'^\\/force\\-static\\/([^\\/]+?)(?:\\/)?$',0.0,0,0,0
9993,9993,'^\\/force\\-static\\/([^\\/]+?)\\.rsc$',0.0,0,0,0
9994,9994,'^\\/gen\\-params\\-dynamic\\-revalidate\\/([^\\/]+?)(?:\\/)?$',0.0,0,0,0
9995,9995,'^\\/gen\\-params\\-dynamic\\-revalidate\\/([^\\/]+?)\\.rsc$',0.0,0,0,0
9996,9996,'^\\/hooks\\/use\\-pathname\\/([^\\/]+?)(?:\\/)?$',0.0,0,0,0
9997,9997,'^\\/hooks\\/use\\-pathname\\/([^\\/]+?)\\.rsc$',0.0,0,0,0
9998,9998,'^\\/lang\\/([^\\/]+?)\\/about(?:\\/)?$',0.0,0,0,0
9999,9999,'^\\/non\\-json\\-blocking\\/([^\\/]+?)(?:\\/)?$',0.0,0,0,0
10000,10000,'^\\/non\\-json\\/([^\\/]+?)(?:\\/)?$',0.0,0,0,0
10001,10001,'^\\/partial\\-gen\\-params\\-no\\-additional\\-lang\\/([^\\/]+?)\\/([^\\/]+?)(?:\\/)?$',0.0,0,0,0
10002,10002,'^\\/partial\\-gen\\-params\\-no\\-additional\\-lang\\/([^\\/]+?)\\/([^\\/]+?)\\.rsc$',0.0,0,0,0
10003,10003,'^\\/partial\\-gen\\-params\\-no\\-additional\\-slug\\/([^\\/]+?)\\/([^\\/]+?)(?:\\/)?$',0.0,0,0,0
10004,10004,'^\\/partial\\-gen\\-params\\-no\\-additional\\-slug\\/([^\\/]+?)\\/([^\\/]+?)\\.rsc$',0.0,0,0,0
10005,10005,'^\\/ssg\\-draft\\-mode(?:\\/(.+?))?(?:\\/)?$',0.0,0,0,0
10006,10006,'^\\/ssg\\-draft\\-mode(?:\\/(.+?))?\\.rsc$',0.0,0,0,0
10007,10007,'^\\/static\\-to\\-dynamic\\-error\\-forced\\/([^\\/]+?)(?:\\/)?$',0.0,0,0,0
10008,10008,'^\\/static\\-to\\-dynamic\\-error\\-forced\\/([^\\/]+?)\\.rsc$',0.0,0,0,0
10009,10009,'__fixtures__',0.0,0,0,0
10010,10010,'__mock_bundle__',0.0,0,0,0
10011,10011,'__mock_map__',0.0,0,0,0
10012,10012,'__nextDefaultLocale',0.0,0,0,0
10013,10013,'__nextFallback',0.0,0,0,0
10014,10014,'__nextIsNotFound',0.0,0,0,0
10015,10015,'__nextLocale',0.0,0,0,0
10016,10016,'_addTouchEventListeners',0.0,0,0,0
10017,10017,'_adjustDialog',0.0,0,0,0
10018,10018,'_basePath',0.0,0,0,0
10019,10019,'_clearInterval',0.0,0,0,0
10020,10020,'_clearTimeout',0.0,0,0,0
10021,10021,'_completeHide',0.0,0,0,0
10022,10022,'_detectNavbar',0.0,0,0,0
10023,10023,'_error',0.0,0,0,0
10024,10024,'_getChildren',0.0,0,0,0
10025,10025,'_getConfig',0.0,0,0,0
10026,10026,'_handleSwipe',0.0,0,0,0
10027,10027,'_i18n',0.0,0,0,0
10028,10028,'_initEvents',0.0,0,0,0
10029,10029,'_keydown',0.0,0,0,0
10030,10030,'_maybeEnableCycle',0.0,0,0,0
10031,10031,'_next/data',0.0,0,0,0
10032,10032,'_orderToDirection',0.0,0,0,0
10033,10033,'_process',0.0,0,0,0
10034,10034,'_queueCallback',0.0,0,0,0
10035,10035,'_resolvedata',0.0,0,0,0
10036,10036,'_rsc',0.0,0,0,0
10037,10037,'_sessionid should be null for non-invoked machines',0.0,0,0,0
10038,10038,'_sessionid should be the service sessionId for invoked machines',0.0,0,0,0
10039,10039,'_sessionid should persist through states (manual)',0.0,0,0,0
10040,10040,'_slide',0.0,0,0,0
10041,10041,'`.nextState()` should not execute actions `predictableActionArguments`',0.0,0,0,0
10042,10042,'`EventExecutor` should be passed event with type that corresponds to its key',0.0,0,0,0
10043,10043,'`events` should allow known event',0.0,0,0,0
10044,10044,'`events` should not allow unknown events',0.0,0,0,0
10045,10045,'`events` should not require all event types (array literal expression)',0.0,0,0,0
10046,10046,'`events` should not require all event types (function)',0.0,0,0,0
10047,10047,'`events` should not require all event types (tuple)',0.0,0,0,0
10048,10048,'`events` should only allow props of a specific event',0.0,0,0,0
10049,10049,'`export const config`',0.0,0,0,0
10050,10050,'`getEvents` should be allowed to return a mutable array',0.0,0,0,0
10051,10051,'`getEvents` should be allowed to return a readonly array',0.0,0,0,0
10052,10052,'`relay` has been moved out of `experimental` and into `compiler.relay`. Please update your next.config.js file accordingly.',0.0,0,0,0
10053,10053,'`serializeEvent` should be allowed to return plain string',0.0,0,0,0
10054,10054,'`serializeState` should be allowed to return plain string',0.0,0,0,0
10055,10055,'`skipTrailingSlashRedirect` has been moved out of `experimental`. Please update your next.config.js file accordingly.',0.0,0,0,0
10056,10056,'`withConfig` should require all missing implementations ',0.0,0,0,0
10057,10057,'a [link](http://test.com)',0.0,0,0,0
10058,10058,'a node dependency',0.0,0,0,0
10059,10059,'a-service',0.0,0,0,0
10060,10060,'a.a1',0.0,0,0,0
10061,10061,'a.a3',0.0,0,0,0
10062,10062,'a.b.c',0.0,0,0,0
10063,10063,'a.disabled',0.0,0,0,0
10064,10064,'a.fake',0.0,0,0,0
10065,10065,'a/b.js',0.0,0,0,0
10066,10066,'a11',0.0,0,0,0
10067,10067,'a2',0.0,0,0,0
10068,10068,'a4',0.0,0,0,0
10069,10069,'a=b&c=d',0.0,0,0,0
10070,10070,"'a[data-bs-dismiss=""modal""]'",0.0,0,0,0
10071,10071,"'a[href=""/about""]'",0.0,0,0,0
10072,10072,"'a[href=""/base/another""]'",0.0,0,0,0
10073,10073,"'a[href=""/linking""]'",0.0,0,0,0
10074,10074,"'a[href=""/linking/about""]'",0.0,0,0,0
10075,10075,"'a[rel=""tooltip""]'",0.0,0,0,0
10076,10076,'aa',0.0,0,0,0
10077,10077,'aaaa',0.0,0,0,0
10078,10078,'abcd',0.0,0,0,0
10079,10079,'about-bypass',0.0,0,0,0
10080,10080,'accept header: text/x-component',0.0,0,0,0
10081,10081,'action objects used within implementations parameter should get access to the provided event type when using model',0.0,0,0,0
10082,10082,'action objects used within implementations parameter should get access to the provided event type',0.0,0,0,0
10083,10083,'actions should be able to be executed manually with execute()',0.0,0,0,0
10084,10084,'actions should be configurable with execute()',0.0,0,0,0
10085,10085,'activate',0.0,0,0,0
10086,10086,'activateCrosswalkLight',0.0,0,0,0
10087,10087,'actor should provide snapshot value immediately',0.0,0,0,0
10088,10088,'actor-state',0.0,0,0,0
10089,10089,'actors spawned in exit handlers of a stopped child should not be started',0.0,0,0,0
10090,10090,'addEventListener',0.0,0,0,0
10091,10091,'adds missing React aliases using array form',0.0,0,0,0
10092,10092,'adds missing React aliases',0.0,0,0,0
10093,10093,'adds the header for a matched data path (with header)',0.0,0,0,0
10094,10094,'adds the header for a matched data path (without header)',0.0,0,0,0
10095,10095,'adds the header for a matched path',0.0,0,0,0
10096,10096,'adds the header for a mathed root path with /index',0.0,0,0,0
10097,10097,'adds the header for another matched data path',0.0,0,0,0
10098,10098,'adds the header for another matched path',0.0,0,0,0
10099,10099,'adds the header to the /',0.0,0,0,0
10100,10100,'adds the header to the /index',0.0,0,0,0
10101,10101,'adds the headers for a matched data path (with header)',0.0,0,0,0
10102,10102,'again',0.0,0,0,0
10103,10103,'al:android:app_name',0.0,0,0,0
10104,10104,'al:android:package',0.0,0,0,0
10105,10105,'al:ios:app_store_id',0.0,0,0,0
10106,10106,'al:ios:url',0.0,0,0,0
10107,10107,'al:web:should_fallback',0.0,0,0,0
10108,10108,"'alert(""code"");'",0.0,0,0,0
10109,10109,"'alert(""header"");'",0.0,0,0,0
10110,10110,'allow',0.0,0,0,0
10111,10111,'allows all different types of props',0.0,0,0,0
10112,10112,'allows empty props',0.0,0,0,0
10113,10113,'allows framer-motion to animate opacity',0.0,0,0,0
10114,10114,'allows identical object instances in an array deeply',0.0,0,0,0
10115,10115,'allows identical object instances in an array',0.0,0,0,0
10116,10116,'allows multi array refs nested',0.0,0,0,0
10117,10117,'allows multi array refs',0.0,0,0,0
10118,10118,'allows multi object refs nested',0.0,0,0,0
10119,10119,'allows multi object refs',0.0,0,0,0
10120,10120,'allows shallow linking with middleware',0.0,0,0,0
10121,10121,'allows to access env variables',0.0,0,0,0
10122,10122,'allows to assets from node_modules',0.0,0,0,0
10123,10123,'allows to change the host',0.0,0,0,0
10124,10124,'allows to change the port',0.0,0,0,0
10125,10125,'allows to change the whole href',0.0,0,0,0
10126,10126,'allows to clone a new copy',0.0,0,0,0
10127,10127,'allows to fetch a remote URL with a path and basename',0.0,0,0,0
10128,10128,'allows to fetch a remote URL',0.0,0,0,0
10129,10129,'allows to fetch image assets',0.0,0,0,0
10130,10130,'allows to fetch text assets',0.0,0,0,0
10131,10131,'allows to get empty locale when there is no locale',0.0,0,0,0
10132,10132,'allows to preserve a json request',0.0,0,0,0
10133,10133,'allows to the pathname',0.0,0,0,0
10134,10134,'allows to update search params',0.0,0,0,0
10135,10135,'allows to update the pathname for a prefetch url',0.0,0,0,0
10136,10136,'allows to update the pathname to the root path for a prefetch url',0.0,0,0,0
10137,10137,'alt',0.0,0,0,0
10138,10138,'always get a default locale',0.0,0,0,0
10139,10139,'alwaysFalse',0.0,0,0,0
10140,10140,'amp enabled',0.0,0,0,0
10141,10141,'amp hybrid enabled',0.0,0,0,0
10142,10142,'an exit action executed when an interpreter gets stopped should receive `xstate.stop` event',0.0,0,0,0
10143,10143,'an exit action executed when an interpreter reaches its final state should be called with the last received event',0.0,0,0,0
10144,10144,'analyzes transition counts',0.0,0,0,0
10145,10145,'ancestor',0.0,0,0,0
10146,10146,'anon',0.0,0,0,0
10147,10147,'another - app',0.0,0,0,0
10148,10148,'another',0.0,0,0,0
10149,10149,'another-middleware',0.0,0,0,0
10150,10150,"'another: true,'",0.0,0,0,0
10151,10151,'anotherEvent',0.0,0,0,0
10152,10152,'another_do_a2',0.0,0,0,0
10153,10153,'another_enter_b',0.0,0,0,0
10154,10154,'another_exit_a',0.0,0,0,0
10155,10155,'answer',0.0,0,0,0
10156,10156,'answering',0.0,0,0,0
10157,10157,'anything',0.0,0,0,0
10158,10158,'api/draft-mode/route.js',0.0,0,0,0
10159,10159,'api/revalidate-path-edge/route.js',0.0,0,0,0
10160,10160,'api/revalidate-path-node/route.js',0.0,0,0,0
10161,10161,'api/revalidate-tag-edge/route.js',0.0,0,0,0
10162,10162,'api/revalidate-tag-node/route.js',0.0,0,0,0
10163,10163,'app-client-comp',0.0,0,0,0
10164,10164,'app-client-layout',0.0,0,0,0
10165,10165,'app-client-page',0.0,0,0,0
10166,10166,'app-comp',0.0,0,0,0
10167,10167,'app-dir imports the correct module',0.0,0,0,0
10168,10168,'app-edge',0.0,0,0,0
10169,10169,"'app-id=myAppStoreID, app-argument=myAppArgument'",0.0,0,0,0
10170,10170,'app-layout',0.0,0,0,0
10171,10171,'app-link',0.0,0,0,0
10172,10172,'app-nested-comp',0.0,0,0,0
10173,10173,'app-nested-layout',0.0,0,0,0
10174,10174,'app-nested-page',0.0,0,0,0
10175,10175,'app-page',0.0,0,0,0
10176,10176,'app/(group)/dynamic/[size]/apple-icon-48jo90/[[...__metadata_id__]]/route.js',0.0,0,0,0
10177,10177,'app/(group)/layout.js',0.0,0,0,0
10178,10178,'app/(group)/route/second/layout.js',0.0,0,0,0
10179,10179,'app/another/page.js',0.0,0,0,0
10180,10180,'app/client-component-route/page.js',0.0,0,0,0
10181,10181,'app/css/css-client/client-page.css',0.0,0,0,0
10182,10182,'app/css/css-page/style.css',0.0,0,0,0
10183,10183,'app/css/sass/global.sass',0.0,0,0,0
10184,10184,'app/css/sass/global.scss',0.0,0,0,0
10185,10185,'app/dashboard/index/page.js',0.0,0,0,0
10186,10186,'app/edge/basic/page.tsx',0.0,0,0,0
10187,10187,'app/favicon.ico',0.0,0,0,0
10188,10188,'app/gsp/sitemap/[__metadata_id__]/route.js',0.0,0,0,0
10189,10189,'app/hmr/global.css',0.0,0,0,0
10190,10190,'app/hmr/import/actual-styles.css',0.0,0,0,0
10191,10191,'app/hmr/page.js',0.0,0,0,0
10192,10192,'app/layout.js',0.0,0,0,0
10193,10193,'app/layout.tsx',0.0,0,0,0
10194,10194,'app/legacy-runtime-config/page.js is deprecated. Please change `runtime` property to segment export config. See https://nextjs.org/docs/app/api-reference/file-conventions/route-segment-config',0.0,0,0,0
10195,10195,'app/metadata-base/unset/icon.tsx',0.0,0,0,0
10196,10196,'app/metadata-base/unset/sitemap.tsx',0.0,0,0,0
10197,10197,'app/next.config.js',0.0,0,0,0
10198,10198,'app/ordering/page.js',0.0,0,0,0
10199,10199,'app/page-with-loading/_loading.js',0.0,0,0,0
10200,10200,'app/page-with-loading/loading.js',0.0,0,0,0
10201,10201,'app/page.js',0.0,0,0,0
10202,10202,'app/page.server.js',0.0,0,0,0
10203,10203,'app/pages',0.0,0,0,0
10204,10204,'app/path/robots.txt',0.0,0,0,0
10205,10205,'app/path/sitemap.xml',0.0,0,0,0
10206,10206,'app/robots.txt',0.0,0,0,0
10207,10207,'app/robots.txt/route.js',0.0,0,0,0
10208,10208,'app/route.js',0.0,0,0,0
10209,10209,'app/route/page.js',0.0,0,0,0
10210,10210,'app/server/actions.js',0.0,0,0,0
10211,10211,'app/sitemap.xml',0.0,0,0,0
10212,10212,'app/sitemap.xml/route.js',0.0,0,0,0
10213,10213,'app/twitter-image/route.js',0.0,0,0,0
10214,10214,'app_name_android',0.0,0,0,0
10215,10215,'app_store_id',0.0,0,0,0
10216,10216,'apple-itunes-app',0.0,0,0,0
10217,10217,'apple-mobile-web-app-capable',0.0,0,0,0
10218,10218,'apple-mobile-web-app-status-bar-style',0.0,0,0,0
10219,10219,'apple-mobile-web-app-title',0.0,0,0,0
10220,10220,'apple-touch-icon',0.0,0,0,0
10221,10221,'apples',0.0,0,0,0
10222,10222,'application-name',0.0,0,0,0
10223,10223,'application/manifest+json',0.0,0,0,0
10224,10224,'application/x-www-form-urlencoded',0.0,0,0,0
10225,10225,'application/xml',0.0,0,0,0
10226,10226,'applies the assignment to multiple properties (property assignment)',0.0,0,0,0
10227,10227,'applies the assignment to multiple properties (static + prop assignment)',0.0,0,0,0
10228,10228,'applies the assignment to multiple properties (static)',0.0,0,0,0
10229,10229,'applies the assignment to multiple properties',0.0,0,0,0
10230,10230,'applies the assignment to the explicit external state (property assignment)',0.0,0,0,0
10231,10231,'applies the assignment to the explicit external state',0.0,0,0,0
10232,10232,'applies the assignment to the external state (property assignment)',0.0,0,0,0
10233,10233,'applies the assignment to the external state',0.0,0,0,0
10234,10234,'argument entity must be string',0.0,0,0,0
10235,10235,'aria-describedby',0.0,0,0,0
10236,10236,'aria-label',0.0,0,0,0
10237,10237,"'aria-label=""This is a link""'",0.0,0,0,0
10238,10238,'array',0.0,0,0,0
10239,10239,'article',0.0,0,0,0
10240,10240,'article:author',0.0,0,0,0
10241,10241,'article:published_time',0.0,0,0,0
10242,10242,'asPath',0.0,0,0,0
10243,10243,'asdf',0.0,0,0,0
10244,10244,'asdf2',0.0,0,0,0
10245,10245,'asdf3',0.0,0,0,0
10246,10246,'assetPrefix',0.0,0,0,0
10247,10247,'async function anotherFetcher(...args)',0.0,0,0,0
10248,10248,'async',0.0,0,0,0
10249,10249,'asyncError',0.0,0,0,0
10250,10250,'attachShadow',0.0,0,0,0
10251,10251,'author1',0.0,0,0,0
10252,10252,'author2',0.0,0,0,0
10253,10253,'author3',0.0,0,0,0
10254,10254,'authorized',0.0,0,0,0
10255,10255,'authorizing',0.0,0,0,0
10256,10256,'automatic',0.0,0,0,0
10257,10257,'automatically parses and formats JSON',0.0,0,0,0
10258,10258,'avatars.*.example.com',0.0,0,0,0
10259,10259,'avatars.*1.example.com',0.0,0,0,0
10260,10260,'avatars.*a*.example.com',0.0,0,0,0
10261,10261,'avatars.ia*.example.com',0.0,0,0,0
10262,10262,'b-service',0.0,0,0,0
10263,10263,'b.b1.foo',0.0,0,0,0
10264,10264,'b.b2',0.0,0,0,0
10265,10265,'b.foo',0.0,0,0,0
10266,10266,'b2',0.0,0,0,0
10267,10267,'b_hist',0.0,0,0,0
10268,10268,'babel-loader',0.0,0,0,0
10269,10269,'babel-polyfill',0.0,0,0,0
10270,10270,'backSequence',0.0,0,0,0
10271,10271,'background-color',0.0,0,0,0
10272,10272,'background-color: blue;',0.0,0,0,0
10273,10273,'background-color: red;',0.0,0,0,0
10274,10274,'background: gray;',0.0,0,0,0
10275,10275,'background: red;',0.0,0,0,0
10276,10276,'bar.server.js:',0.0,0,0,0
10277,10277,'bar/*.js',0.0,0,0,0
10278,10278,'bar=bar2; Path=/',0.0,0,0,0
10279,10279,'barAgain',0.0,0,0,0
10280,10280,'barDelay',0.0,0,0,0
10281,10281,'barFinal',0.0,0,0,0
10282,10282,'base jss instance setup shoud not affect Styleguidist styles',0.0,0,0,0
10283,10283,'base16-light',0.0,0,0,0
10284,10284,'base64',0.0,0,0,0
10285,10285,'baseLinkClass customClass',0.0,0,0,0
10286,10286,'baseLinkClass',0.0,0,0,0
10287,10287,'basePath',0.0,0,0,0
10288,10288,'basepath/next.config.js',0.0,0,0,0
10289,10289,'basepath/pages',0.0,0,0,0
10290,10290,'basic example',0.0,0,0,0
10291,10291,'basic-route',0.0,0,0,0
10292,10292,'baz=baz2; Path=/',0.0,0,0,0
10293,10293,'bazGuard',0.0,0,0,0
10294,10294,'bb',0.0,0,0,0
10295,10295,'beforeFiles',0.0,0,0,0
10296,10296,'beforeHistoryChange',0.0,0,0,0
10297,10297,'behaviors should have reference to the parent',0.0,0,0,0
10298,10298,'black-translucent',0.0,0,0,0
10299,10299,'blink',0.0,0,0,0
10300,10300,'blinkCrosswalkLight',0.0,0,0,0
10301,10301,'block',0.0,0,0,0
10302,10302,'blog page',0.0,0,0,0
10303,10303,'blog/[author]/[slug]/page.js',0.0,0,0,0
10304,10304,'blog/[author]/page.js',0.0,0,0,0
10305,10305,'blog/[slug]',0.0,0,0,0
10306,10306,'blog/seb.html',0.0,0,0,0
10307,10307,'blog/seb.rsc',0.0,0,0,0
10308,10308,'blog/seb/second-post.html',0.0,0,0,0
10309,10309,'blog/seb/second-post.rsc',0.0,0,0,0
10310,10310,'blog/styfle.html',0.0,0,0,0
10311,10311,'blog/styfle.rsc',0.0,0,0,0
10312,10312,'blog/styfle/first-post.html',0.0,0,0,0
10313,10313,'blog/styfle/first-post.rsc',0.0,0,0,0
10314,10314,'blog/styfle/second-post.html',0.0,0,0,0
10315,10315,'blog/styfle/second-post.rsc',0.0,0,0,0
10316,10316,'blog/tim.html',0.0,0,0,0
10317,10317,'blog/tim.rsc',0.0,0,0,0
10318,10318,'blog/tim/first-post.html',0.0,0,0,0
10319,10319,'blog/tim/first-post.rsc',0.0,0,0,0
10320,10320,'blueberries',0.0,0,0,0
10321,10321,"'body a[href=""/root""]'",0.0,0,0,0
10322,10322,'body div',0.0,0,0,0
10323,10323,'body meta',0.0,0,0,0
10324,10324,'bold.off',0.0,0,0,0
10325,10325,'bold.on',0.0,0,0,0
10326,10326,'books',0.0,0,0,0
10327,10327,'boolean',0.0,0,0,0
10328,10328,'border-color',0.0,0,0,0
10329,10329,'border-radius',0.0,0,0,0
10330,10330,'broken.js',0.0,0,0,0
10331,10331,'browser inspector should use targetWindow if provided',0.0,0,0,0
10332,10332,'browser',0.0,0,0,0
10333,10333,'bs-popover-auto',0.0,0,0,0
10334,10334,'bs.alert',0.0,0,0,0
10335,10335,'bs.button',0.0,0,0,0
10336,10336,'bs.carousel',0.0,0,0,0
10337,10337,'bs.collapse',0.0,0,0,0
10338,10338,'bs.dropdown',0.0,0,0,0
10339,10339,'bs.modal',0.0,0,0,0
10340,10340,'bs.offcanvas',0.0,0,0,0
10341,10341,'bs.popover',0.0,0,0,0
10342,10342,'bs.scrollspy',0.0,0,0,0
10343,10343,'bs.toast',0.0,0,0,0
10344,10344,'bs.tooltip',0.0,0,0,0
10345,10345,'bsData',0.0,0,0,0
10346,10346,'btn',0.0,0,0,0
10347,10347,'bu',0.0,0,0,0
10348,10348,'build-time-1',0.0,0,0,0
10349,10349,'build-time-2',0.0,0,0,0
10350,10350,'build-time-3',0.0,0,0,0
10351,10351,'build.js',0.0,0,0,0
10352,10352,'build/[name].[chunkhash:8].js',0.0,0,0,0
10353,10353,'build/[name].bundle.js',0.0,0,0,0
10354,10354,'build/[name].js',0.0,0,0,0
10355,10355,'build/bundle.[chunkhash:8].js',0.0,0,0,0
10356,10356,'buildError',0.0,0,0,0
10357,10357,'buildStart',0.0,0,0,0
10358,10358,'builds with API route on the edge runtime and page on the experimental edge runtime',0.0,0,0,0
10359,10359,'but',0.0,0,0,0
10360,10360,'button foo-class',0.0,0,0,0
10361,10361,'button isSmall',0.0,0,0,0
10362,10362,'button-push',0.0,0,0,0
10363,10363,'button.active',0.0,0,0,0
10364,10364,'button:not(.active)',0.0,0,0,0
10365,10365,"'button[data-bs-dismiss=""modal""]'",0.0,0,0,0
10366,10366,"'button[data-bs-toggle=""dropdown""]'",0.0,0,0,0
10367,10367,'button[disabled]',0.0,0,0,0
10368,10368,'buttons',0.0,0,0,0
10369,10369,'c-service',0.0,0,0,0
10370,10370,'c/d.css',0.0,0,0,0
10371,10371,'c2',0.0,0,0,0
10372,10372,'c3',0.0,0,0,0
10373,10373,'cache clean function shouldn’t throw',0.0,0,0,0
10374,10374,'cache-handler get',0.0,0,0,0
10375,10375,'cache-handler set',0.0,0,0,0
10376,10376,'callback should be able to receive messages from parent',0.0,0,0,0
10377,10377,'callback spy',0.0,0,0,0
10378,10378,'callback',0.0,0,0,0
10379,10379,'called',0.0,0,0,0
10380,10380,'calls config hook',0.0,0,0,0
10381,10381,'calls dev server hook (with updated config)',0.0,0,0,0
10382,10382,'calls dev server hook with send message API',0.0,0,0,0
10383,10383,'calls export hook (with updated config)',0.0,0,0,0
10384,10384,'calls override function with env',0.0,0,0,0
10385,10385,'calls webpack config function with correct args',0.0,0,0,0
10386,10386,'cameraOff',0.0,0,0,0
10387,10387,'can assign from event',0.0,0,0,0
10388,10388,'can be called twice',0.0,0,0,0
10389,10389,'can be cloned',0.0,0,0,0
10390,10390,'can cancel a delayed event',0.0,0,0,0
10391,10391,'can handle arr circular refs',0.0,0,0,0
10392,10392,'can handle deep arr circular refs (with objects)',0.0,0,0,0
10393,10393,'can handle deep arr circular refs',0.0,0,0,0
10394,10394,'can handle deep obj circular refs (with arrays)',0.0,0,0,0
10395,10395,'can handle deep obj circular refs',0.0,0,0,0
10396,10396,'can handle handle a streaming request and streaming response (edge)',0.0,0,0,0
10397,10397,'can handle handle a streaming request and streaming response',0.0,0,0,0
10398,10398,'can handle obj circular refs',0.0,0,0,0
10399,10399,'can model actions',0.0,0,0,0
10400,10400,'can model events',0.0,0,0,0
10401,10401,'can read a JSON encoded body (edge)',0.0,0,0,0
10402,10402,'can read a JSON encoded body for DELETE requests',0.0,0,0,0
10403,10403,'can read a JSON encoded body for OPTIONS requests',0.0,0,0,0
10404,10404,'can read a JSON encoded body',0.0,0,0,0
10405,10405,'can read a streamed JSON encoded body (edge)',0.0,0,0,0
10406,10406,'can read a streamed JSON encoded body',0.0,0,0,0
10407,10407,'can read query parameters (edge)',0.0,0,0,0
10408,10408,'can read query parameters',0.0,0,0,0
10409,10409,'can read the text body (edge)',0.0,0,0,0
10410,10410,'can read the text body',0.0,0,0,0
10411,10411,'can respond correctly',0.0,0,0,0
10412,10412,'can return JSON',0.0,0,0,0
10413,10413,'can send an event after a delay (delayed transitions)',0.0,0,0,0
10414,10414,'can send an event after a delay (expression using _event)',0.0,0,0,0
10415,10415,'can send an event after a delay (expression)',0.0,0,0,0
10416,10416,'can send an event after a delay',0.0,0,0,0
10417,10417,'can send events with a string and object payload',0.0,0,0,0
10418,10418,'can send events with a string',0.0,0,0,0
10419,10419,'can send events with an object with payload',0.0,0,0,0
10420,10420,'can send events with an object',0.0,0,0,0
10421,10421,'canary',0.0,0,0,0
10422,10422,'capture',0.0,0,0,0
10423,10423,'carousel slid when it should not have slid',0.0,0,0,0
10424,10424,'carousel-item',0.0,0,0,0
10425,10425,'catchall slug slug',0.0,0,0,0
10426,10426,'catchall slug',0.0,0,0,0
10427,10427,'catchall-slug',0.0,0,0,0
10428,10428,'catches extra brackets for optional',0.0,0,0,0
10429,10429,'catches extra dots in catch-all',0.0,0,0,0
10430,10430,'catches middle catch-all with another catch-all',0.0,0,0,0
10431,10431,'catches middle catch-all with fixed route',0.0,0,0,0
10432,10432,'catches mismatched param names',0.0,0,0,0
10433,10433,'catches missing dots in catch-all',0.0,0,0,0
10434,10434,'catches param names differing only by non-word characters',0.0,0,0,0
10435,10435,'catches reused param names with catch-all',0.0,0,0,0
10436,10436,'catches reused param names',0.0,0,0,0
10437,10437,'category-1',0.0,0,0,0
10438,10438,'change',0.0,0,0,0
10439,10439,'change-catchall',0.0,0,0,0
10440,10440,'change-param',0.0,0,0,0
10441,10441,'change-static',0.0,0,0,0
10442,10442,'changePassword',0.0,0,0,0
10443,10443,'check layout without params get no params',0.0,0,0,0
10444,10444,'check topmost layout renders all params',0.0,0,0,0
10445,10445,'checking',0.0,0,0,0
10446,10446,'child should not invoke an actor when it transitions to an invoking state when it gets stopped by its parent',0.0,0,0,0
10447,10447,'child2',0.0,0,0,0
10448,10448,'childContent',0.0,0,0,0
10449,10449,'childMachine',0.0,0,0,0
10450,10450,'child_a',0.0,0,0,0
10451,10451,'child_b',0.0,0,0,0
10452,10452,'cjs-client',0.0,0,0,0
10453,10453,'cjs-shared',0.0,0,0,0
10454,10454,'class',0.0,0,0,0
10455,10455,"'class=""test""'",0.0,0,0,0
10456,10456,'classic',0.0,0,0,0
10457,10457,'clearInterval',0.0,0,0,0
10458,10458,'click.namespace2',0.0,0,0,0
10459,10459,'click</button>',0.0,0,0,0
10460,10460,'clickCallback',0.0,0,0,0
10461,10461,'clickListener',0.0,0,0,0
10462,10462,'client component client-navigation',0.0,0,0,0
10463,10463,'client component under sever no ssr',0.0,0,0,0
10464,10464,'client component',0.0,0,0,0
10465,10465,'client-reference-manifest.json',0.0,0,0,0
10466,10466,'close.bs.alert',0.0,0,0,0
10467,10467,'closed.bs.alert',0.0,0,0,0
10468,10468,'closes message handler clients',0.0,0,0,0
10469,10469,'cmFuZG9tCg==',0.0,0,0,0
10470,10470,'collapses fixtures dir with sibling',0.0,0,0,0
10471,10471,'collapses fixtures dir',0.0,0,0,0
10472,10472,'collapses fixtures dirs at different levels',0.0,0,0,0
10473,10473,'collapses index fixture',0.0,0,0,0
10474,10474,'collapses index multi fixture',0.0,0,0,0
10475,10475,'collapses multiple outer dirs',0.0,0,0,0
10476,10476,'collapses named index fixture (case insensitive)',0.0,0,0,0
10477,10477,'collapses named index fixture',0.0,0,0,0
10478,10478,'collapses nested named index fixture',0.0,0,0,0
10479,10479,'collapses one outer dir (multi fixture)',0.0,0,0,0
10480,10480,'collapses one outer dir',0.0,0,0,0
10481,10481,'color',0.0,0,0,0
10482,10482,'color-scheme',0.0,0,0,0
10483,10483,"'color: ""pink""'",0.0,0,0,0
10484,10484,'color: PropTypes.string',0.0,0,0,0
10485,10485,'color: PropTypes.string.isRequired',0.0,0,0,0
10486,10486,'color: brown',0.0,0,0,0
10487,10487,'color: burlywood;',0.0,0,0,0
10488,10488,'color: red',0.0,0,0,0
10489,10489,'color: red;',0.0,0,0,0
10490,10490,'color:blue',0.0,0,0,0
10491,10491,'color:transparent',0.0,0,0,0
10492,10492,'colors: PropTypes.arrayOf(PropTypes.string)',0.0,0,0,0
10493,10493,'colors: PropTypes.objectOf(PropTypes.string)',0.0,0,0,0
10494,10494,'com.example.android/package',0.0,0,0,0
10495,10495,'comment',0.0,0,0,0
10496,10496,'compiler.relay',0.0,0,0,0
10497,10497,'complete',0.0,0,0,0
10498,10498,'completed',0.0,0,0,0
10499,10499,'component',0.0,0,0,0
10500,10500,'component:index.server',0.0,0,0,0
10501,10501,'component:root.server',0.0,0,0,0
10502,10502,'componentName=',0.0,0,0,0
10503,10503,'components',0.0,0,0,0
10504,10504,'components/**/*.js',0.0,0,0,0
10505,10505,'components/**/B*.js',0.0,0,0,0
10506,10506,'components/**/P*.js',0.0,0,0,0
10507,10507,'components/*/*.js',0.0,0,0,0
10508,10508,'components/Button/*.js',0.0,0,0,0
10509,10509,'components/Button/Button.js',0.0,0,0,0
10510,10510,'components/Button/Readme.md',0.0,0,0,0
10511,10511,'components/Placeholder/Placeholder.js',0.0,0,0,0
10512,10512,'components/Placeholder/Placeholder.md',0.0,0,0,0
10513,10513,'components/RandomButton/RandomButton.js',0.0,0,0,0
10514,10514,'conditionallyRevealAnswer',0.0,0,0,0
10515,10515,'config option is deprecated. Don’t use!',0.0,0,0,0
10516,10516,'config option is required',0.0,0,0,0
10517,10517,"'config option should be object, received null'",0.0,0,0,0
10518,10518,'config option should be',0.0,0,0,0
10519,10519,'config',0.0,0,0,0
10520,10520,'config-down/one/two/three/',0.0,0,0,0
10521,10521,'config-js',0.0,0,0,0
10522,10522,'config-json',0.0,0,0,0
10523,10523,'config-long-cjs',0.0,0,0,0
10524,10524,'config-long-js',0.0,0,0,0
10525,10525,'config-long-json',0.0,0,0,0
10526,10526,'config-package-json',0.0,0,0,0
10527,10527,'configDir option should be a current directory if the config was passed as an object',0.0,0,0,0
10528,10528,'configDir option should be a directory of a passed config',0.0,0,0,0
10529,10529,'consider 127.0.0.1 and variations as localhost',0.0,0,0,0
10530,10530,'console',0.0,0,0,0
10531,10531,'console.error',0.0,0,0,0
10532,10532,"'const __NEXT_DROP_CLIENT_FILE__=""__NEXT_DROP_CLIENT_FILE__ 1234"";'",0.0,0,0,0
10533,10533,'constants',0.0,0,0,0
10534,10534,'constructor',0.0,0,0,0
10535,10535,'contains',0.0,0,0,0
10536,10536,'context from a function should be lazily evaluated',0.0,0,0,0
10537,10537,'context should get inferred for a builtin action within an array of entry actions',0.0,0,0,0
10538,10538,'context should get inferred for a builtin action within an array of transition actions',0.0,0,0,0
10539,10539,'context should get inferred for a stop action used as a transition action',0.0,0,0,0
10540,10540,'context should get inferred for a stop action used as an entry action',0.0,0,0,0
10541,10541,'context should get inferred for a stop actions within an array of entry actions',0.0,0,0,0
10542,10542,'context should get inferred for builtin actions used as a transition action',0.0,0,0,0
10543,10543,'context should get inferred for builtin actions used as an entry action',0.0,0,0,0
10544,10544,'converts a full transition',0.0,0,0,0
10545,10545,'converts a simple transition',0.0,0,0,0
10546,10546,'cookieName',0.0,0,0,0
10547,10547,'cookieValue',0.0,0,0,0
10548,10548,'cool',0.0,0,0,0
10549,10549,'copies plugin files to export directory',0.0,0,0,0
10550,10550,'correctly handles trailing slash in _next/data with basePath',0.0,0,0,0
10551,10551,'correctly handles trailing slash in _next/data with config',0.0,0,0,0
10552,10552,'correctly handles trailing slash in _next/data',0.0,0,0,0
10553,10553,'correctly parses a prefetch index url',0.0,0,0,0
10554,10554,'correctly parses a prefetch url with i18n',0.0,0,0,0
10555,10555,'correctly parses a prefetch url',0.0,0,0,0
10556,10556,'correctly sorts required slugs',0.0,0,0,0
10557,10557,'cosmos-export',0.0,0,0,0
10558,10558,'cosmos-export/',0.0,0,0,0
10559,10559,'cosmos-fooProjectId',0.0,0,0,0
10560,10560,'cosmos.config.json',0.0,0,0,0
10561,10561,'counted',0.0,0,0,0
10562,10562,'create output',0.0,0,0,0
10563,10563,'create root layout',0.0,0,0,0
10564,10564,'create',0.0,0,0,0
10565,10565,'createElement',0.0,0,0,0
10566,10566,'createServer should return an object containing a development Webpack compiler',0.0,0,0,0
10567,10567,'createServer should return an object containing a production Webpack compiler',0.0,0,0,0
10568,10568,'createServer should return an object containing a server instance',0.0,0,0,0
10569,10569,'creates an interpreter',0.0,0,0,0
10570,10570,'creates message handler',0.0,0,0,0
10571,10571,'creates nested tree with fixture',0.0,0,0,0
10572,10572,'creates nested tree with multi fixture',0.0,0,0,0
10573,10573,'creates tree with fixture',0.0,0,0,0
10574,10574,'creates tree with multi fixture',0.0,0,0,0
10575,10575,'creates value tree',0.0,0,0,0
10576,10576,'creator',0.0,0,0,0
10577,10577,'creatorId',0.0,0,0,0
10578,10578,'crouching',0.0,0,0,0
10579,10579,'crypto is available',0.0,0,0,0
10580,10580,'currentTarget',0.0,0,0,0
10581,10581,'custom pages/500',0.0,0,0,0
10582,10582,'custom path generators can be provided',0.0,0,0,0
10583,10583,'custom-agent',0.0,0,0,0
10584,10584,'custom-class custom-class-2',0.0,0,0,0
10585,10585,'custom-class-2',0.0,0,0,0
10586,10586,'customClass',0.0,0,0,0
10587,10587,'cycle',0.0,0,0,0
10588,10588,'d-none',0.0,0,0,0
10589,10589,'d3',0.0,0,0,0
10590,10590,'da',0.0,0,0,0
10591,10591,"'da, en'",0.0,0,0,0
10592,10592,"'da, en-GB'",0.0,0,0,0
10593,10593,"'da, en-GB, *'",0.0,0,0,0
10594,10594,"'da, en-GB, en'",0.0,0,0,0
10595,10595,"'da, en-GB, en-us'",0.0,0,0,0
10596,10596,"'da;q=0.5, en;q=1'",0.0,0,0,0
10597,10597,'dark',0.0,0,0,0
10598,10598,'data-bs-key',0.0,0,0,0
10599,10599,'data-bs-margin-right',0.0,0,0,0
10600,10600,'data-bs-padding-right',0.0,0,0,0
10601,10601,'data-bs-test-key',0.0,0,0,0
10602,10602,'data-key',0.0,0,0,0
10603,10603,'data-key-bs',0.0,0,0,0
10604,10604,'data-nimg',0.0,0,0,0
10605,10605,'data-param-first',0.0,0,0,0
10606,10606,'data-param-not-real',0.0,0,0,0
10607,10607,'data-param-second',0.0,0,0,0
10608,10608,'data-param-third',0.0,0,0,0
10609,10609,'data-params',0.0,0,0,0
10610,10610,'data-pathname',0.0,0,0,0
10611,10611,'data-query',0.0,0,0,0
10612,10612,'data.json',0.0,0,0,0
10613,10613,"'data:audio/opus;base64,iVBORw0KGgoAAAANSUhEUgAAABAAAAAQCAYAAAAf8/'",0.0,0,0,0
10614,10614,'data:image',0.0,0,0,0
10615,10615,"'data:image/png;base64,iVBORw0KGgoAAAANSUhEUgAAABAAAAAQCAYAAAAf8/'",0.0,0,0,0
10616,10616,"'data:video/webm;base64,iVBORw0KGgoAAAANSUhEUgAAABAAAAAQCAYAAAAf8/'",0.0,0,0,0
10617,10617,'deactivate',0.0,0,0,0
10618,10618,'decodes renderer URL fixture',0.0,0,0,0
10619,10619,'decoding',0.0,0,0,0
10620,10620,'deep-link',0.0,0,0,0
10621,10621,'deep.prop.baz',0.0,0,0,0
10622,10622,'default from @slot',0.0,0,0,0
10623,10623,'default getExampleFilename should return Component.md path if it exists',0.0,0,0,0
10624,10624,'default getExampleFilename should return Readme.md path if it exists',0.0,0,0,0
10625,10625,'default getExampleFilename should return false if no examples file found',0.0,0,0,0
10626,10626,'default view for parallel',0.0,0,0,0
10627,10627,'default-cache/page.js',0.0,0,0,0
10628,10628,'defaults lazy to false',0.0,0,0,0
10629,10629,'defer',0.0,0,0,0
10630,10630,'defined',0.0,0,0,0
10631,10631,'delayExpr',0.0,0,0,0
10632,10632,'delayed',0.0,0,0,0
10633,10633,'delegatedClickListener',0.0,0,0,0
10634,10634,'delete foo',0.0,0,0,0
10635,10635,'deploy',0.0,0,0,0
10636,10636,'deprecated',0.0,0,0,0
10637,10637,'derives string from StateMachine without typegen',0.0,0,0,0
10638,10638,'derives tags from StateMachine when typegen is enabled',0.0,0,0,0
10639,10639,'destroy',0.0,0,0,0
10640,10640,'destructuring assignment (array)',0.0,0,0,0
10641,10641,'destructuring assignment (object)',0.0,0,0,0
10642,10642,'details',0.0,0,0,0
10643,10643,'deux',0.0,0,0,0
10644,10644,'dev',0.0,0,0,0
10645,10645,'devTools should not be connected by default',0.0,0,0,0
10646,10646,'development',0.0,0,0,0
10647,10647,'diallows nested non-serializable types',0.0,0,0,0
10648,10648,'dialog',0.0,0,0,0
10649,10649,'die',0.0,0,0,0
10650,10650,'direct',0.0,0,0,0
10651,10651,'direction.center',0.0,0,0,0
10652,10652,'direction.right',0.0,0,0,0
10653,10653,'directory path',0.0,0,0,0
10654,10654,'disallows apex and optional catch all',0.0,0,0,0
10655,10655,'disallows mixing required catch all and optional catch all',0.0,0,0,0
10656,10656,'disallows optional params',0.0,0,0,0
10657,10657,'disallows top-level non-serializable types',0.0,0,0,0
10658,10658,'disconnect',0.0,0,0,0
10659,10659,'dispatchEvent',0.0,0,0,0
10660,10660,'displayName',0.0,0,0,0
10661,10661,'dispose',0.0,0,0,0
10662,10662,'div.collapse',0.0,0,0,0
10663,10663,'dns-prefetch',0.0,0,0,0
10664,10664,'doEffect',0.0,0,0,0
10665,10665,'doNotInvoke',0.0,0,0,0
10666,10666,'doSomething',0.0,0,0,0
10667,10667,'doSomethingParent',0.0,0,0,0
10668,10668,'do_a2',0.0,0,0,0
10669,10669,'do_a3_to_a2',0.0,0,0,0
10670,10670,'do_b2',0.0,0,0,0
10671,10671,'document.cookie',0.0,0,0,0
10672,10672,'does add the header for root data request',0.0,0,0,0
10673,10673,'does add the header for root request',0.0,0,0,0
10674,10674,'does noop changing to an invalid hostname',0.0,0,0,0
10675,10675,'does not add extra routes',0.0,0,0,0
10676,10676,'does not add locale for api route',0.0,0,0,0
10677,10677,'does not add the header for an unmatched path',0.0,0,0,0
10678,10678,'does not add the header for root data request',0.0,0,0,0
10679,10679,'does not add the header for root request',0.0,0,0,0
10680,10680,'does not build with page on the edge runtime',0.0,0,0,0
10681,10681,'does not collapse index fixture with sibling',0.0,0,0,0
10682,10682,'does not embed server-only plugins in playground HTML',0.0,0,0,0
10683,10683,'does not exist',0.0,0,0,0
10684,10684,'does not expose imports by default',0.0,0,0,0
10685,10685,'does not include HotModuleReplacementPlugin',0.0,0,0,0
10686,10686,'does not include nonce when not enabled',0.0,0,0,0
10687,10687,'does not include the locale in redirects by default',0.0,0,0,0
10688,10688,'does not include webpack-hot-middleware entry',0.0,0,0,0
10689,10689,"'does not print warning when there is ""app"" directory and no ""pages"" directory'",0.0,0,0,0
10690,10690,'does not provide params to routes without dynamic parameters',0.0,0,0,0
10691,10691,'does not reset fixture state on reselect',0.0,0,0,0
10692,10692,'does not send fixture select request to renderer with same selected fixture',0.0,0,0,0
10693,10693,'does not show code initially',0.0,0,0,0
10694,10694,'does not show table initially',0.0,0,0,0
10695,10695,'does not statically generate with dynamic usage',0.0,0,0,0
10696,10696,'doesn\'t try removing event listeners unless it needs to (in case it hasn\'t been activated)',0.0,0,0,0
10697,10697,'doesnt allow to set an unexisting locale',0.0,0,0,0
10698,10698,'doesn’t export a component',0.0,0,0,0
10699,10699,'done.invoke events should have unique names when invokee is a machine with an id property',0.0,0,0,0
10700,10700,'done.invoke events should only select onDone transition on the invoking state when invokee is referenced using a string',0.0,0,0,0
10701,10701,'done.invoke.(machine).a:invocation[0]',0.0,0,0,0
10702,10702,'done.invoke.(machine).first.fetch:invocation[0]',0.0,0,0,0
10703,10703,'done.invoke.(machine).second.fetch:invocation[0]',0.0,0,0,0
10704,10704,'done.invoke.myactor',0.0,0,0,0
10705,10705,'done.invoke.test',0.0,0,0,0
10706,10706,'dynamic first second',0.0,0,0,0
10707,10707,'dynamic first',0.0,0,0,0
10708,10708,'dynamic hello',0.0,0,0,0
10709,10709,'dynamic-error/[id]/page.js',0.0,0,0,0
10710,10710,'dynamic-first',0.0,0,0,0
10711,10711,'dynamic-no-gen-params-ssr/[slug]/page.js',0.0,0,0,0
10712,10712,'dynamic-no-gen-params/[slug]/page.js',0.0,0,0,0
10713,10713,'dynamicModal',0.0,0,0,0
10714,10714,'e3',0.0,0,0,0
10715,10715,'edge response again',0.0,0,0,0
10716,10716,'edge response',0.0,0,0,0
10717,10717,'edge',0.0,0,0,0
10718,10718,'edge-hmr',0.0,0,0,0
10719,10719,'editing',0.0,0,0,0
10720,10720,'editorConfig option should have default values',0.0,0,0,0
10721,10721,'editorConfig theme should change alias',0.0,0,0,0
10722,10722,'eight',0.0,0,0,0
10723,10723,'electronicsabc',0.0,0,0,0
10724,10724,'else',0.0,0,0,0
10725,10725,'embeds UI plugin in playground HTML',0.0,0,0,0
10726,10726,'embeds plugin in playground HTML',0.0,0,0,0
10727,10727,"'emits ""fixtureReselect"" event'",0.0,0,0,0
10728,10728,"'emits ""fixtureSelect"" event on ""fixtureId"" URL param change'",0.0,0,0,0
10729,10729,"'emits ""fixtureSelect"" event'",0.0,0,0,0
10730,10730,"'emits ""fixtureUnselect"" event on removed ""fixtureId"" URL param'",0.0,0,0,0
10731,10731,"'emits ""fixtureUnselect"" event'",0.0,0,0,0
10732,10732,'emits renderer request externally',0.0,0,0,0
10733,10733,'emits renderer response internally',0.0,0,0,0
10734,10734,'emits response event',0.0,0,0,0
10735,10735,'emits server message internally',0.0,0,0,0
10736,10736,'empty array',0.0,0,0,0
10737,10737,'empty string',0.0,0,0,0
10738,10738,'empty',0.0,0,0,0
10739,10739,"'en, en-GB'",0.0,0,0,0
10740,10740,"'en, en-GB, en-US'",0.0,0,0,0
10741,10741,"'en-US, en'",0.0,0,0,0
10742,10742,'en-us',0.0,0,0,0
10743,10743,"'en;q=0.6, en-GB;q=0.8'",0.0,0,0,0
10744,10744,'ends on the completed state',0.0,0,0,0
10745,10745,'enter: A',0.0,0,0,0
10746,10746,'enter: A.A1',0.0,0,0,0
10747,10747,'enter: A.A2',0.0,0,0,0
10748,10748,'enter: A.A2.A2_child',0.0,0,0,0
10749,10749,'enter: A.A2.A2a',0.0,0,0,0
10750,10750,'enter: a',0.0,0,0,0
10751,10751,'enter: a.a1',0.0,0,0,0
10752,10752,'enter: a.a1.a11',0.0,0,0,0
10753,10753,'enter: a.a2',0.0,0,0,0
10754,10754,'enter: loaded',0.0,0,0,0
10755,10755,'enter: loaded.idle',0.0,0,0,0
10756,10756,'enter: ready',0.0,0,0,0
10757,10757,'enter: ready.camera',0.0,0,0,0
10758,10758,'enter: ready.camera.off',0.0,0,0,0
10759,10759,'enter: ready.devicesInfo',0.0,0,0,0
10760,10760,'enterGreen',0.0,0,0,0
10761,10761,'enter_a',0.0,0,0,0
10762,10762,'enter_a1',0.0,0,0,0
10763,10763,'enter_a2',0.0,0,0,0
10764,10764,'enter_a3_fn',0.0,0,0,0
10765,10765,'enter_b',0.0,0,0,0
10766,10766,'enter_b1',0.0,0,0,0
10767,10767,'enter_b2',0.0,0,0,0
10768,10768,'enter_green',0.0,0,0,0
10769,10769,'enter_red',0.0,0,0,0
10770,10770,'enter_wait',0.0,0,0,0
10771,10771,'enter_walk',0.0,0,0,0
10772,10772,'enter_yellow',0.0,0,0,0
10773,10773,'entered foobaz',0.0,0,0,0
10774,10774,'errors about page using edge runtime',0.0,0,0,0
10775,10775,'errors for incorrect mix of functions',0.0,0,0,0
10776,10776,'escaped line terminators should work',0.0,0,0,0
10777,10777,'evaluates without error',0.0,0,0,0
10778,10778,'evening',0.0,0,0,0
10779,10779,'event type should be inferrable from a simple state machine type',0.0,0,0,0
10780,10780,'eventThatDoesNotExist',0.0,0,0,0
10781,10781,'example',0.0,0,0,0
10782,10782,'example.org',0.0,0,0,0
10783,10783,'examples',0.0,0,0,0
10784,10784,'executes actions from a restored state',0.0,0,0,0
10785,10785,'exist in this version of Next.js',0.0,0,0,0
10786,10786,'existing directory path',0.0,0,0,0
10787,10787,'existing file path',0.0,0,0,0
10788,10788,'exit actions should be called when invoked machine reaches its final state',0.0,0,0,0
10789,10789,'exit actions should be called when stopping a machine',0.0,0,0,0
10790,10790,'exit: A',0.0,0,0,0
10791,10791,'exit: A.A1',0.0,0,0,0
10792,10792,'exit: A.A2',0.0,0,0,0
10793,10793,'exit: A.A2.A2_child',0.0,0,0,0
10794,10794,'exit: __root__',0.0,0,0,0
10795,10795,'exit: a',0.0,0,0,0
10796,10796,'exit: a.a1',0.0,0,0,0
10797,10797,'exit: a.a1.a11',0.0,0,0,0
10798,10798,'exit: a.a2',0.0,0,0,0
10799,10799,'exit: a.child_a',0.0,0,0,0
10800,10800,'exit: b',0.0,0,0,0
10801,10801,'exit: b.child_b',0.0,0,0,0
10802,10802,'exit: loaded',0.0,0,0,0
10803,10803,'exit: loaded.idle',0.0,0,0,0
10804,10804,'exit: ready',0.0,0,0,0
10805,10805,'exit: ready.camera',0.0,0,0,0
10806,10806,'exit: ready.camera.on',0.0,0,0,0
10807,10807,'exit: ready.devicesInfo',0.0,0,0,0
10808,10808,'exitGreen',0.0,0,0,0
10809,10809,'exit_a',0.0,0,0,0
10810,10810,'exit_a1',0.0,0,0,0
10811,10811,'exit_a3_fn',0.0,0,0,0
10812,10812,'exit_b1',0.0,0,0,0
10813,10813,'exit_green',0.0,0,0,0
10814,10814,'exit_red',0.0,0,0,0
10815,10815,'exit_walk',0.0,0,0,0
10816,10816,'exit_yellow',0.0,0,0,0
10817,10817,'expandDefaultComponent() replace placeholders with component name',0.0,0,0,0
10818,10818,'experimental-edge',0.0,0,0,0
10819,10819,'explicit preference overrides range match',0.0,0,0,0
10820,10820,"'export array:4,5,6'",0.0,0,0,0
10821,10821,'export config with AsExpression',0.0,0,0,0
10822,10822,'export config with type annotation',0.0,0,0,0
10823,10823,'export const config = {} as PageConfig;',0.0,0,0,0
10824,10824,'export const config: PageConfig = {};',0.0,0,0,0
10825,10825,'export const config={};',0.0,0,0,0
10826,10826,'export named:named',0.0,0,0,0
10827,10827,'export object:{x:1}',0.0,0,0,0
10828,10828,'export value:123',0.0,0,0,0
10829,10829,'export {}',0.0,0,0,0
10830,10830,'extends boolean key',0.0,0,0,0
10831,10831,'extends number key',0.0,0,0,0
10832,10832,'extends partial array of objects',0.0,0,0,0
10833,10833,'extends partially serializable array key',0.0,0,0,0
10834,10834,'extends partially serializable object key',0.0,0,0,0
10835,10835,'extends serializable object key',0.0,0,0,0
10836,10836,'extends string key',0.0,0,0,0
10837,10837,'external',0.0,0,0,0
10838,10838,'extra layout default | Layout',0.0,0,0,0
10839,10839,'extracts all the assets from the bundle',0.0,0,0,0
10840,10840,'eyJwYXRoIjoiL3BhdGgvdG8vZml4dHVyZS5qcyIsIm5hbWUiOiJmaXJzdCJ9',0.0,0,0,0
10841,10841,'facebookexternalhit/1.0 (+http://www.facebook.com/externalhit_uatext.php)',0.0,0,0,0
10842,10842,'fadeInGreen',0.0,0,0,0
10843,10843,'fails getting if cache is not loaded',0.0,0,0,0
10844,10844,'fails setting if cache is not loaded',0.0,0,0,0
10845,10845,'failure',0.0,0,0,0
10846,10846,'fake',0.0,0,0,0
10847,10847,'fake-analytics-id',0.0,0,0,0
10848,10848,'fakeId',0.0,0,0,0
10849,10849,'favicon',0.0,0,0,0
10850,10850,'favors the browser export',0.0,0,0,0
10851,10851,'feedback',0.0,0,0,0
10852,10852,'fetch',0.0,0,0,0
10853,10853,'fetch-no-cache/page.js',0.0,0,0,0
10854,10854,'fetchMachine',0.0,0,0,0
10855,10855,'fetchPriority',0.0,0,0,0
10856,10856,'fetchSmth',0.0,0,0,0
10857,10857,'fifteen',0.0,0,0,0
10858,10858,'file path',0.0,0,0,0
10859,10859,'file:///someA/pathB?fooC=barD#hashE',0.0,0,0,0
10860,10860,'finds the shortest paths from a state to another state',0.0,0,0,0
10861,10861,'finds the shortest paths to a state without continuing traversal from that state',0.0,0,0,0
10862,10862,'finish',0.0,0,0,0
10863,10863,'finish_one',0.0,0,0,0
10864,10864,'finish_two',0.0,0,0,0
10865,10865,'first state',0.0,0,0,0
10866,10866,'five item array',0.0,0,0,0
10867,10867,'five',0.0,0,0,0
10868,10868,'fixture locked',0.0,0,0,0
10869,10869,'flattens fixture tree',0.0,0,0,0
10870,10870,'flight/[slug]/[slug2]/page.js',0.0,0,0,0
10871,10871,'fn: (e) => console.log(e)',0.0,0,0,0
10872,10872,'fn: PropTypes.func',0.0,0,0,0
10873,10873,'fn: null',0.0,0,0,0
10874,10874,'fn: undefined',0.0,0,0,0
10875,10875,'focusableChildren',0.0,0,0,0
10876,10876,'focusout',0.0,0,0,0
10877,10877,'font without preloadable subsets',0.0,0,0,0
10878,10878,'font without size adjust',0.0,0,0,0
10879,10879,'font-size',0.0,0,0,0
10880,10880,'fonts.js',0.0,0,0,0
10881,10881,'foo slot',0.0,0,0,0
10882,10882,'foo.bar',0.0,0,0,0
10883,10883,'foo.bar.baz.quo',0.0,0,0,0
10884,10884,'foo.client',0.0,0,0,0
10885,10885,'foo.false.baz',0.0,0,0,0
10886,10886,'foo/*.js',0.0,0,0,0
10887,10887,"'foo: ""bar"" | number'",0.0,0,0,0
10888,10888,"'foo: ""bar""'",0.0,0,0,0
10889,10889,'foo: () => void',0.0,0,0,0
10890,10890,"'foo: PropTypes.shape({bar: PropTypes.number.isRequired, baz: PropTypes.any})'",0.0,0,0,0
10891,10891,'foo: React.ReactNode',0.0,0,0,0
10892,10892,"'foo: [""bar"", number]'",0.0,0,0,0
10893,10893,'foo: string',0.0,0,0,0
10894,10894,'foo: { bar: string }',0.0,0,0,0
10895,10895,"'foo=; Path=/; Expires=Thu, 01 Jan 1970 00:00:00 GMT, fooz=; Path=/; Expires=Thu, 01 Jan 1970 00:00:00 GMT'",0.0,0,0,0
10896,10896,"'foo=; Path=/; Expires=Thu, 01 Jan 1970 00:00:00 GMT, fooz=barz; Path=/'",0.0,0,0,0
10897,10897,'foo=bar; Path=/',0.0,0,0,0
10898,10898,"'foo=bar; Path=/, fooz=barz; Path=/'",0.0,0,0,0
10899,10899,"'foo=bar; Path=/test, fooz=barz; Path=/test2'",0.0,0,0,0
10900,10900,'foo=foo1; Path=/',0.0,0,0,0
10901,10901,"'foo?: ""bar""'",0.0,0,0,0
10902,10902,'foo?: string',0.0,0,0,0
10903,10903,'fooKey',0.0,0,0,0
10904,10904,'fooProjectId',0.0,0,0,0
10905,10905,'fooValue',0.0,0,0,0
10906,10906,"'foos: PropTypes.arrayOf(PropTypes.shape({bar: PropTypes.number, baz: PropTypes.any}))'",0.0,0,0,0
10907,10907,'force-cache.html',0.0,0,0,0
10908,10908,'force-cache.rsc',0.0,0,0,0
10909,10909,'force-cache/page.js',0.0,0,0,0
10910,10910,'force-dynamic',0.0,0,0,0
10911,10911,'force-dynamic-catch-all/[slug]/[[...id]]/page.js',0.0,0,0,0
10912,10912,'force-dynamic-no-prerender/[id]/page.js',0.0,0,0,0
10913,10913,'force-dynamic-prerender/[slug]/page.js',0.0,0,0,0
10914,10914,'force-no-store/page.js',0.0,0,0,0
10915,10915,'force-static/[slug]/page.js',0.0,0,0,0
10916,10916,'force-static/first.html',0.0,0,0,0
10917,10917,'force-static/first.rsc',0.0,0,0,0
10918,10918,'force-static/page.js',0.0,0,0,0
10919,10919,'force-static/second.html',0.0,0,0,0
10920,10920,'force-static/second.rsc',0.0,0,0,0
10921,10921,'form',0.0,0,0,0
10922,10922,'formData',0.0,0,0,0
10923,10923,'format has been changed',0.0,0,0,0
10924,10924,'format-detection',0.0,0,0,0
10925,10925,'formats correctly the trailingSlash for root pages',0.0,0,0,0
10926,10926,'four item array',0.0,0,0,0
10927,10927,'fourteen',0.0,0,0,0
10928,10928,'framework',0.0,0,0,0
10929,10929,'frameworks',0.0,0,0,0
10930,10930,'frm',0.0,0,0,0
10931,10931,"'from-middleware=1; Path=/, hello=From API'",0.0,0,0,0
10932,10932,"'from-middleware=1; Path=/, hello=From%20API; Path=/'",0.0,0,0,0
10933,10933,'from-node-module',0.0,0,0,0
10934,10934,'fs: function',0.0,0,0,0
10935,10935,'ftp://abc',0.0,0,0,0
10936,10936,'ftp://example.com/path/to/file',0.0,0,0,0
10937,10937,'ftp://example.com:42/path/to/file',0.0,0,0,0
10938,10938,'ftp://example.com:81/path/to/file',0.0,0,0,0
10939,10939,'function () {}',0.0,0,0,0
10940,10940,'function a(){console.log(typeof window)}',0.0,0,0,0
10941,10941,'g-y 1',0.0,0,0,0
10942,10942,'g-y 2',0.0,0,0,0
10943,10943,'geist',0.0,0,0,0
10944,10944,'gen-params-dynamic-revalidate/[slug]/page.js',0.0,0,0,0
10945,10945,'gen-params-dynamic-revalidate/one.html',0.0,0,0,0
10946,10946,'gen-params-dynamic-revalidate/one.rsc',0.0,0,0,0
10947,10947,'gen-params-dynamic/[slug]',0.0,0,0,0
10948,10948,'gen-params-dynamic/[slug]/page.js',0.0,0,0,0
10949,10949,'general',0.0,0,0,0
10950,10950,'generates an adjacency list',0.0,0,0,0
10951,10951,'geo.city',0.0,0,0,0
10952,10952,'get',0.0,0,0,0
10953,10953,'getBoundingClientRect',0.0,0,0,0
10954,10954,'getComponentFiles() should accept components as a function that returns absolute paths',0.0,0,0,0
10955,10955,'getComponentFiles() should accept components as a function that returns file names',0.0,0,0,0
10956,10956,'getComponentFiles() should accept components as a glob',0.0,0,0,0
10957,10957,'getComponentFiles() should accept components as an array of file names',0.0,0,0,0
10958,10958,'getComponentFiles() should ignore specified patterns',0.0,0,0,0
10959,10959,'getComponentFiles() should return an empty array if components is null',0.0,0,0,0
10960,10960,"'getComponentFiles() should throw if components is not a function, array or a string'",0.0,0,0,0
10961,10961,'getComponentFilesFromSections() should ignore specified patterns',0.0,0,0,0
10962,10962,'getComponentFilesFromSections() should return a list of files',0.0,0,0,0
10963,10963,'getComponents() should return an object for components',0.0,0,0,0
10964,10964,'getComputedStyle',0.0,0,0,0
10965,10965,"'getComputedStyle(document.querySelector(""#app-open-sans"")).fontFamily'",0.0,0,0,0
10966,10966,"'getComputedStyle(document.querySelector(""#app-open-sans"")).fontStyle'",0.0,0,0,0
10967,10967,"'getComputedStyle(document.querySelector(""#app-open-sans"")).fontWeight'",0.0,0,0,0
10968,10968,"'getComputedStyle(document.querySelector(""#client-comp"")).fontFamily'",0.0,0,0,0
10969,10969,"'getComputedStyle(document.querySelector(""#client-comp"")).fontStyle'",0.0,0,0,0
10970,10970,"'getComputedStyle(document.querySelector(""#client-comp"")).fontWeight'",0.0,0,0,0
10971,10971,"'getComputedStyle(document.querySelector(""#client-layout"")).fontFamily'",0.0,0,0,0
10972,10972,"'getComputedStyle(document.querySelector(""#client-layout"")).fontStyle'",0.0,0,0,0
10973,10973,"'getComputedStyle(document.querySelector(""#client-layout"")).fontWeight'",0.0,0,0,0
10974,10974,"'getComputedStyle(document.querySelector(""#client-page"")).fontFamily'",0.0,0,0,0
10975,10975,"'getComputedStyle(document.querySelector(""#client-page"")).fontStyle'",0.0,0,0,0
10976,10976,"'getComputedStyle(document.querySelector(""#client-page"")).fontWeight'",0.0,0,0,0
10977,10977,"'getComputedStyle(document.querySelector(""#comp-with-fonts-inter"")).fontFamily'",0.0,0,0,0
10978,10978,"'getComputedStyle(document.querySelector(""#comp-with-fonts-inter"")).fontStyle'",0.0,0,0,0
10979,10979,"'getComputedStyle(document.querySelector(""#comp-with-fonts-inter"")).fontWeight'",0.0,0,0,0
10980,10980,"'getComputedStyle(document.querySelector(""#comp-with-fonts-roboto"")).fontFamily'",0.0,0,0,0
10981,10981,"'getComputedStyle(document.querySelector(""#comp-with-fonts-roboto"")).fontStyle'",0.0,0,0,0
10982,10982,"'getComputedStyle(document.querySelector(""#comp-with-fonts-roboto"")).fontWeight'",0.0,0,0,0
10983,10983,"'getComputedStyle(document.querySelector(""#root-comp"")).fontFamily'",0.0,0,0,0
10984,10984,"'getComputedStyle(document.querySelector(""#root-comp"")).fontStyle'",0.0,0,0,0
10985,10985,"'getComputedStyle(document.querySelector(""#root-comp"")).fontWeight'",0.0,0,0,0
10986,10986,"'getComputedStyle(document.querySelector(""#root-layout"")).fontFamily'",0.0,0,0,0
10987,10987,"'getComputedStyle(document.querySelector(""#root-layout"")).fontStyle'",0.0,0,0,0
10988,10988,"'getComputedStyle(document.querySelector(""#root-layout"")).fontWeight'",0.0,0,0,0
10989,10989,"'getComputedStyle(document.querySelector(""#root-page"")).fontFamily'",0.0,0,0,0
10990,10990,"'getComputedStyle(document.querySelector(""#root-page"")).fontStyle'",0.0,0,0,0
10991,10991,"'getComputedStyle(document.querySelector(""#root-page"")).fontWeight'",0.0,0,0,0
10992,10992,"'getComputedStyle(document.querySelector(""#variables-fira-code"")).fontFamily'",0.0,0,0,0
10993,10993,"'getComputedStyle(document.querySelector(""#variables-local-font"")).fontFamily'",0.0,0,0,0
10994,10994,"'getComputedStyle(document.querySelector(""#variables-roboto-100-italic"")).fontFamily'",0.0,0,0,0
10995,10995,"'getComputedStyle(document.querySelector(""#with-fallback-fonts-classname"")).fontFamily'",0.0,0,0,0
10996,10996,"'getComputedStyle(document.querySelector(""#with-fallback-fonts-style"")).fontFamily'",0.0,0,0,0
10997,10997,"'getComputedStyle(document.querySelector(""#with-fallback-fonts-variable"")).fontFamily'",0.0,0,0,0
10998,10998,"'getComputedStyle(document.querySelector(""#with-fonts-open-sans"")).fontFamily'",0.0,0,0,0
10999,10999,"'getComputedStyle(document.querySelector(""#with-fonts-open-sans"")).fontStyle'",0.0,0,0,0
11000,11000,"'getComputedStyle(document.querySelector(""#with-fonts-open-sans"")).fontWeight'",0.0,0,0,0
11001,11001,"'getComputedStyle(document.querySelector(""#with-fonts-open-sans-style"")).fontStyle'",0.0,0,0,0
11002,11002,"'getComputedStyle(document.querySelector(""#with-fonts-open-sans-style"")).fontWeight'",0.0,0,0,0
11003,11003,"'getComputedStyle(document.querySelector(""#without-variables-fira-code"")).fontFamily'",0.0,0,0,0
11004,11004,"'getComputedStyle(document.querySelector(""#without-variables-local-font"")).fontFamily'",0.0,0,0,0
11005,11005,"'getComputedStyle(document.querySelector(""#without-variables-roboto-100-italic"")).fontFamily'",0.0,0,0,0
11006,11006,'getConfiguration',0.0,0,0,0
11007,11007,'getExamples() should return an empty array if component has no example file',0.0,0,0,0
11008,11008,'getExamples() should return require with examples-loader is component ha example file',0.0,0,0,0
11009,11009,'getExamples() should return require with examples-loader is component has examples',0.0,0,0,0
11010,11010,'getImageUrl',0.0,0,0,0
11011,11011,'getOffset',0.0,0,0,0
11012,11012,'getOrCreateInstance',0.0,0,0,0
11013,11013,'getPopperConfig',0.0,0,0,0
11014,11014,'getRequests()',0.0,0,0,0
11015,11015,'getRootNode',0.0,0,0,0
11016,11016,'getSections() should return an array',0.0,0,0,0
11017,11017,'getServerSideProps',0.0,0,0,0
11018,11018,'gets the correct values',0.0,0,0,0
11019,11019,'gets the proper display name of a component',0.0,0,0,0
11020,11020,'given a config object must override data attributes',0.0,0,0,0
11021,11021,'global Headers should return true when undici is used',0.0,0,0,0
11022,11022,'global Request should return true when undici is used',0.0,0,0,0
11023,11023,'global Response should return true when undici is used',0.0,0,0,0
11024,11024,'global fetch should return true when undici is used',0.0,0,0,0
11025,11025,'global',0.0,0,0,0
11026,11026,'go-to-hello-world-anchor',0.0,0,0,0
11027,11027,'gone',0.0,0,0,0
11028,11028,'goodbye',0.0,0,0,0
11029,11029,'google fonts with multiple weights/styles',0.0,0,0,0
11030,11030,'google',0.0,0,0,0
11031,11031,'google-fetch-error/pages',0.0,0,0,0
11032,11032,'google-site-verification',0.0,0,0,0
11033,11033,"'got: hello, world.'",0.0,0,0,0
11034,11034,'grandchild',0.0,0,0,0
11035,11035,'gsp',0.0,0,0,0
11036,11036,'guard predicates should be able to be referenced from a function',0.0,0,0,0
11037,11037,'guard predicates should be able to be referenced from a string',0.0,0,0,0
11038,11038,'guard predicates should be able to be referenced from an object',0.0,0,0,0
11039,11039,'guardFn',0.0,0,0,0
11040,11040,'h2',0.0,0,0,0
11041,11041,'h5',0.0,0,0,0
11042,11042,'handleSuccess',0.0,0,0,0
11043,11043,'handles escalated errors as an expression',0.0,0,0,0
11044,11044,'handles escalated errors',0.0,0,0,0
11045,11045,'handles event cases',0.0,0,0,0
11046,11046,'handles non-plain object props',0.0,0,0,0
11047,11047,'handles null and undefined props',0.0,0,0,0
11048,11048,'has cookie',0.0,0,0,0
11049,11049,'has view code button',0.0,0,0,0
11050,11050,'has-match-2',0.0,0,0,0
11051,11051,'has-match-3',0.0,0,0,0
11052,11052,'hasHeader',0.0,0,0,0
11053,11053,'hasSidebar',0.0,0,0,0
11054,11054,'hashChangeComplete',0.0,0,0,0
11055,11055,'hashChangeStart',0.0,0,0,0
11056,11056,"'head > link[rel=""apple-touch-icon""]'",0.0,0,0,0
11057,11057,"'head > link[rel=""icon""]'",0.0,0,0,0
11058,11058,"'head > link[rel=""icon""][type!=""image/x-icon""]'",0.0,0,0,0
11059,11059,'head meta[itemProp]',0.0,0,0,0
11060,11060,"'head meta[name=""theme-color""]'",0.0,0,0,0
11061,11061,'head script[defer]',0.0,0,0,0
11062,11062,'head title',0.0,0,0,0
11063,11063,'head',0.0,0,0,0
11064,11064,'header meta[itemProp]',0.0,0,0,0
11065,11065,'header',0.0,0,0,0
11066,11066,'header:test-util',0.0,0,0,0
11067,11067,'heading',0.0,0,0,0
11068,11068,'hello ',0.0,0,0,0
11069,11069,'hello dashboard/page!',0.0,0,0,0
11070,11070,'hello from another',0.0,0,0,0
11071,11071,'hello from app/client-component-route. count: 0',0.0,0,0,0
11072,11072,'hello from app/client-component-route. count: 1',0.0,0,0,0
11073,11073,'hello from app/client-nested',0.0,0,0,0
11074,11074,'hello from app/dashboard',0.0,0,0,0
11075,11075,'hello from app/dashboard/(custom)/deployments/breakdown',0.0,0,0,0
11076,11076,'hello from app/dashboard/changelog',0.0,0,0,0
11077,11077,'hello from app/dashboard/deployments/[id]. ID is: 123',0.0,0,0,0
11078,11078,'hello from app/dashboard/index',0.0,0,0,0
11079,11079,'hello from app/dashboard/integrations',0.0,0,0,0
11080,11080,'hello from app/shared-component-route',0.0,0,0,0
11081,11081,'hello from app/should-not-serve-client',0.0,0,0,0
11082,11082,'hello from app/should-not-serve-server',0.0,0,0,0
11083,11083,'hello from gssp',0.0,0,0,0
11084,11084,'hello from layout',0.0,0,0,0
11085,11085,'hello from middleware',0.0,0,0,0
11086,11086,'hello from newroot/dashboard/another',0.0,0,0,0
11087,11087,'hello from page',0.0,0,0,0
11088,11088,'hello from pages/blog/[slug]',0.0,0,0,0
11089,11089,'hello from pages/index',0.0,0,0,0
11090,11090,'hello from slow layout',0.0,0,0,0
11091,11091,'hello nextjs',0.0,0,0,0
11092,11092,'hello world from /nested',0.0,0,0,0
11093,11093,'hello world!!',0.0,0,0,0
11094,11094,"'hello, world'",0.0,0,0,0
11095,11095,"'hello, world.'",0.0,0,0,0
11096,11096,'hello-world',0.0,0,0,0
11097,11097,'hello123',0.0,0,0,0
11098,11098,'hellooo',0.0,0,0,0
11099,11099,'hi fallback',0.0,0,0,0
11100,11100,'hi',0.0,0,0,0
11101,11101,'hidden event should not be triggered if hide is prevented',0.0,0,0,0
11102,11102,'hidden.bs.modal',0.0,0,0,0
11103,11103,'hidden.bs.offcanvas',0.0,0,0,0
11104,11104,'hidden.bs.popover',0.0,0,0,0
11105,11105,'hidden.bs.tab',0.0,0,0,0
11106,11106,'hidden.bs.toast',0.0,0,0,0
11107,11107,'hidden.bs.tooltip',0.0,0,0,0
11108,11108,'hide.bs.collapse',0.0,0,0,0
11109,11109,'hide.bs.dropdown',0.0,0,0,0
11110,11110,'hide.bs.modal',0.0,0,0,0
11111,11111,'hide.bs.offcanvas',0.0,0,0,0
11112,11112,'hide.bs.tab',0.0,0,0,0
11113,11113,'hide.bs.toast',0.0,0,0,0
11114,11114,'hide.bs.tooltip',0.0,0,0,0
11115,11115,'hideFunction',0.0,0,0,0
11116,11116,'hidePrevented',0.0,0,0,0
11117,11117,'hidePrevented.bs.offcanvas',0.0,0,0,0
11118,11118,'hides fixture suffix',0.0,0,0,0
11119,11119,'hides nested fixture suffix',0.0,0,0,0
11120,11120,'high',0.0,0,0,0
11121,11121,'history',0.0,0,0,0
11122,11122,'hit: 1',0.0,0,0,0
11123,11123,'hit: 2',0.0,0,0,0
11124,11124,'hobbit',0.0,0,0,0
11125,11125,'home',0.0,0,0,0
11126,11126,'home-link',0.0,0,0,0
11127,11127,'homepage',0.0,0,0,0
11128,11128,'hooks/use-pathname/[slug]/page.js',0.0,0,0,0
11129,11129,'hooks/use-pathname/slug.html',0.0,0,0,0
11130,11130,'hooks/use-pathname/slug.rsc',0.0,0,0,0
11131,11131,'hooks/use-search-params.html',0.0,0,0,0
11132,11132,'hooks/use-search-params.rsc',0.0,0,0,0
11133,11133,'hooks/use-search-params/force-static.html',0.0,0,0,0
11134,11134,'hooks/use-search-params/force-static.rsc',0.0,0,0,0
11135,11135,'hooks/use-search-params/force-static/page.js',0.0,0,0,0
11136,11136,'hooks/use-search-params/page.js',0.0,0,0,0
11137,11137,'hooks/use-search-params/with-suspense.html',0.0,0,0,0
11138,11138,'hooks/use-search-params/with-suspense.rsc',0.0,0,0,0
11139,11139,'hooks/use-search-params/with-suspense/page.js',0.0,0,0,0
11140,11140,'hover.bs.carousel',0.0,0,0,0
11141,11141,"'href=""/apple-icon-x3.png""'",0.0,0,0,0
11142,11142,"'href=""/assets/startup/apple-touch-startup-image-1536x2008.png""'",0.0,0,0,0
11143,11143,"'href=""/assets/startup/apple-touch-startup-image-768x1004.png""'",0.0,0,0,0
11144,11144,"'href=""javascript:alert(7)'",0.0,0,0,0
11145,11145,"'hreflang=""de-DE""'",0.0,0,0,0
11146,11146,"'hreflang=""en-US""'",0.0,0,0,0
11147,11147,'html',0.0,0,0,0
11148,11148,'http:',0.0,0,0,0
11149,11149,'http:///localhost:3000/api',0.0,0,0,0
11150,11150,'http://127.0.0.1',0.0,0,0,0
11151,11151,'http://127.0.0.1:3000',0.0,0,0,0
11152,11152,'http://127.0.0.1:3000/hello',0.0,0,0,0
11153,11153,'http://127.0.1.0:3000/hello',0.0,0,0,0
11154,11154,'http://::1:3000/hello',0.0,0,0,0
11155,11155,'http://JavaScript/my.js',0.0,0,0,0
11156,11156,'http://abc',0.0,0,0,0
11157,11157,'http://example.com',0.0,0,0,0
11158,11158,'http://example.com/path/to/file',0.0,0,0,0
11159,11159,'http://example.com/styleguide/#!/FooBar',0.0,0,0,0
11160,11160,'http://example.com/styleguide/#!/FooBar/3',0.0,0,0,0
11161,11161,'http://example.com/styleguide/#foobar',0.0,0,0,0
11162,11162,'http://example.com/styleguide/',0.0,0,0,0
11163,11163,'http://example.com/styleguide/?nochrome#!/FooBar',0.0,0,0,0
11164,11164,'http://example.com:3210/someF/pathG?fooH=barI#hashJ',0.0,0,0,0
11165,11165,'http://example.com:42/path/to/file',0.0,0,0,0
11166,11166,'http://example.com:81/path/to/file',0.0,0,0,0
11167,11167,'http://foo.com/bar',0.0,0,0,0
11168,11168,'http://google.com/someF/pathG?fooH=barI#hashJ',0.0,0,0,0
11169,11169,'http://localhost',0.0,0,0,0
11170,11170,'http://localhost.com',0.0,0,0,0
11171,11171,'http://localhost.com/example?foo=bar',0.0,0,0,0
11172,11172,'http://localhost/about?param1=value1',0.0,0,0,0
11173,11173,'http://localhost/es/bar',0.0,0,0,0
11174,11174,'http://localhost/root-test/es/test',0.0,0,0,0
11175,11175,'http://localhost/root/bar',0.0,0,0,0
11176,11176,'http://localhost/root/en/bar',0.0,0,0,0
11177,11177,'http://localhost/root/es/bar',0.0,0,0,0
11178,11178,'http://localhost/root/example',0.0,0,0,0
11179,11179,'http://localhost/root/fr/bar',0.0,0,0,0
11180,11180,'http://localhost:',0.0,0,0,0
11181,11181,'http://localhost:3000/_next/data/1234/abc.json',0.0,0,0,0
11182,11182,'http://localhost:3000/_next/data/1234/en/hello.json',0.0,0,0,0
11183,11183,'http://localhost:3000/_next/data/development/en/foo.json',0.0,0,0,0
11184,11184,'http://localhost:3000/_next/data/development/en/hello.json',0.0,0,0,0
11185,11185,'http://localhost:3000/_next/data/development/index.json',0.0,0,0,0
11186,11186,'http://localhost:3000/about?param1=value1',0.0,0,0,0
11187,11187,'http://localhost:3000/api',0.0,0,0,0
11188,11188,'http://localhost:3000/api/hello',0.0,0,0,0
11189,11189,'http://localhost:3000/docs/_next/data/1234/abc.json',0.0,0,0,0
11190,11190,'http://localhost:3000/dynamic',0.0,0,0,0
11191,11191,'http://localhost:3000/es',0.0,0,0,0
11192,11192,'http://localhost:3000/es/',0.0,0,0,0
11193,11193,'http://localhost:3000/hello',0.0,0,0,0
11194,11194,'http://localhost:3000/hihi?param1=value1',0.0,0,0,0
11195,11195,'http://localhost:5000',0.0,0,0,0
11196,11196,'http://localhost:5000/?fixtureId=%7B%22path%22%3A%22%2Fpath%2Fto%2Ffixture.js%22%2C%22name%22%3A%22first%22%7D&locked=true',0.0,0,0,0
11197,11197,'http://localhost:5000/?fixtureId=%7B%22path%22%3A%22%2Fpath%2Fto%2Ffixture.js%22%2C%22name%22%3A%22first%22%7D',0.0,0,0,0
11198,11198,'http://localhost:5000/?fixtureId=%7B%22path%22%3A%22src%2FCounter.fixture.tsx%22%2C%22name%22%3A%22default%22%7D',0.0,0,0,0
11199,11199,'http://localhost:5000/?fixtureId=%7B%22path%22%3A%22src%2FCounter.fixture.tsx%22%2C%22name%22%3A%22large+number%22%7D',0.0,0,0,0
11200,11200,'http://localhost:5000/?fixtureId=%7B%22path%22%3A%22src%2FCounter.fixture.tsx%22%2C%22name%22%3A%22small+number%22%7D',0.0,0,0,0
11201,11201,'http://localhost:5000/?fixtureId=%7B%22path%22%3A%22src%2FCounterButton.fixture.tsx%22%7D',0.0,0,0,0
11202,11202,'http://localhost:5000/?fixtureId=%7B%22path%22%3A%22src%2FWelcomeMessage%2FWelcomeMessage.fixture.tsx%22%7D',0.0,0,0,0
11203,11203,'http://localhost:5000/?fixtureId=%7B%22path%22%3A%22src%2F__fixtures__%2Fcontrols%2FCustom+Panel.tsx%22%7D',0.0,0,0,0
11204,11204,'http://localhost:5000/?fixtureId=%7B%22path%22%3A%22src%2F__fixtures__%2Fcontrols%2FProps+Panel.tsx%22%7D',0.0,0,0,0
11205,11205,'http://localhost:5000/cosmos/eyJwYXRoIjoiL3BhdGgvdG8vZml4dHVyZS5qcyIsIm5hbWUiOiJmaXJzdCJ9',0.0,0,0,0
11206,11206,'http://localhost:5000/cosmos/eyJwYXRoIjoiL3BhdGgvdG8vZml4dHVyZS5qcyIsIm5hbWUiOiJmaXJzdCJ9?locked=true',0.0,0,0,0
11207,11207,'http://localhost:5000/cosmos/index',0.0,0,0,0
11208,11208,'http://localhost:5000/eyJwYXRoIjoiL3BhdGgvdG8vZml4dHVyZS5qcyIsIm5hbWUiOiJmaXJzdCJ9',0.0,0,0,0
11209,11209,'http://localhost:5000/eyJwYXRoIjoiL3BhdGgvdG8vZml4dHVyZS5qcyIsIm5hbWUiOiJmaXJzdCJ9?locked=true',0.0,0,0,0
11210,11210,'http://localhost:5000/index',0.0,0,0,0
11211,11211,'http://localhost:5000/renderer.html',0.0,0,0,0
11212,11212,'http://localhost:5000/renderer.html?fixtureId=%7B%22path%22%3A%22%2Fpath%2Fto%2Ffixture.js%22%2C%22name%22%3A%22first%22%7D&locked=true',0.0,0,0,0
11213,11213,'http://localhost:5000/renderer.html?fixtureId=%7B%22path%22%3A%22%2Fpath%2Fto%2Ffixture.js%22%2C%22name%22%3A%22first%22%7D',0.0,0,0,0
11214,11214,'http://localhost:5000/renderer.html?fixtureId=%7B%22path%22%3A%22src%2FCounter.fixture.tsx%22%2C%22name%22%3A%22default%22%7D',0.0,0,0,0
11215,11215,'http://localhost:5000/renderer.html?fixtureId=%7B%22path%22%3A%22src%2FCounter.fixture.tsx%22%2C%22name%22%3A%22large+number%22%7D',0.0,0,0,0
11216,11216,'http://localhost:5000/renderer.html?fixtureId=%7B%22path%22%3A%22src%2FCounter.fixture.tsx%22%2C%22name%22%3A%22small+number%22%7D',0.0,0,0,0
11217,11217,'http://localhost:5000/renderer.html?fixtureId=%7B%22path%22%3A%22src%2FCounterButton.fixture.tsx%22%7D',0.0,0,0,0
11218,11218,'http://localhost:5000/renderer.html?fixtureId=%7B%22path%22%3A%22src%2FWelcomeMessage%2FWelcomeMessage.fixture.tsx%22%7D',0.0,0,0,0
11219,11219,'http://localhost:5000/renderer.html?fixtureId=%7B%22path%22%3A%22src%2F__fixtures__%2Fcontrols%2FCustom+Panel.tsx%22%7D',0.0,0,0,0
11220,11220,'http://localhost:5000/renderer.html?fixtureId=%7B%22path%22%3A%22src%2F__fixtures__%2Fcontrols%2FProps+Panel.tsx%22%7D',0.0,0,0,0
11221,11221,'http://localhost:5050',0.0,0,0,0
11222,11222,'http://localhost:8080/test?foo=bar',0.0,0,0,0
11223,11223,'https',0.0,0,0,0
11224,11224,'https:',0.0,0,0,0
11225,11225,'https://127.0.0.1:3000/hello',0.0,0,0,0
11226,11226,'https://127.0.1.0:3000/hello',0.0,0,0,0
11227,11227,'https://::1:3000/hello',0.0,0,0,0
11228,11228,'https://abc',0.0,0,0,0
11229,11229,'https://avatars.1.example.com',0.0,0,0,0
11230,11230,'https://avatars.a.example.com',0.0,0,0,0
11231,11231,'https://avatars.example.com',0.0,0,0,0
11232,11232,'https://avatars.ia.example.com',0.0,0,0,0
11233,11233,'https://avatars.iad1.example.com',0.0,0,0,0
11234,11234,'https://avatars.iad2.example.com',0.0,0,0,0
11235,11235,'https://avatars.sfo1.example.com',0.0,0,0,0
11236,11236,'https://avatars.sfo2.example.com',0.0,0,0,0
11237,11237,'https://bar.example/url/subpath',0.0,0,0,0
11238,11238,'https://com',0.0,0,0,0
11239,11239,'https://com:42',0.0,0,0,0
11240,11240,'https://deep.sub.example.com',0.0,0,0,0
11241,11241,'https://example.com.uk',0.0,0,0,0
11242,11242,'https://example.com.uk:42',0.0,0,0,0
11243,11243,'https://example.com/',0.0,0,0,0
11244,11244,'https://example.com/act123',0.0,0,0,0
11245,11245,'https://example.com/act123/4/pic.jpg',0.0,0,0,0
11246,11246,'https://example.com/act123/sr/pic.jpg',0.0,0,0,0
11247,11247,'https://example.com/act123/team/pic.jpg',0.0,0,0,0
11248,11248,'https://example.com/act123/team4/pic.jpg',0.0,0,0,0
11249,11249,'https://example.com/act123/team5/pic.jpg',0.0,0,0,0
11250,11250,'https://example.com/act123/usr/pic.jpg',0.0,0,0,0
11251,11251,'https://example.com/act123/usr4',0.0,0,0,0
11252,11252,'https://example.com/act123/usr4/pic',0.0,0,0,0
11253,11253,'https://example.com/act123/usr4/pic.jpg',0.0,0,0,0
11254,11254,'https://example.com/act123/usr4/picsjpg',0.0,0,0,0
11255,11255,'https://example.com/act123/usr5/pic.jpg',0.0,0,0,0
11256,11256,'https://example.com/act123/usr6/pic.jpg',0.0,0,0,0
11257,11257,'https://example.com/act456/team/pic.jpg',0.0,0,0,0
11258,11258,'https://example.com/act456/team5/pic.jpg',0.0,0,0,0
11259,11259,'https://example.com/alternates',0.0,0,0,0
11260,11260,'https://example.com/alternates/child',0.0,0,0,0
11261,11261,'https://example.com/alternates/child/123',0.0,0,0,0
11262,11262,'https://example.com/alternates/child/de-DE',0.0,0,0,0
11263,11263,'https://example.com/alternates/child/en-US',0.0,0,0,0
11264,11264,'https://example.com/alternates/de-DE',0.0,0,0,0
11265,11265,'https://example.com/alternates/en-US',0.0,0,0,0
11266,11266,'https://example.com/blog.rss',0.0,0,0,0
11267,11267,'https://example.com/blog/js.rss',0.0,0,0,0
11268,11268,'https://example.com/icon.png',0.0,0,0,0
11269,11269,'https://example.com/ios',0.0,0,0,0
11270,11270,'https://example.com/mobile',0.0,0,0,0
11271,11271,'https://example.com/og-image.jpg',0.0,0,0,0
11272,11272,'https://example.com/path',0.0,0,0,0
11273,11273,'https://example.com/path/to',0.0,0,0,0
11274,11274,'https://example.com/path/to/file?q=1',0.0,0,0,0
11275,11275,'https://example.com/team/pic.jpg',0.0,0,0,0
11276,11276,"'https://example.com/test.png?w=128&q=75 1x, https://example.com/test.png?w=256&q=75 2x'",0.0,0,0,0
11277,11277,'https://example.com/test.png?w=256&q=75',0.0,0,0,0
11278,11278,'https://example.com:42',0.0,0,0,0
11279,11279,'https://example.com:42/file',0.0,0,0,0
11280,11280,'https://example.com:42/path',0.0,0,0,0
11281,11281,'https://example.com:42/path/to',0.0,0,0,0
11282,11282,'https://example.com:42/path/to/file',0.0,0,0,0
11283,11283,'https://example.com:42/path/to/file?q=1',0.0,0,0,0
11284,11284,'https://example.com:81/path/to/file',0.0,0,0,0
11285,11285,'https://example.com:81/path/to/file?q=1',0.0,0,0,0
11286,11286,'https://example.net',0.0,0,0,0
11287,11287,'https://example.vercel.sh',0.0,0,0,0
11288,11288,'https://example.vercel.sh/somewhere',0.0,0,0,0
11289,11289,'https://example.vercel.sh/somewhere/',0.0,0,0,0
11290,11290,'https://example.vercel.sh/vitals',0.0,0,0,0
11291,11291,'https://foo.bar',0.0,0,0,0
11292,11292,'https://foo.com/test/bar',0.0,0,0,0
11293,11293,'https://ipad_url',0.0,0,0,0
11294,11294,'https://iphone_url',0.0,0,0,0
11295,11295,'https://localhost.com/foo',0.0,0,0,0
11296,11296,'https://localhost/foo',0.0,0,0,0
11297,11297,'https://localhost:3000/foo',0.0,0,0,0
11298,11298,'https://localhost:3000/hello',0.0,0,0,0
11299,11299,'https://localhost:3001/foo',0.0,0,0,0
11300,11300,'https://localhost:80/foo',0.0,0,0,0
11301,11301,'https://more.avatars.iad1.example.com',0.0,0,0,0
11302,11302,'https://mydomain.com/',0.0,0,0,0
11303,11303,'https://next-data-api-endpoint.vercel.app/api/random?b2',0.0,0,0,0
11304,11304,'https://nextjs.org/',0.0,0,0,0
11305,11305,'https://nextjs.org/docs/messages/next-response-next-in-app-route-handler',0.0,0,0,0
11306,11306,'https://outerspace.com/huozhi.png',0.0,0,0,0
11307,11307,'https://sub.example.com',0.0,0,0,0
11308,11308,'https://sub.example.com.uk',0.0,0,0,0
11309,11309,'https://sub.example.com/act123/team/pic.jpg',0.0,0,0,0
11310,11310,'https://sub.example.com/act123/usr6/pic.jpg',0.0,0,0,0
11311,11311,'https://sub.example.com:42',0.0,0,0,0
11312,11312,'https://tree.com',0.0,0,0,0
11313,11313,'https://twitter.com/image-100x100.png',0.0,0,0,0
11314,11314,'https://twitter.com/image-200x200.png',0.0,0,0,0
11315,11315,'https://twitter.com/image.png',0.0,0,0,0
11316,11316,'https://twitter.com/large-image.png',0.0,0,0,0
11317,11317,'https://twitter.com/player',0.0,0,0,0
11318,11318,'https://twitter.com/secure.png',0.0,0,0,0
11319,11319,'https://twitter.com/stream',0.0,0,0,0
11320,11320,'https://vitals.vercel-insights.com/v1/vitals',0.0,0,0,0
11321,11321,'https://x.y',0.0,0,0,0
11322,11322,'huozhi',0.0,0,0,0
11323,11323,'i am',0.0,0,0,0
11324,11324,'i18n',0.0,0,0,0
11325,11325,'ia_archiver (+http://www.alexa.com/site/help/webmasters; crawler@alexa.com)',0.0,0,0,0
11326,11326,'icon',0.0,0,0,0
11327,11327,'id-1',0.0,0,0,0
11328,11328,'id-2',0.0,0,0,0
11329,11329,'identifies initial activities',0.0,0,0,0
11330,11330,'identifies multiple stop activities for child and parent states',0.0,0,0,0
11331,11331,'identifies start activities for child states and active activities',0.0,0,0,0
11332,11332,'identifies start activities',0.0,0,0,0
11333,11333,'identifies stop activities for child states',0.0,0,0,0
11334,11334,'idle.absent',0.0,0,0,0
11335,11335,'idle.hist',0.0,0,0,0
11336,11336,'idle.present',0.0,0,0,0
11337,11337,"'if configured not to autofocus, should not autofocus itself'",0.0,0,0,0
11338,11338,"'if data-bs-dismiss=""PluginName"" hasn\'t got ""data-bs-target"", ""getOrCreateInstance"" has to be initialized by closest ""plugin.Name"" class'",0.0,0,0,0
11339,11339,"'if data-bs-dismiss=""PluginName"" is disabled, must not trigger function'",0.0,0,0,0
11340,11340,"'if event is not one of left/right/up/down arrow, ignore it'",0.0,0,0,0
11341,11341,'if keydown event is left arrow and next element is disabled',0.0,0,0,0
11342,11342,"'if keydown event is left arrow, handle it'",0.0,0,0,0
11343,11343,'if keydown event is right arrow and next element is disabled',0.0,0,0,0
11344,11344,"'if keydown event is right/down arrow, handle it'",0.0,0,0,0
11345,11345,"'if scroll is disabled, should call ScrollBarHelper to handle scrollBar on body'",0.0,0,0,0
11346,11346,"'if scroll is enabled, should allow body to scroll while offcanvas is open'",0.0,0,0,0
11347,11347,'ignoredProp',0.0,0,0,0
11348,11348,'ignores an empty preferences array',0.0,0,0,0
11349,11349,'ignores preference case when matching',0.0,0,0,0
11350,11350,'ignores unrelated options starting with --inspect-',0.0,0,0,0
11351,11351,'ignores update from secondary renderer',0.0,0,0,0
11352,11352,'image-alt',0.0,0,0,0
11353,11353,'image-file',0.0,0,0,0
11354,11354,'image-response',0.0,0,0,0
11355,11355,'image/avif',0.0,0,0,0
11356,11356,'image/svg+xml',0.0,0,0,0
11357,11357,'image/webp',0.0,0,0,0
11358,11358,'image/x-icon',0.0,0,0,0
11359,11359,'immediately notifies the listener with the initial state and event',0.0,0,0,0
11360,11360,'implements HEAD on routes with GET already implemented',0.0,0,0,0
11361,11361,'implements OPTIONS on routes',0.0,0,0,0
11362,11362,'includes DOM devtooks hook entry',0.0,0,0,0
11363,11363,'includes HotModuleReplacementPlugin',0.0,0,0,0
11364,11364,'includes HtmlWebpackPlugin',0.0,0,0,0
11365,11365,'includes a nonce value with inline scripts when Content-Security-Policy header is defined',0.0,0,0,0
11366,11366,'includes an integrity attribute on scripts',0.0,0,0,0
11367,11367,'includes client entry',0.0,0,0,0
11368,11368,'includes plugin from user config',0.0,0,0,0
11369,11369,'includes plugin from user override',0.0,0,0,0
11370,11370,'includes user imports loader',0.0,0,0,0
11371,11371,'includes user plugin',0.0,0,0,0
11372,11372,'includes user rule',0.0,0,0,0
11373,11373,'includes webpack-hot-middleware entry',0.0,0,0,0
11374,11374,'index - app',0.0,0,0,0
11375,11375,'index',0.0,0,0,0
11376,11376,"'index, follow'",0.0,0,0,0
11377,11377,"'index, nofollow, noimageindex, max-video-preview:standard, max-image-preview:-1, max-snippet:-1'",0.0,0,0,0
11378,11378,'index.html',0.0,0,0,0
11379,11379,'index.js',0.0,0,0,0
11380,11380,'index.rsc',0.0,0,0,0
11381,11381,'info',0.0,0,0,0
11382,11382,'inherit',0.0,0,0,0
11383,11383,'initial actions should receive context updated only by preceeding assign actions',0.0,0,0,0
11384,11384,'initial invoked actor should be immediately available',0.0,0,0,0
11385,11385,'initial state should be cached',0.0,0,0,0
11386,11386,'initial',0.0,0,0,0
11387,11387,'initialState = {a: 1}',0.0,0,0,0
11388,11388,'initialState',0.0,0,0,0
11389,11389,'initialized custom cache-handler',0.0,0,0,0
11390,11390,'inner',0.0,0,0,0
11391,11391,'input still focused',0.0,0,0,0
11392,11392,'input.css',0.0,0,0,0
11393,11393,'inserted.bs.tooltip',0.0,0,0,0
11394,11394,'inside',0.0,0,0,0
11395,11395,'integrity',0.0,0,0,0
11396,11396,'intercepted',0.0,0,0,0
11397,11397,'interception from @slot/nested',0.0,0,0,0
11398,11398,'internal',0.0,0,0,0
11399,11399,'invalid dynamic route',0.0,0,0,0
11400,11400,'invalid static route',0.0,0,0,0
11401,11401,'invalid type',0.0,0,0,0
11402,11402,'invalid',0.0,0,0,0
11403,11403,'invalid-predicate',0.0,0,0,0
11404,11404,'invalid-target',0.0,0,0,0
11405,11405,'invoke `src` should accept invoke source definition',0.0,0,0,0
11406,11406,'invoke generated ID should be predictable based on the state node where it is defined',0.0,0,0,0
11407,11407,'invoke',0.0,0,0,0
11408,11408,'invokeChild',0.0,0,0,0
11409,11409,'invokePromise',0.0,0,0,0
11410,11410,'invoked actor in a standalone component should be able to receive events',0.0,0,0,0
11411,11411,'invoked child should be available on the new state',0.0,0,0,0
11412,11412,'invoked child should not be available on the state after leaving invoking state',0.0,0,0,0
11413,11413,'invoked.child',0.0,0,0,0
11414,11414,'ionic://localhost/someA/pathB?fooC=barD#hashE',0.0,0,0,0
11415,11415,'is not any',0.0,0,0,0
11416,11416,'is not defined',0.0,0,0,0
11417,11417,'is present',0.0,0,0,0
11418,11418,'is',0.0,0,0,0
11419,11419,'isAlsoNamed',0.0,0,0,0
11420,11420,'isLonely',0.0,0,0,0
11421,11421,'isNamed',0.0,0,0,0
11422,11422,'isSupported',0.0,0,0,0
11423,11423,'isolated',0.0,0,0,0
11424,11424,'isr-multiple/nested',0.0,0,0,0
11425,11425,'isr-ssr-combined/nested',0.0,0,0,0
11426,11426,'it works',0.0,0,0,0
11427,11427,'italic',0.0,0,0,0
11428,11428,'item count 128000',0.0,0,0,0
11429,11429,'item2 is focused',0.0,0,0,0
11430,11430,'jQuery',0.0,0,0,0
11431,11431,'jav&#x09;ascript:alert();',0.0,0,0,0
11432,11432,'jav\u0000ascript:alert();',0.0,0,0,0
11433,11433,'javascript:alert(7)',0.0,0,0,0
11434,11434,'javascript:evil()',0.0,0,0,0
11435,11435,'john',0.0,0,0,0
11436,11436,'js coffee',0.0,0,0,0
11437,11437,"'js { ""showCode"": true }'",0.0,0,0,0
11438,11438,"'js { ""showcode"": true }'",0.0,0,0,0
11439,11439,'js { nope }',0.0,0,0,0
11440,11440,'js-ts-config',0.0,0,0,0
11441,11441,'json',0.0,0,0,0
11442,11442,'jss plugins should be enabled',0.0,0,0,0
11443,11443,'jss-global plugin should be enabled',0.0,0,0,0
11444,11444,'jsx showCode Static',0.0,0,0,0
11445,11445,'jsx showcode static',0.0,0,0,0
11446,11446,'jsx',0.0,0,0,0
11447,11447,'just anything',0.0,0,0,0
11448,11448,'kB',0.0,0,0,0
11449,11449,'kMaxLength',0.0,0,0,0
11450,11450,'kStringMaxLength',0.0,0,0,0
11451,11451,'keeps empty object key',0.0,0,0,0
11452,11452,'keeps fixtures state when secondary renderer connects',0.0,0,0,0
11453,11453,'keeps null key',0.0,0,0,0
11454,11454,'keeps other resolve plugins',0.0,0,0,0
11455,11455,'keeps the trailingSlash format for non root pages',0.0,0,0,0
11456,11456,'keeps undefined key',0.0,0,0,0
11457,11457,'keeps unserializable function key',0.0,0,0,0
11458,11458,'keeps unserializable regexp key',0.0,0,0,0
11459,11459,'key',0.0,0,0,0
11460,11460,'keydown.bs.carousel',0.0,0,0,0
11461,11461,'keywords',0.0,0,0,0
11462,11462,'last',0.0,0,0,0
11463,11463,'lax',0.0,0,0,0
11464,11464,'layout.js',0.0,0,0,0
11465,11465,'lazy',0.0,0,0,0
11466,11466,'letter',0.0,0,0,0
11467,11467,'level',0.0,0,0,0
11468,11468,'li:first-child a',0.0,0,0,0
11469,11469,'li:last-child .dropdown-menu a:first-child',0.0,0,0,0
11470,11470,'li:last-child a',0.0,0,0,0
11471,11471,'light.red',0.0,0,0,0
11472,11472,'light.red.flashing',0.0,0,0,0
11473,11473,'light.red.stop',0.0,0,0,0
11474,11474,'light.red.wait',0.0,0,0,0
11475,11475,'light.red.walk',0.0,0,0,0
11476,11476,'link to home clicked but prevented',0.0,0,0,0
11477,11477,'link to home clicked',0.0,0,0,0
11478,11478,'link to home',0.0,0,0,0
11479,11479,'link-to-app',0.0,0,0,0
11480,11480,'link-to-b',0.0,0,0,0
11481,11481,'link-to-pages',0.0,0,0,0
11482,11482,'link-to-rewritten-path',0.0,0,0,0
11483,11483,"'link[rel=""apple-touch-icon""]'",0.0,0,0,0
11484,11484,"'link[rel=""canonical""]'",0.0,0,0,0
11485,11485,"'link[rel=""favicon""]'",0.0,0,0,0
11486,11486,"'link[rel=""icon""][type=""image/svg+xml""]'",0.0,0,0,0
11487,11487,"'link[rel=""manifest""]'",0.0,0,0,0
11488,11488,'link[rel=amphtml]',0.0,0,0,0
11489,11489,'link[rel=prefetch]',0.0,0,0,0
11490,11490,'link[rel=preload]',0.0,0,0,0
11491,11491,'listeners should immediately get the initial state',0.0,0,0,0
11492,11492,'listeners should subscribe to state changes',0.0,0,0,0
11493,11493,'lists the necessary wasm bindings in the manifest',0.0,0,0,0
11494,11494,'load',0.0,0,0,0
11495,11495,'loads item from localForage',0.0,0,0,0
11496,11496,'loads mono repo plugins',0.0,0,0,0
11497,11497,'localhost:3000',0.0,0,0,0
11498,11498,"'location.href = ""/""'",0.0,0,0,0
11499,11499,'lodash',0.0,0,0,0
11500,11500,'log',0.0,0,0,0
11501,11501,'loggedIn',0.0,0,0,0
11502,11502,'loggedIn=false',0.0,0,0,0
11503,11503,'loggedIn=true',0.0,0,0,0
11504,11504,'login',0.0,0,0,0
11505,11505,'lower',0.0,0,0,0
11506,11506,'ltl',0.0,0,0,0
11507,11507,'machine',0.0,0,0,0
11508,11508,'machine-invoke',0.0,0,0,0
11509,11509,'machine-state',0.0,0,0,0
11510,11510,'mailto:foo@example.com',0.0,0,0,0
11511,11511,'mailto:me@example.com',0.0,0,0,0
11512,11512,'makeABarrelRoll',0.0,0,0,0
11513,11513,'margin-right',0.0,0,0,0
11514,11514,'markdown',0.0,0,0,0
11515,11515,'matching should be relative to grandparent (match)',0.0,0,0,0
11516,11516,'matching should be relative to grandparent (no match)',0.0,0,0,0
11517,11517,'max-age=9999',0.0,0,0,0
11518,11518,'max-age=foo',0.0,0,0,0
11519,11519,'max-width',0.0,0,0,0
11520,11520,'maxTouchPoints',0.0,0,0,0
11521,11521,'maybe',0.0,0,0,0
11522,11522,"'media=""only screen and (max-width: 600px)""'",0.0,0,0,0
11523,11523,'message',0.0,0,0,0
11524,11524,'message-contents',0.0,0,0,0
11525,11525,'meta data should be available in the invoke source function',0.0,0,0,0
11526,11526,"'meta[charset=""utf-8""]'",0.0,0,0,0
11527,11527,"'meta[name=""robots""]'",0.0,0,0,0
11528,11528,"'meta[name=""twitter:description""]'",0.0,0,0,0
11529,11529,"'meta[name=""twitter:image""]'",0.0,0,0,0
11530,11530,"'meta[name=""twitter:image:alt""]'",0.0,0,0,0
11531,11531,"'meta[name=""twitter:title""]'",0.0,0,0,0
11532,11532,"'meta[property=""og:image:alt""]'",0.0,0,0,0
11533,11533,"'meta[property=""og:url""]'",0.0,0,0,0
11534,11534,"'metadata.metadataBase is not set for resolving social open graph or twitter images, using'",0.0,0,0,0
11535,11535,'method',0.0,0,0,0
11536,11536,'middleware overriding headers',0.0,0,0,0
11537,11537,'middleware',0.0,0,0,0
11538,11538,'middleware-build-manifest.js',0.0,0,0,0
11539,11539,'middleware-manifest.json',0.0,0,0,0
11540,11540,'missing-predicate',0.0,0,0,0
11541,11541,'mockFixturePath',0.0,0,0,0
11542,11542,'modal',0.0,0,0,0
11543,11543,'mode',0.0,0,0,0
11544,11544,'model.assign updates context and is typed correctly',0.0,0,0,0
11545,11545,'model.createMachine(...) should provide the initial context',0.0,0,0,0
11546,11546,'model.reset resets the context to its initial value',0.0,0,0,0
11547,11547,'module type:esm-export',0.0,0,0,0
11548,11548,"'modules:[""/path/to/page""'",0.0,0,0,0
11549,11549,'mousedown',0.0,0,0,0
11550,11550,'multi',0.0,0,0,0
11551,11551,'my-email',0.0,0,0,0
11552,11552,'my-font.woff2',0.0,0,0,0
11553,11553,'my-link',0.0,0,0,0
11554,11554,'my-not-found',0.0,0,0,0
11555,11555,'my-query',0.0,0,0,0
11556,11556,'myAction',0.0,0,0,0
11557,11557,'myActivity',0.0,0,0,0
11558,11558,'myCookie',0.0,0,0,0
11559,11559,'myCookie=cookieValue',0.0,0,0,0
11560,11560,'myDelay',0.0,0,0,0
11561,11561,'myInvoke',0.0,0,0,0
11562,11562,'myactor',0.0,0,0,0
11563,11563,'mywebpack.config.js',0.0,0,0,0
11564,11564,"'name=""theme-color""'",0.0,0,0,0
11565,11565,'nana nana nananana',0.0,0,0,0
11566,11566,'navigate-',0.0,0,0,0
11567,11567,'navigate-https://example.vercel.sh/',0.0,0,0,0
11568,11568,'navigate-https://example.vercel.sh/stuff?abc=123',0.0,0,0,0
11569,11569,'nested',0.0,0,0,0
11570,11570,'nested-sections',0.0,0,0,0
11571,11571,'nestedFinal',0.0,0,0,0
11572,11572,'never',0.0,0,0,0
11573,11573,'new entry',0.0,0,0,0
11574,11574,'new value',0.0,0,0,0
11575,11575,'new-author',0.0,0,0,0
11576,11576,'newAction',0.0,0,0,0
11577,11577,'next build failed',0.0,0,0,0
11578,11578,'next start',0.0,0,0,0
11579,11579,'next-dynamic dynamic no ssr on client',0.0,0,0,0
11580,11580,'next-dynamic dynamic no ssr on client:suffix',0.0,0,0,0
11581,11581,'next-dynamic dynamic no ssr on server',0.0,0,0,0
11582,11582,'next-dynamic dynamic on client',0.0,0,0,0
11583,11583,'next-dynamic dynamic on server',0.0,0,0,0
11584,11584,'next-dynamic lazy',0.0,0,0,0
11585,11585,'next-dynamic server import client',0.0,0,0,0
11586,11586,'next-standalone-',0.0,0,0,0
11587,11587,'next.js',0.0,0,0,0
11588,11588,"'next.js,react,javascript'",0.0,0,0,0
11589,11589,"'next.router.isReady ? ""yes"" : ""no""'",0.0,0,0,0
11590,11590,"'next.router.isReady ? ""yes"" : ""nope""'",0.0,0,0,0
11591,11591,"'next.router.push(""/404"", ""/slug-2"")'",0.0,0,0,0
11592,11592,"'next.router.push(""/_error"", ""/slug-2"")'",0.0,0,0,0
11593,11593,'next.router.query',0.0,0,0,0
11594,11594,"'next.router.query.hello === ""world"" ? ""success"" : JSON.stringify(next.router.query)'",0.0,0,0,0
11595,11595,'next.router.query.rewriteSlug',0.0,0,0,0
11596,11596,'next.router.query.slug',0.0,0,0,0
11597,11597,'next/dist/lib/get-project-dir',0.0,0,0,0
11598,11598,'next/dist/server/web/spec-extension/response',0.0,0,0,0
11599,11599,'next/server',0.0,0,0,0
11600,11600,'nextUrl.pathname',0.0,0,0,0
11601,11601,'next_streaming_data',0.0,0,0,0
11602,11602,'next_streaming_fallback',0.0,0,0,0
11603,11603,'no cookie',0.0,0,0,0
11604,11604,'no-cache',0.0,0,0,0
11605,11605,'no-components',0.0,0,0,0
11606,11606,'no-events',0.0,0,0,0
11607,11607,'no-sections',0.0,0,0,0
11608,11608,'noExecute',0.0,0,0,0
11609,11609,'node',0.0,0,0,0
11610,11610,'node_modules instance from client module pure-esm-module',0.0,0,0,0
11611,11611,'node_modules/nanoid/index.js',0.0,0,0,0
11612,11612,'nodejs',0.0,0,0,0
11613,11613,'noindex',0.0,0,0,0
11614,11614,"'noindex, follow, nocache'",0.0,0,0,0
11615,11615,'non-conflict app',0.0,0,0,0
11616,11616,'non-conflict pages',0.0,0,0,0
11617,11617,'non-existent',0.0,0,0,0
11618,11618,'nonce',0.0,0,0,0
11619,11619,'noop-layout-page-1',0.0,0,0,0
11620,11620,'noop-layout-page-2',0.0,0,0,0
11621,11621,'noop-layout/page-1',0.0,0,0,0
11622,11622,'noop-layout/page-2',0.0,0,0,0
11623,11623,'normal state transitions should be changed (initial state)',0.0,0,0,0
11624,11624,'normal state transitions should be changed',0.0,0,0,0
11625,11625,'normal state transitions with unknown event should be unchanged',0.0,0,0,0
11626,11626,'normal-fetch',0.0,0,0,0
11627,11627,'noscript img',0.0,0,0,0
11628,11628,'not intercepted',0.0,0,0,0
11629,11629,'not-a-function',0.0,0,0,0
11630,11630,'not-a-page.js',0.0,0,0,0
11631,11631,'notifies renderer connection',0.0,0,0,0
11632,11632,'noto-sans-v27-latin-regular.ttf',0.0,0,0,0
11633,11633,'null',0.0,0,0,0
11634,11634,'num: PropTypes.instanceOf(Number)',0.0,0,0,0
11635,11635,'nxtPcomment',0.0,0,0,0
11636,11636,'nxtPid',0.0,0,0,0
11637,11637,'nxtPlang',0.0,0,0,0
11638,11638,'nxtPuser',0.0,0,0,0
11639,11639,'objectActionType',0.0,0,0,0
11640,11640,'objectActionTypeWithExec',0.0,0,0,0
11641,11641,'obs',0.0,0,0,0
11642,11642,'observer should be called with initial state',0.0,0,0,0
11643,11643,'observer should be called with next state',0.0,0,0,0
11644,11644,'offsetHeight',0.0,0,0,0
11645,11645,'og:description',0.0,0,0,0
11646,11646,'og:image',0.0,0,0,0
11647,11647,'og:image:alt',0.0,0,0,0
11648,11648,'og:image:height',0.0,0,0,0
11649,11649,'og:image:type',0.0,0,0,0
11650,11650,'og:image:width',0.0,0,0,0
11651,11651,'og:locale',0.0,0,0,0
11652,11652,'og:site_name',0.0,0,0,0
11653,11653,'og:title',0.0,0,0,0
11654,11654,'og:type',0.0,0,0,0
11655,11655,'og:url',0.0,0,0,0
11656,11656,'ok',0.0,0,0,0
11657,11657,"'on window load, should make visible an offcanvas element, if its markup contains class ""show""'",0.0,0,0,0
11658,11658,'one-link',0.0,0,0,0
11659,11659,'only collapses index fixture without sibling',0.0,0,0,0
11660,11660,'only reassigns when selected values change',0.0,0,0,0
11661,11661,'only rerenders for selected values',0.0,0,0,0
11662,11662,'only take the transition of the most inner matching event',0.0,0,0,0
11663,11663,'ontouchstart',0.0,0,0,0
11664,11664,'oof',0.0,0,0,0
11665,11665,'optimization',0.0,0,0,0
11666,11666,'option is unnecessary in Node.js',0.0,0,0,0
11667,11667,'option',0.0,0,0,0
11668,11668,'options bar',0.0,0,0,0
11669,11669,'options.testState(...) should test state',0.0,0,0,0
11670,11670,'origin-when-cross-origin',0.0,0,0,0
11671,11671,'other value',0.0,0,0,0
11672,11672,'other',0.0,0,0,0
11673,11673,'other-touch-icon',0.0,0,0,0
11674,11674,'output',0.0,0,0,0
11675,11675,'output.css',0.0,0,0,0
11676,11676,'output: standalone with app dir',0.0,0,0,0
11677,11677,'outputs a prerender-manifest correctly',0.0,0,0,0
11678,11678,'outputs dataRoutes in routes-manifest correctly',0.0,0,0,0
11679,11679,'outputs prerendered files correctly',0.0,0,0,0
11680,11680,'outside',0.0,0,0,0
11681,11681,'outside-focusable',0.0,0,0,0
11682,11682,'p.a',0.0,0,0,0
11683,11683,'p.a.a1',0.0,0,0,0
11684,11684,'p.a.a2',0.0,0,0,0
11685,11685,'p.a.a3',0.0,0,0,0
11686,11686,'p.b',0.0,0,0,0
11687,11687,'p.b.b1',0.0,0,0,0
11688,11688,'p.b.b2',0.0,0,0,0
11689,11689,'p.b.b3',0.0,0,0,0
11690,11690,'p1',0.0,0,0,0
11691,11691,'p:nth-child(2)',0.0,0,0,0
11692,11692,'padding-right',0.0,0,0,0
11693,11693,'page could not be found',0.0,0,0,0
11694,11694,'page using fallback fonts',0.0,0,0,0
11695,11695,'page using variables',0.0,0,0,0
11696,11696,'page with font',0.0,0,0,0
11697,11697,'page with fonts',0.0,0,0,0
11698,11698,'page with local fonts',0.0,0,0,0
11699,11699,'page without fonts',0.0,0,0,0
11700,11700,'page',0.0,0,0,0
11701,11701,'page-runtime/edge.js',0.0,0,0,0
11702,11702,'page-runtime/nodejs-ssr.js',0.0,0,0,0
11703,11703,'page-runtime/nodejs.js',0.0,0,0,0
11704,11704,'page-runtime/ssr-variable-gssp.js',0.0,0,0,0
11705,11705,'page-runtime/static.js',0.0,0,0,0
11706,11706,'page-text',0.0,0,0,0
11707,11707,'page.js',0.0,0,0,0
11708,11708,'pages import the correct module',0.0,0,0,0
11709,11709,'pages-icon-page',0.0,0,0,0
11710,11710,'pages-link',0.0,0,0,0
11711,11711,'pages-opengraph-image-page',0.0,0,0,0
11712,11712,'pages-page',0.0,0,0,0
11713,11713,'pages/_app.js',0.0,0,0,0
11714,11714,'pages/another.js',0.0,0,0,0
11715,11715,'pages/another2.js',0.0,0,0,0
11716,11716,'pages/api endpoints import the correct module',0.0,0,0,0
11717,11717,'pages/api/edge',0.0,0,0,0
11718,11718,'pages/api/hello',0.0,0,0,0
11719,11719,'pages/index2.js',0.0,0,0,0
11720,11720,'pages/no-preload.js',0.0,0,0,0
11721,11721,'pages/temp/[slug].js',0.0,0,0,0
11722,11722,'pages/temp2/[slug].js',0.0,0,0,0
11723,11723,'pages/url-prop.js',0.0,0,0,0
11724,11724,'pages/without-fonts.js',0.0,0,0,0
11725,11725,'parallel for foo',0.0,0,0,0
11726,11726,'parallel subroute layout',0.0,0,0,0
11727,11727,'parallel-nested/home/nested',0.0,0,0,0
11728,11728,'parallel-one',0.0,0,0,0
11729,11729,'parallel-two',0.0,0,0,0
11730,11730,'parallel/(new)/@baz/nested/page',0.0,0,0,0
11731,11731,'parallel/(new)/layout',0.0,0,0,0
11732,11732,'parallel/@bar/nested/@a/page',0.0,0,0,0
11733,11733,'parallel/@bar/nested/@b/page',0.0,0,0,0
11734,11734,'parallel/@bar/nested/layout',0.0,0,0,0
11735,11735,'parallel/@foo/nested/@a/page',0.0,0,0,0
11736,11736,'parallel/@foo/nested/@b/page',0.0,0,0,0
11737,11737,'parallel/@foo/nested/layout',0.0,0,0,0
11738,11738,'parallel/layout',0.0,0,0,0
11739,11739,'parallel/nested/page',0.0,0,0,0
11740,11740,'parallelSteps',0.0,0,0,0
11741,11741,'params - slug',0.0,0,0,0
11742,11742,'params',0.0,0,0,0
11743,11743,'parent should be able to read the updated state of a child when receiving an event from it',0.0,0,0,0
11744,11744,'parent state should be changed if synced child actor update occurs',0.0,0,0,0
11745,11745,'parent state should enter child state without re-entering self (relative target)',0.0,0,0,0
11746,11746,'parent state should enter child state without re-entering self',0.0,0,0,0
11747,11747,'parent state should only exit/reenter if there is an explicit self-transition (to child)',0.0,0,0,0
11748,11748,'parent state should only exit/reenter if there is an explicit self-transition',0.0,0,0,0
11749,11749,'parent state should re-enter self upon transitioning to child state if internal is false',0.0,0,0,0
11750,11750,'parent',0.0,0,0,0
11751,11751,"'parent,child'",0.0,0,0,0
11752,11752,'parentKeyHandler',0.0,0,0,0
11753,11753,'parse an user agent',0.0,0,0,0
11754,11754,'parse empty user agent',0.0,0,0,0
11755,11755,'parse user agent from a NextRequest instance',0.0,0,0,0
11756,11756,'parseFromString',0.0,0,0,0
11757,11757,'parses and formats the basePath',0.0,0,0,0
11758,11758,'parses and formats the default locale with forceLocale',0.0,0,0,0
11759,11759,'parses and formats the default locale',0.0,0,0,0
11760,11760,'parses the header',0.0,0,0,0
11761,11761,'partial-gen-params-no-additional-$1/$2/RAND',0.0,0,0,0
11762,11762,'partial-gen-params-no-additional-lang/[lang]/[slug]/page.js',0.0,0,0,0
11763,11763,'partial-gen-params-no-additional-lang/en/RAND.html',0.0,0,0,0
11764,11764,'partial-gen-params-no-additional-lang/en/RAND.rsc',0.0,0,0,0
11765,11765,'partial-gen-params-no-additional-lang/en/first.html',0.0,0,0,0
11766,11766,'partial-gen-params-no-additional-lang/en/first.rsc',0.0,0,0,0
11767,11767,'partial-gen-params-no-additional-lang/en/second.html',0.0,0,0,0
11768,11768,'partial-gen-params-no-additional-lang/en/second.rsc',0.0,0,0,0
11769,11769,'partial-gen-params-no-additional-lang/fr/RAND.html',0.0,0,0,0
11770,11770,'partial-gen-params-no-additional-lang/fr/RAND.rsc',0.0,0,0,0
11771,11771,'partial-gen-params-no-additional-lang/fr/first.html',0.0,0,0,0
11772,11772,'partial-gen-params-no-additional-lang/fr/first.rsc',0.0,0,0,0
11773,11773,'partial-gen-params-no-additional-lang/fr/second.html',0.0,0,0,0
11774,11774,'partial-gen-params-no-additional-lang/fr/second.rsc',0.0,0,0,0
11775,11775,'partial-gen-params-no-additional-slug/[lang]/[slug]/page.js',0.0,0,0,0
11776,11776,'partial-gen-params-no-additional-slug/en/RAND.html',0.0,0,0,0
11777,11777,'partial-gen-params-no-additional-slug/en/RAND.rsc',0.0,0,0,0
11778,11778,'partial-gen-params-no-additional-slug/en/first.html',0.0,0,0,0
11779,11779,'partial-gen-params-no-additional-slug/en/first.rsc',0.0,0,0,0
11780,11780,'partial-gen-params-no-additional-slug/en/second.html',0.0,0,0,0
11781,11781,'partial-gen-params-no-additional-slug/en/second.rsc',0.0,0,0,0
11782,11782,'partial-gen-params-no-additional-slug/fr/RAND.html',0.0,0,0,0
11783,11783,'partial-gen-params-no-additional-slug/fr/RAND.rsc',0.0,0,0,0
11784,11784,'partial-gen-params-no-additional-slug/fr/first.html',0.0,0,0,0
11785,11785,'partial-gen-params-no-additional-slug/fr/first.rsc',0.0,0,0,0
11786,11786,'partial-gen-params-no-additional-slug/fr/second.html',0.0,0,0,0
11787,11787,'partial-gen-params-no-additional-slug/fr/second.rsc',0.0,0,0,0
11788,11788,'partial-gen-params/[lang]/[slug]/page.js',0.0,0,0,0
11789,11789,"'partytown = {lib: ""/_next/static/~partytown/"",debug: true};'",0.0,0,0,0
11790,11790,"'partytown = {lib: ""/_next/static/~partytown/""};'",0.0,0,0,0
11791,11791,'passes search params with rewrites',0.0,0,0,0
11792,11792,'passes the method on a direct fetch request',0.0,0,0,0
11793,11793,'passes the method when providing a Request object',0.0,0,0,0
11794,11794,'passwordField',0.0,0,0,0
11795,11795,'path from events',0.0,0,0,0
11796,11796,'path generation should cover all transitions by default',0.0,0,0,0
11797,11797,'path/to/styles.css',0.0,0,0,0
11798,11798,'pause',0.0,0,0,0
11799,11799,'payload',0.0,0,0,0
11800,11800,'persisted data',0.0,0,0,0
11801,11801,'phase-development-server',0.0,0,0,0
11802,11802,'phase-export',0.0,0,0,0
11803,11803,'phase-production-build',0.0,0,0,0
11804,11804,'phase-production-server',0.0,0,0,0
11805,11805,'ping',0.0,0,0,0
11806,11806,'ping-pong',0.0,0,0,0
11807,11807,'ping.foo',0.0,0,0,0
11808,11808,'pingRenderers',0.0,0,0,0
11809,11809,'pipeline',0.0,0,0,0
11810,11810,'pizza-cra',0.0,0,0,0
11811,11811,'pizza.js',0.0,0,0,0
11812,11812,'placement',0.0,0,0,0
11813,11813,'player',0.0,0,0,0
11814,11814,'pointer',0.0,0,0,0
11815,11815,'pointerdown',0.0,0,0,0
11816,11816,'pointerup',0.0,0,0,0
11817,11817,'popover',0.0,0,0,0
11818,11818,'post',0.0,0,0,0
11819,11819,'post-10',0.0,0,0,0
11820,11820,'postfixed',0.0,0,0,0
11821,11821,"'posts ""pingRenderers"" renderer request on load'",0.0,0,0,0
11822,11822,"'posts ""selectFixture"" renderer request with fixture state'",0.0,0,0,0
11823,11823,"'posts ""selectFixture"" renderer request'",0.0,0,0,0
11824,11824,"'posts ""selectFixture"" renderer requests'",0.0,0,0,0
11825,11825,"'posts ""setFixtureState"" renderer requests'",0.0,0,0,0
11826,11826,"'posts ""setFixtureState"" request to secondary renderer'",0.0,0,0,0
11827,11827,"'posts ""unselectFixture"" renderer requests'",0.0,0,0,0
11828,11828,'pre#result',0.0,0,0,0
11829,11829,'pre',0.0,0,0,0
11830,11830,'preconnect',0.0,0,0,0
11831,11831,'preload correct files at /inter',0.0,0,0,0
11832,11832,'preload correct files at /local-font',0.0,0,0,0
11833,11833,'preload correct files at /roboto',0.0,0,0,0
11834,11834,'preload correct files',0.0,0,0,0
11835,11835,'prepareGreenLight',0.0,0,0,0
11836,11836,'preserve-my-class',0.0,0,0,0
11837,11837,'preserve-my-id',0.0,0,0,0
11838,11838,'preserves React aliases using array form',0.0,0,0,0
11839,11839,'preserves React aliases with exact matches',0.0,0,0,0
11840,11840,'preserves React aliases',0.0,0,0,0
11841,11841,'preserves the fragment',0.0,0,0,0
11842,11842,'preserves the trailingSlash',0.0,0,0,0
11843,11843,'preset-react',0.0,0,0,0
11844,11844,'preventDefault',0.0,0,0,0
11845,11845,'prevents infinite recursion based on a provided limit',0.0,0,0,0
11846,11846,"'prints warning when there are no ""pages"" or ""app"" directories'",0.0,0,0,0
11847,11847,'process.env.PIZZA',0.0,0,0,0
11848,11848,'processComponent() should return an object for section with content',0.0,0,0,0
11849,11849,'processSection() should return an object for section with components',0.0,0,0,0
11850,11850,'processSection() should return an object for section with content',0.0,0,0,0
11851,11851,'processSection() should return an object for section without ignored components',0.0,0,0,0
11852,11852,'processSection() should throw when content file not found',0.0,0,0,0
11853,11853,'promise',0.0,0,0,0
11854,11854,'property',0.0,0,0,0
11855,11855,'provides params to routes with catch-all routes',0.0,0,0,0
11856,11856,'provides params to routes with dynamic parameters',0.0,0,0,0
11857,11857,'proxying',0.0,0,0,0
11858,11858,"'public, max-age=0, must-revalidate'",0.0,0,0,0
11859,11859,"'public, max-age=5555, s-maxage=9999'",0.0,0,0,0
11860,11860,"'public, s-maxage=""9999"", max-age=""5555""'",0.0,0,0,0
11861,11861,"'public,s-maxage=9999,max-age=5555'",0.0,0,0,0
11862,11862,'pure-esm-module',0.0,0,0,0
11863,11863,'p{color:#ff0}',0.0,0,0,0
11864,11864,'query:0',0.0,0,0,0
11865,11865,'query:1',0.0,0,0,0
11866,11866,'query:2',0.0,0,0,0
11867,11867,'question',0.0,0,0,0
11868,11868,'quux',0.0,0,0,0
11869,11869,'qwertyService',0.0,0,0,0
11870,11870,'random',0.0,0,0,0
11871,11871,'react-cosmos',0.0,0,0,0
11872,11872,'react-fetch-deduping-edge/page.js',0.0,0,0,0
11873,11873,'react-fetch-deduping-node/page.js',0.0,0,0,0
11874,11874,'reads a JSON body',0.0,0,0,0
11875,11875,'reads a multipart form data',0.0,0,0,0
11876,11876,'reads a text body',0.0,0,0,0
11877,11877,'reads an URL encoded form data',0.0,0,0,0
11878,11878,'reads the body as text',0.0,0,0,0
11879,11879,'reads the body from index',0.0,0,0,0
11880,11880,'ready',0.0,0,0,0
11881,11881,'readyState',0.0,0,0,0
11882,11882,'rect',0.0,0,0,0
11883,11883,'red.stop',0.0,0,0,0
11884,11884,'red.wait',0.0,0,0,0
11885,11885,'redirect-dest',0.0,0,0,0
11886,11886,'redirected',0.0,0,0,0
11887,11887,'referencedAction',0.0,0,0,0
11888,11888,'referrer',0.0,0,0,0
11889,11889,'reflect .delete into `set-cookie`',0.0,0,0,0
11890,11890,'reflect .set into `set-cookie`',0.0,0,0,0
11891,11891,'refreshes the page when middleware changes ',0.0,0,0,0
11892,11892,'regions should be able to transition to orthogonal regions',0.0,0,0,0
11893,11893,'regions',0.0,0,0,0
11894,11894,'rel',0.0,0,0,0
11895,11895,'relatedTarget',0.0,0,0,0
11896,11896,'relay',0.0,0,0,0
11897,11897,'remote-full',0.0,0,0,0
11898,11898,'remote-with-base',0.0,0,0,0
11899,11899,'removeEventListener',0.0,0,0,0
11900,11900,'removes --inspect option at end of line',0.0,0,0,0
11901,11901,'removes --inspect option with parameters',0.0,0,0,0
11902,11902,'removes --inspect option',0.0,0,0,0
11903,11903,'removes --inspect-brk option with parameters',0.0,0,0,0
11904,11904,'removes --inspect-brk option',0.0,0,0,0
11905,11905,'removes ModuleScopePlugin resolve plugin',0.0,0,0,0
11906,11906,'render should not render title if name is not set',0.0,0,0,0
11907,11907,'render should render component',0.0,0,0,0
11908,11908,'render should render section',0.0,0,0,0
11909,11909,'render should render styled component',0.0,0,0,0
11910,11910,'render should render title if name is set',0.0,0,0,0
11911,11911,'renderer should a path line',0.0,0,0,0
11912,11912,'renderer should have sidebar if pagePerSection is true',0.0,0,0,0
11913,11913,'renderer should have sidebar if showSidebar is not set',0.0,0,0,0
11914,11914,'renderer should not have sidebar if showSidebar is false',0.0,0,0,0
11915,11915,'renderer should not have sidebar in isolation mode',0.0,0,0,0
11916,11916,'renderer should render argument name',0.0,0,0,0
11917,11917,'renderer should render arguments',0.0,0,0,0
11918,11918,'renderer should render components list layout',0.0,0,0,0
11919,11919,'renderer should render deprecated argument name',0.0,0,0,0
11920,11920,'renderer should render error message',0.0,0,0,0
11921,11921,'renderer should render header',0.0,0,0,0
11922,11922,'renderer should render heading',0.0,0,0,0
11923,11923,'renderer should render link',0.0,0,0,0
11924,11924,"'renderer should render logo, table of contents, ribbon and passed children'",0.0,0,0,0
11925,11925,'renderer should render message for array',0.0,0,0,0
11926,11926,'renderer should render message',0.0,0,0,0
11927,11927,'renderer should render nothing for empty array',0.0,0,0,0
11928,11928,'renderer should render preview',0.0,0,0,0
11929,11929,'renderer should render table of contents',0.0,0,0,0
11930,11930,'renderer should render type',0.0,0,0,0
11931,11931,'renderer should render welcome screen',0.0,0,0,0
11932,11932,'renderer-connect-mockRendererId1',0.0,0,0,0
11933,11933,'renderer.html',0.0,0,0,0
11934,11934,'renderer.html?fixtureId=%7B%22path%22%3A%22%2Fpath%2Fto%2Ffixture.js%22%2C%22name%22%3A%22first%22%7D&locked=true',0.0,0,0,0
11935,11935,'renderer.html?fixtureId=%7B%22path%22%3A%22%2Fpath%2Fto%2Ffixture.js%22%2C%22name%22%3A%22first%22%7D',0.0,0,0,0
11936,11936,'rendererReady',0.0,0,0,0
11937,11937,'rendererResponse',0.0,0,0,0
11938,11938,'rendering index',0.0,0,0,0
11939,11939,'renders component preview',0.0,0,0,0
11940,11940,'renders fixture elements',0.0,0,0,0
11941,11941,'renders the static page',0.0,0,0,0
11942,11942,'renders without crashing',0.0,0,0,0
11943,11943,'report',0.0,0,0,0
11944,11944,'req-url-path',0.0,0,0,0
11945,11945,"'require(""./car"")'",0.0,0,0,0
11946,11946,'require() statements can be added',0.0,0,0,0
11947,11947,'requireIt() should return an AST for require statement',0.0,0,0,0
11948,11948,'resets fixture state on select',0.0,0,0,0
11949,11949,'resets fixture state',0.0,0,0,0
11950,11950,'resets fixtures state when primary renderer re-connects',0.0,0,0,0
11951,11951,'resize',0.0,0,0,0
11952,11952,'resolves --exportImports CLI arg path',0.0,0,0,0
11953,11953,'resource',0.0,0,0,0
11954,11954,'respects weights',0.0,0,0,0
11955,11955,'respond() should be able to respond to sender',0.0,0,0,0
11956,11956,'responds with 400 (Bad Request) when the requested method is not a valid HTTP method',0.0,0,0,0
11957,11957,'responds with 405 (Method Not Allowed) when method is not implemented',0.0,0,0,0
11958,11958,'responds with 500 (Internal Server Error) when the handler calls NextResponse.next()',0.0,0,0,0
11959,11959,'responds with 500 (Internal Server Error) when the handler throws an error',0.0,0,0,0
11960,11960,'response-url/page.js',0.0,0,0,0
11961,11961,'response.cookie does not modify options',0.0,0,0,0
11962,11962,'return language with heighest weight',0.0,0,0,0
11963,11963,'return value + 1',0.0,0,0,0
11964,11964,'return value + 1000',0.0,0,0,0
11965,11965,'returns a response when headers are accessed',0.0,0,0,0
11966,11966,'returns absolute globalImports',0.0,0,0,0
11967,11967,'returns an empty string with header is empty',0.0,0,0,0
11968,11968,'returns connected renderer IDs',0.0,0,0,0
11969,11969,'returns cosmos config at --config path',0.0,0,0,0
11970,11970,'returns cosmos config at --root-dir path',0.0,0,0,0
11971,11971,'returns cosmos config at cwd',0.0,0,0,0
11972,11972,'returns custom export path',0.0,0,0,0
11973,11973,'returns custom fixtureFileSuffix',0.0,0,0,0
11974,11974,'returns custom fixturesDir',0.0,0,0,0
11975,11975,'returns custom hostname',0.0,0,0,0
11976,11976,'returns custom port',0.0,0,0,0
11977,11977,'returns custom publicUrl',0.0,0,0,0
11978,11978,'returns custom static path from custom root dir',0.0,0,0,0
11979,11979,'returns custom static path',0.0,0,0,0
11980,11980,'returns default empty globalImports',0.0,0,0,0
11981,11981,'returns default export path from custom root dir',0.0,0,0,0
11982,11982,'returns default export path',0.0,0,0,0
11983,11983,'returns default fixtureFileSuffix',0.0,0,0,0
11984,11984,'returns default fixturesDir',0.0,0,0,0
11985,11985,'returns default hostname',0.0,0,0,0
11986,11986,'returns default null static path',0.0,0,0,0
11987,11987,'returns default port',0.0,0,0,0
11988,11988,'returns default publicUrl',0.0,0,0,0
11989,11989,'returns empty fixture state',0.0,0,0,0
11990,11990,'returns empty string if header is missing',0.0,0,0,0
11991,11991,'returns empty string if none of the preferences match',0.0,0,0,0
11992,11992,'returns events when transitioned from StateValue',0.0,0,0,0
11993,11993,'returns false',0.0,0,0,0
11994,11994,'returns first found preference that header includes',0.0,0,0,0
11995,11995,'returns first preference if header has * and is unmatched',0.0,0,0,0
11996,11996,'returns fixture info',0.0,0,0,0
11997,11997,'returns fixture state',0.0,0,0,0
11998,11998,'returns fixtureId',0.0,0,0,0
11999,11999,'returns fixtures',0.0,0,0,0
12000,12000,'returns language using range match',0.0,0,0,0
12001,12001,'returns no next events if there are none',0.0,0,0,0
12002,12002,'returns null',0.0,0,0,0
12003,12003,'returns port from --port arg',0.0,0,0,0
12004,12004,'returns preference with highest order when equal weigths',0.0,0,0,0
12005,12005,'returns primary renderer ID',0.0,0,0,0
12006,12006,'returns resolved (explicit) relative globalImports',0.0,0,0,0
12007,12007,'returns resolved (implicit) relative globalImports',0.0,0,0,0
12008,12008,'returns resolved custom watchDirs',0.0,0,0,0
12009,12009,'returns resolved default watchDirs',0.0,0,0,0
12010,12010,'returns resolved module globalImports',0.0,0,0,0
12011,12011,'returns resolved user imports path',0.0,0,0,0
12012,12012,'returns response using edge runtime',0.0,0,0,0
12013,12013,'returns root dir from config',0.0,0,0,0
12014,12014,'returns root dir from cwd',0.0,0,0,0
12015,12015,'returns the next possible events for the current state',0.0,0,0,0
12016,12016,'returns the next state for the given event without changing the interpreter state',0.0,0,0,0
12017,12017,'returns true',0.0,0,0,0
12018,12018,'returns web renderer URL',0.0,0,0,0
12019,12019,'returns',0.0,0,0,0
12020,12020,'reveal',0.0,0,0,0
12021,12021,'revealAnswer',0.0,0,0,0
12022,12022,'rewrite',0.0,0,0,0
12023,12023,'rewrite/api/edge',0.0,0,0,0
12024,12024,"'rgb(0, 255, 255)'",0.0,0,0,0
12025,12025,"'rgb(139, 0, 0)'",0.0,0,0,0
12026,12026,"'rgb(165, 42, 42)'",0.0,0,0,0
12027,12027,"'rgb(205, 92, 92)'",0.0,0,0,0
12028,12028,"'rgb(210, 105, 30)'",0.0,0,0,0
12029,12029,"'rgb(222, 184, 135)'",0.0,0,0,0
12030,12030,"'rgb(233, 150, 122)'",0.0,0,0,0
12031,12031,"'rgb(245, 222, 179)'",0.0,0,0,0
12032,12032,"'rgb(25, 133, 123)'",0.0,0,0,0
12033,12033,"'rgb(255, 228, 181)'",0.0,0,0,0
12034,12034,"'rgb(255, 99, 71)'",0.0,0,0,0
12035,12035,"'rgb(34, 139, 34)'",0.0,0,0,0
12036,12036,"'rgb(37, 99, 235)'",0.0,0,0,0
12037,12037,"'rgb(75, 0, 130)'",0.0,0,0,0
12038,12038,"'rgb(78, 39, 231)'",0.0,0,0,0
12039,12039,'root page',0.0,0,0,0
12040,12040,'root sidebar here',0.0,0,0,0
12041,12041,'route-group',0.0,0,0,0
12042,12042,'route-handler-edge/revalidate-360/route.js',0.0,0,0,0
12043,12043,'route-handler/post/route.js',0.0,0,0,0
12044,12044,'route-handler/revalidate-360-isr/route.js',0.0,0,0,0
12045,12045,'route-handler/revalidate-360/route.js',0.0,0,0,0
12046,12046,'route-handler/static-cookies/route.js',0.0,0,0,0
12047,12047,'route-name',0.0,0,0,0
12048,12048,'routeChangeComplete',0.0,0,0,0
12049,12049,'routeChangeError',0.0,0,0,0
12050,12050,'router.query must exist when Link clicked page routing',0.0,0,0,0
12051,12051,'routes to the correct handler',0.0,0,0,0
12052,12052,'rsg-codemirror-theme.css',0.0,0,0,0
12053,12053,'rsg-components/StyleGuide/StyleGuideRenderer',0.0,0,0,0
12054,12054,'rsg-components/Wrapper',0.0,0,0,0
12055,12055,'running',0.0,0,0,0
12056,12056,'runs with no warning API route on the edge runtime',0.0,0,0,0
12057,12057,'runtimes.txt',0.0,0,0,0
12058,12058,'s',0.0,0,0,0
12059,12059,"'s-maxage=2, stale-while-revalidate'",0.0,0,0,0
12060,12060,"'s-maxage=31536000, stale-while-revalidate'",0.0,0,0,0
12061,12061,'s-maxage=9999',0.0,0,0,0
12062,12062,'s3.1',0.0,0,0,0
12063,12063,'s4',0.0,0,0,0
12064,12064,'s8',0.0,0,0,0
12065,12065,'safari',0.0,0,0,0
12066,12066,'salami',0.0,0,0,0
12067,12067,'save',0.0,0,0,0
12068,12068,'saved',0.0,0,0,0
12069,12069,'schema should be present in the machine definition',0.0,0,0,0
12070,12070,'script',0.0,0,0,0
12071,12071,'script:not([src])',0.0,0,0,0
12072,12072,'script[async]',0.0,0,0,0
12073,12073,'script[nonce]:not([src])',0.0,0,0,0
12074,12074,'script[src]',0.0,0,0,0
12075,12075,'search',0.0,0,0,0
12076,12076,'searching',0.0,0,0,0
12077,12077,'second-post',0.0,0,0,0
12078,12078,'second/post',0.0,0,0,0
12079,12079,'secret',0.0,0,0,0
12080,12080,'section',0.0,0,0,0
12081,12081,'selected tab should deactivate previous selected link in dropdown',0.0,0,0,0
12082,12082,'selecting a dropdown tab does not activate another',0.0,0,0,0
12083,12083,'self.__next_f=',0.0,0,0,0
12084,12084,'sendOther',0.0,0,0,0
12085,12085,'sendUpper',0.0,0,0,0
12086,12086,'sending',0.0,0,0,0
12087,12087,'sends fixture select request to renderer with different selected fixture',0.0,0,0,0
12088,12088,'sends renderer request to message handler',0.0,0,0,0
12089,12089,'sends renderer response to renderer core',0.0,0,0,0
12090,12090,'sent events from exit handlers of a done child should be received by its children ',0.0,0,0,0
12091,12091,'sent events from exit handlers of a done child should be received by the parent ',0.0,0,0,0
12092,12092,'sent events from exit handlers of a stopped child should be received by its children ',0.0,0,0,0
12093,12093,'sent events from exit handlers of a stopped child should not be received by the parent',0.0,0,0,0
12094,12094,'sequence',0.0,0,0,0
12095,12095,'server component client-navigation',0.0,0,0,0
12096,12096,'server component',0.0,0,0,0
12097,12097,'server response again',0.0,0,0,0
12098,12098,'server response',0.0,0,0,0
12099,12099,'server should return an object containing a server instance',0.0,0,0,0
12100,12100,'server.js',0.0,0,0,0
12101,12101,'server/edge-chunks/wasm_58ccff8b2b94b5dac6ef8957082ecd8f6d34186d.wasm',0.0,0,0,0
12102,12102,'server/edge-runtime-webpack',0.0,0,0,0
12103,12103,'server/middleware.js',0.0,0,0,0
12104,12104,'server/pages/api/edge.js',0.0,0,0,0
12105,12105,'server/pages/api/hello.js',0.0,0,0,0
12106,12106,'serves favicon',0.0,0,0,0
12107,12107,'serves playground HTML',0.0,0,0,0
12108,12108,'serves playground JS',0.0,0,0,0
12109,12109,'serves plugin JS files',0.0,0,0,0
12110,12110,'service.event',0.0,0,0,0
12111,12111,'service.register',0.0,0,0,0
12112,12112,'services started from a persisted state should calculate meta data',0.0,0,0,0
12113,12113,'session=true',0.0,0,0,0
12114,12114,'session=value',0.0,0,0,0
12115,12115,'set image route',0.0,0,0,0
12116,12116,'set-query',0.0,0,0,0
12117,12117,'setInterval',0.0,0,0,0
12118,12118,'sets URL params',0.0,0,0,0
12119,12119,'sets experiments.topLevelAwait to true',0.0,0,0,0
12120,12120,'sets fixture state in plugin state',0.0,0,0,0
12121,12121,'sets fixtureState in renderer state',0.0,0,0,0
12122,12122,'sets item to local cache',0.0,0,0,0
12123,12123,'sets item to localForage',0.0,0,0,0
12124,12124,'sets originalSource with multiple matchers',0.0,0,0,0
12125,12125,'sets originalSource with one matcher',0.0,0,0,0
12126,12126,'sets primary renderer ID in state',0.0,0,0,0
12127,12127,'sets selected fixture ID',0.0,0,0,0
12128,12128,'sets tags correctly after not selecting any transition',0.0,0,0,0
12129,12129,'sets undefined properties',0.0,0,0,0
12130,12130,'setup',0.0,0,0,0
12131,12131,'seven',0.0,0,0,0
12132,12132,'sha256',0.0,0,0,0
12133,12133,'sha256-',0.0,0,0,0
12134,12134,'shallow-link',0.0,0,0,0
12135,12135,'shortcut icon',0.0,0,0,0
12136,12136,'shortest paths for reducers',0.0,0,0,0
12137,12137,'shortest paths parallel',0.0,0,0,0
12138,12138,'shortest paths',0.0,0,0,0
12139,12139,'should 404 for a missing catchall explicit route',0.0,0,0,0
12140,12140,'should 404 for an invalid data url',0.0,0,0,0
12141,12141,'should 404 for public file without basePath',0.0,0,0,0
12142,12142,'should 404 when manually adding basePath with <Link>',0.0,0,0,0
12143,12143,'should 404 when manually adding basePath with router.push',0.0,0,0,0
12144,12144,'should 404 when manually adding basePath with router.replace',0.0,0,0,0
12145,12145,'should HMR correctly for client component',0.0,0,0,0
12146,12146,'should HMR correctly for server component',0.0,0,0,0
12147,12147,'should NOT show a popover without `title` and `content`',0.0,0,0,0
12148,12148,'should SSR blocking path correctly (blocking)',0.0,0,0,0
12149,12149,'should SSR blocking path correctly (pre-rendered)',0.0,0,0,0
12150,12150,'should SSR catch-all page with brackets in param as object',0.0,0,0,0
12151,12151,'should SSR catch-all page with brackets in param as string',0.0,0,0,0
12152,12152,'should SSR dynamic page with brackets in param as object',0.0,0,0,0
12153,12153,'should SSR dynamic page with brackets in param as string',0.0,0,0,0
12154,12154,'should SSR getServerSideProps page correctly',0.0,0,0,0
12155,12155,'should SSR incremental page correctly',0.0,0,0,0
12156,12156,'should SSR normal page correctly',0.0,0,0,0
12157,12157,'should absolutize assetsDir if it exists',0.0,0,0,0
12158,12158,'should absolutize defaultExample if it is a string',0.0,0,0,0
12159,12159,'should accept a delay option (expression)',0.0,0,0,0
12160,12160,'should accept a delay option',0.0,0,0,0
12161,12161,'should accept a machine as a service',0.0,0,0,0
12162,12162,'should accept a serializer',0.0,0,0,0
12163,12163,'should accept a string action',0.0,0,0,0
12164,12164,'should accept a string event',0.0,0,0,0
12165,12165,'should accept a valid event type returned from an expression',0.0,0,0,0
12166,12166,'should accept a valid event type',0.0,0,0,0
12167,12167,'should accept a valid simple event type',0.0,0,0,0
12168,12168,'should accept absolute path',0.0,0,0,0
12169,12169,'should accept an action object',0.0,0,0,0
12170,12170,'should accept an activity definition',0.0,0,0,0
12171,12171,'should accept an event object',0.0,0,0,0
12172,12172,'should accept an id option',0.0,0,0,0
12173,12173,'should accept assign with partial static object',0.0,0,0,0
12174,12174,'should accept config as an object',0.0,0,0,0
12175,12175,'should accept default loggers',0.0,0,0,0
12176,12176,"'should accept element, either passed as a CSS selector or DOM element'",0.0,0,0,0
12177,12177,"'should accept element, either passed as a CSS selector, jQuery element, or DOM element'",0.0,0,0,0
12178,12178,'should accept event expression',0.0,0,0,0
12179,12179,'should accept language as null',0.0,0,0,0
12180,12180,'should accept required as a function',0.0,0,0,0
12181,12181,"'should activate element by tab id (using buttons, the preferred semantic way)'",0.0,0,0,0
12182,12182,"'should activate element by tab id (using links for tabs - not ideal, but still supported)'",0.0,0,0,0
12183,12183,'should activate element by tab id in list group',0.0,0,0,0
12184,12184,'should activate element by tab id in nav list',0.0,0,0,0
12185,12185,'should activate element by tab id in ordered list',0.0,0,0,0
12186,12186,"'should activate even if there are subsequent automatic, but blocked transitions'",0.0,0,0,0
12187,12187,"'should add ""collapsed"" class and set aria-expanded to triggers only when all the targeted collapse are hidden'",0.0,0,0,0
12188,12188,"'should add ""collapsed"" class to target when collapse is hidden'",0.0,0,0,0
12189,12189,'should add `hiding` class during closing and remover `show` & `hiding` classes on end',0.0,0,0,0
12190,12190,'should add `show` class to tab panes if there is no `.fade` class',0.0,0,0,0
12191,12191,'should add `showing` class during opening and `show` class on end',0.0,0,0,0
12192,12192,'should add a rewrite header on data requests for rewrites',0.0,0,0,0
12193,12193,'should add all plugins in jQuery',0.0,0,0,0
12194,12194,'should add basePath correctly when no basePath',0.0,0,0,0
12195,12195,'should add basePath to routes-manifest',0.0,0,0,0
12196,12196,'should add common parent folder of all components to context dependencies',0.0,0,0,0
12197,12197,'should add context dependencies to webpack from contextDependencies config option',0.0,0,0,0
12198,12198,'should add event listener',0.0,0,0,0
12199,12199,'should add header with basePath by default',0.0,0,0,0
12200,12200,'should add header without basePath when set to false',0.0,0,0,0
12201,12201,'should add html sanitized',0.0,0,0,0
12202,12202,'should add html without sanitize it',0.0,0,0,0
12203,12203,'should add listener when escape touch is pressed',0.0,0,0,0
12204,12204,'should add namespaced event listener',0.0,0,0,0
12205,12205,'should add native namespaced event listener',0.0,0,0,0
12206,12206,'should add show class to tab panes if there is a `.fade` class',0.0,0,0,0
12207,12207,'should add text content',0.0,0,0,0
12208,12208,'should add the active class to the correct element',0.0,0,0,0
12209,12209,'should add the aria-label attribute for referencing original title',0.0,0,0,0
12210,12210,'should add the aria-label attribute when element text content is a whitespace string',0.0,0,0,0
12211,12211,'should add the child text content in the element',0.0,0,0,0
12212,12212,'should add the content as a child of the element for jQuery elements',0.0,0,0,0
12213,12213,"'should add to list-group, the active class to the correct element (list-group markup)'",0.0,0,0,0
12214,12214,'should add to nav the active class to the correct element (nav markup)',0.0,0,0,0
12215,12215,'should add touch event listeners by default',0.0,0,0,0
12216,12216,'should add webpack alias for each styleguideComponents config option item',0.0,0,0,0
12217,12217,'should add webpack entry for each require config option item',0.0,0,0,0
12218,12218,"'should add when missing (after, array)'",0.0,0,0,0
12219,12219,"'should add when missing (before, array)'",0.0,0,0,0
12220,12220,"'should add when missing (multi, array)'",0.0,0,0,0
12221,12221,"'should add when missing (single, array)'",0.0,0,0,0
12222,12222,"'should add when missing (single, non-array)'",0.0,0,0,0
12223,12223,'should adjust dialog on resize',0.0,0,0,0
12224,12224,'should adjust the inline margin and padding of sticky elements',0.0,0,0,0
12225,12225,'should adjust the inline padding of fixed elements which are full-width',0.0,0,0,0
12226,12226,'should allow POST request for getServerSideProps page',0.0,0,0,0
12227,12227,"'should allow `data-bs-toggle=""dropdown""` click events to bubble up'",0.0,0,0,0
12228,12228,'should allow a machine service returning the explicitly declared data in the given schema.services',0.0,0,0,0
12229,12229,'should allow a matching transition',0.0,0,0,0
12230,12230,'should allow a promise service returning the explicitly declared data in the given schema.services',0.0,0,0,0
12231,12231,'should allow a valid tag with `hasTag`',0.0,0,0,0
12232,12232,'should allow a version to be specified',0.0,0,0,0
12233,12233,'should allow access to the router',0.0,0,0,0
12234,12234,'should allow accordion to contain nested elements',0.0,0,0,0
12235,12235,'should allow accordion to target multiple elements',0.0,0,0,0
12236,12236,'should allow accordion to use children other than card',0.0,0,0,0
12237,12237,'should allow any action if actions are not specified',0.0,0,0,0
12238,12238,'should allow aria attributes and safe attributes',0.0,0,0,0
12239,12239,'should allow bidirectional communication between parent/child actors',0.0,0,0,0
12240,12240,'should allow configuring className',0.0,0,0,0
12241,12241,'should allow cookie and header async storages',0.0,0,0,0
12242,12242,'should allow dynamic routes to access cookies',0.0,0,0,0
12243,12243,'should allow for a fallback target to be a simple string',0.0,0,0,0
12244,12244,'should allow for a purely defined dynamic action',0.0,0,0,0
12245,12245,'should allow for dynamic generation of cases based on state',0.0,0,0,0
12246,12246,'should allow for fallback unguarded actions',0.0,0,0,0
12247,12247,'should allow for lazy context to be used with `withConfig`',0.0,0,0,0
12248,12248,'should allow for nested conditional actions',0.0,0,0,0
12249,12249,'should allow for purely defined action type strings',0.0,0,0,0
12250,12250,'should allow for purely defined dynamic actions',0.0,0,0,0
12251,12251,'should allow for purely defined lack of actions',0.0,0,0,0
12252,12252,'should allow for representing many cases',0.0,0,0,0
12253,12253,'should allow for the action type to be explicitly given when creators have not been configured',0.0,0,0,0
12254,12254,'should allow forcing on automatic mode',0.0,0,0,0
12255,12255,'should allow forcing on classic mode',0.0,0,0,0
12256,12256,'should allow jquery object in parent config',0.0,0,0,0
12257,12257,'should allow linking from app page to pages page',0.0,0,0,0
12258,12258,'should allow matches to be called multiple times in a single branch of code',0.0,0,0,0
12259,12259,'should allow multiple sanitation passes of the same template',0.0,0,0,0
12260,12260,'should allow navigating to a non-existent page',0.0,0,0,0
12261,12261,'should allow navigating to a page calling notfound',0.0,0,0,0
12262,12262,'should allow navigation back to route that was initially not-found',0.0,0,0,0
12263,12263,'should allow navigation between dynamic parameter and static parameter of the same value',0.0,0,0,0
12264,12264,'should allow navigation on error',0.0,0,0,0
12265,12265,'should allow navigation on not-found',0.0,0,0,0
12266,12266,'should allow navigation to other routes on route that was initially not-found',0.0,0,0,0
12267,12267,'should allow next/prev events to be undefined',0.0,0,0,0
12268,12268,'should allow no webpack config',0.0,0,0,0
12269,12269,'should allow non jquery object in parent config',0.0,0,0,0
12270,12270,'should allow overriding components',0.0,0,0,0
12271,12271,'should allow resetting error boundary',0.0,0,0,0
12272,12272,'should allow response body from middleware with flag',0.0,0,0,0
12273,12273,'should allow rewriting invalid buildId correctly',0.0,0,0,0
12274,12274,'should allow rewriting to SSG page with fallback: false',0.0,0,0,0
12275,12275,'should allow string selector in parent config',0.0,0,0,0
12276,12276,"'should allow swipeLeft and call ""leftCallback"" with pointer events'",0.0,0,0,0
12277,12277,"'should allow swipeRight and call ""rightCallback"" with pointer events'",0.0,0,0,0
12278,12278,'should allow swipeleft and call _slide (next) with touch events',0.0,0,0,0
12279,12279,'should allow swipeleft and call next with pointer events',0.0,0,0,0
12280,12280,'should allow swiperight and call _slide (prev) with pointer events',0.0,0,0,0
12281,12281,'should allow swiperight and call _slide (prev) with touch events',0.0,0,0,0
12282,12282,'should allow the 2nd parameter to be undefined',0.0,0,0,0
12283,12283,'should allow to config in js',0.0,0,0,0
12284,12284,'should allow to create a service out of a machine with implementations provided through `withConfig`',0.0,0,0,0
12285,12285,'should allow to create a service out of a machine without any missing implementations',0.0,0,0,0
12286,12286,'should allow to destroy toast and hide it before that',0.0,0,0,0
12287,12287,'should allow to destroy toast',0.0,0,0,0
12288,12288,'should allow to have a valid /not-found route',0.0,0,0,0
12289,12289,'should allow to hide toast manually',0.0,0,0,0
12290,12290,'should allow to opt-out prefetch caching',0.0,0,0,0
12291,12291,'should allow to override already provided implementation using `withConfig`',0.0,0,0,0
12292,12292,'should allow to pass config to Popper with `popperConfig` as a function',0.0,0,0,0
12293,12293,'should allow to pass config to Popper with `popperConfig`',0.0,0,0,0
12294,12294,'should allow to rewrite to a `afterFiles` rewrite config',0.0,0,0,0
12295,12295,'should allow to rewrite to a `beforeFiles` rewrite config',0.0,0,0,0
12296,12296,'should allow transitioning from valid states',0.0,0,0,0
12297,12297,'should allow valid object `matches`',0.0,0,0,0
12298,12298,'should allow valid string `matches`',0.0,0,0,0
12299,12299,'should always call getServerSideProps without caching',0.0,0,0,0
12300,12300,'should always call getStaticProps without caching in dev',0.0,0,0,0
12301,12301,'should always show fallback for page not in getStaticPaths',0.0,0,0,0
12302,12302,'should announce document.title changes',0.0,0,0,0
12303,12303,'should announce h1 changes',0.0,0,0,0
12304,12304,'should announce route changes when h1 changes inside an inner layout',0.0,0,0,0
12305,12305,'should append @example doclet to all examples',0.0,0,0,0
12306,12306,"'should append the backdrop html once and include the ""fade"" class if it is ""shown"" and ""animated""'",0.0,0,0,0
12307,12307,"'should append the backdrop html once on show and include the ""show"" class if it is ""shown""'",0.0,0,0,0
12308,12308,'should apply an update function',0.0,0,0,0
12309,12309,'should apply browserslist target',0.0,0,0,0
12310,12310,'should apply config redirect correctly',0.0,0,0,0
12311,12311,'should apply config rewrites correctly',0.0,0,0,0
12312,12312,'should apply legacyBrowsers: false by default',0.0,0,0,0
12313,12313,'should apply legacyBrowsers: true',0.0,0,0,0
12314,12314,'should apply metadata when navigating client-side',0.0,0,0,0
12315,12315,'should apply ref on link',0.0,0,0,0
12316,12316,'should apply the catch-all route to the parallel route if no matching route is found',0.0,0,0,0
12317,12317,'should apply updateWebpackConfig config option',0.0,0,0,0
12318,12318,'should assign the resolved data when invoked with a promise factory',0.0,0,0,0
12319,12319,'should assign the resolved data when invoked with a promise service',0.0,0,0,0
12320,12320,'should attach Styleguidist config object to webpack context',0.0,0,0,0
12321,12321,'should attach examples from Markdown file',0.0,0,0,0
12322,12322,'should auto hide',0.0,0,0,0
12323,12323,'should autofocus itself by default',0.0,0,0,0
12324,12324,'should automatically enable preserveActionOrder',0.0,0,0,0
12325,12325,'should automatically reset cache TTL when an error occurs and build cache was available',0.0,0,0,0
12326,12326,'should automatically reset cache TTL when an error occurs and runtime cache was available',0.0,0,0,0
12327,12327,'should avoid double-fetching when optimistic navigation fails',0.0,0,0,0
12328,12328,'should bail out to client rendering during SSG',0.0,0,0,0
12329,12329,'should bailout to client rendering - with suspense boundary',0.0,0,0,0
12330,12330,'should bailout to client rendering - without suspense boundary',0.0,0,0,0
12331,12331,'should bailout when using searchParams is passed to client component',0.0,0,0,0
12332,12332,'should bailout when using searchParams',0.0,0,0,0
12333,12333,'should batch send events',0.0,0,0,0
12334,12334,'should be a function',0.0,0,0,0
12335,12335,'should be able to be initialized at a custom state value',0.0,0,0,0
12336,12336,'should be able to be initialized at a custom state',0.0,0,0,0
12337,12337,'should be able to be stringified',0.0,0,0,0
12338,12338,'should be able to check a tag after recreating a persisted state',0.0,0,0,0
12339,12339,'should be able to check source state tags when checking',0.0,0,0,0
12340,12340,'should be able to communicate with arbitrary actors if sessionId is known',0.0,0,0,0
12341,12341,'should be able to create a state from a JSON config',0.0,0,0,0
12342,12342,'should be able to defer events',0.0,0,0,0
12343,12343,'should be able to handle toggling of other children siblings',0.0,0,0,0
12344,12344,"'should be able to identify clicked dropdown, even with multiple dropdowns in the same tag'",0.0,0,0,0
12345,12345,"'should be able to identify clicked dropdown, no matter the markup order'",0.0,0,0,0
12346,12346,'should be able to ignore some Array-destructured hook return values',0.0,0,0,0
12347,12347,'should be able to log (log action)',0.0,0,0,0
12348,12348,'should be able to log event origin (log action)',0.0,0,0,0
12349,12349,'should be able to name existing actors',0.0,0,0,0
12350,12350,'should be able to navigate between edge SSR routes without any errors',0.0,0,0,0
12351,12351,'should be able to navigate between rsc routes',0.0,0,0,0
12352,12352,'should be able to opt-out 3rd party packages being bundled in server components',0.0,0,0,0
12353,12353,'should be able to provide events that use string unions as their type',0.0,0,0,0
12354,12354,'should be able to raise a delayed event and respond to it in the same state',0.0,0,0,0
12355,12355,'should be able to raise an event and respond to it in the same state',0.0,0,0,0
12356,12356,'should be able to raise event using special target',0.0,0,0,0
12357,12357,'should be able to read from event',0.0,0,0,0
12358,12358,'should be able to reference action implementations from action objects',0.0,0,0,0
12359,12359,'should be able to require next/server outside edge',0.0,0,0,0
12360,12360,'should be able to resolve a custom initialized state',0.0,0,0,0
12361,12361,'should be able to restart a named spawned actor within a single macrostep when stopping by ref',0.0,0,0,0
12362,12362,'should be able to restart a named spawned actor within a single macrostep when stopping by resolved name',0.0,0,0,0
12363,12363,'should be able to restart a named spawned actor within a single macrostep when stopping by static name',0.0,0,0,0
12364,12364,'should be able to restart a spawned actor within a single macrostep',0.0,0,0,0
12365,12365,'should be able to restart an invoke when reentering the invoking state',0.0,0,0,0
12366,12366,'should be able to return an invalid value if the request was already sent',0.0,0,0,0
12367,12367,'should be able to rewrite on _next/static/chunks/pages/ 404',0.0,0,0,0
12368,12368,'should be able to send a delayed event to itself with delay = 0',0.0,0,0,0
12369,12369,'should be able to send a delayed event to itself',0.0,0,0,0
12370,12370,'should be able to send all of the parent event types back to the parent from an invoked callback',0.0,0,0,0
12371,12371,'should be able to send an event directly to an ActorRef',0.0,0,0,0
12372,12372,'should be able to send an event from expression to an actor',0.0,0,0,0
12373,12373,'should be able to send an event to a named actor',0.0,0,0,0
12374,12374,'should be able to send an event to an actor',0.0,0,0,0
12375,12375,'should be able to send and return body greater than default highWaterMark (16KiB)',0.0,0,0,0
12376,12376,'should be able to send and return body size equal to 1mb',0.0,0,0,0
12377,12377,'should be able to send and return body size equal to 5kb',0.0,0,0,0
12378,12378,'should be able to send and return body size equal to 5mb',0.0,0,0,0
12379,12379,'should be able to send and return with body greater than 16KiB',0.0,0,0,0
12380,12380,'should be able to send and return with body size equal to 16KiB',0.0,0,0,0
12381,12381,"'should be able to show the proper menu, even with multiple dropdowns in the same tag'",0.0,0,0,0
12382,12382,'should be able to spawn a promise',0.0,0,0,0
12383,12383,'should be able to spawn an actor from a callback',0.0,0,0,0
12384,12384,'should be able to spawn an observable',0.0,0,0,0
12385,12385,'should be able to spawn callback actors in (lazy) initial context',0.0,0,0,0
12386,12386,'should be able to spawn machines in (lazy) initial context',0.0,0,0,0
12387,12387,'should be able to specify a Promise as a service',0.0,0,0,0
12388,12388,'should be able to specify a callback as a service',0.0,0,0,0
12389,12389,'should be able to transition with delay from nested initial state',0.0,0,0,0
12390,12390,'should be able to use `hasTag` immediately',0.0,0,0,0
12391,12391,'should be able to use actions and guards defined in options',0.0,0,0,0
12392,12392,'should be able to use choose actions from within options',0.0,0,0,0
12393,12393,"'should be appended on ""document.body"" by default'",0.0,0,0,0
12394,12394,'should be appended on any element given by the proper config',0.0,0,0,0
12395,12395,'should be available in Route Handlers',0.0,0,0,0
12396,12396,'should be available in Server Components',0.0,0,0,0
12397,12397,'should be changed if any actions occur',0.0,0,0,0
12398,12398,'should be changed if state changes',0.0,0,0,0
12399,12399,'should be convertable to Rx observable',0.0,0,0,0
12400,12400,'should be disabled from api route handler',0.0,0,0,0
12401,12401,'should be disabled',0.0,0,0,0
12402,12402,'should be enabled from api route handler when draft mode enabled',0.0,0,0,0
12403,12403,'should be enabled from page when draft mode enabled',0.0,0,0,0
12404,12404,"'should be interoperable with RxJS, etc. via Symbol.observable'",0.0,0,0,0
12405,12405,'should be invoked with a promise factory and ignore unhandled onError target',0.0,0,0,0
12406,12406,'should be invoked with a promise factory and reject with ErrorExecution',0.0,0,0,0
12407,12407,'should be invoked with a promise factory and resolve through onDone for compound state nodes',0.0,0,0,0
12408,12408,'should be invoked with a promise factory and resolve through onDone',0.0,0,0,0
12409,12409,'should be invoked with a promise factory and stop on unhandled onError target when on strict mode',0.0,0,0,0
12410,12410,'should be invoked with a promise service and resolve through onDone for compound state nodes',0.0,0,0,0
12411,12411,'should be possible to access context in the event expression',0.0,0,0,0
12412,12412,'should be possible to cancel a raised delayed event',0.0,0,0,0
12413,12413,'should be possible to disable sorting',0.0,0,0,0
12414,12414,'should be possible to pass typegen-less machines to functions expecting a machine argument that do not utilize the typegen information',0.0,0,0,0
12415,12415,'should be possible to send immediate events to initially invoked actors',0.0,0,0,0
12416,12416,'should be possible to switch between runtimes in API routes',0.0,0,0,0
12417,12417,'should be possible to switch between runtimes in pages',0.0,0,0,0
12418,12418,'should be possible to write custom sort function',0.0,0,0,0
12419,12419,'should be shown after the first call to show() has been prevented while fading is enabled ',0.0,0,0,0
12420,12420,'should be soft for back navigation',0.0,0,0,0
12421,12421,'should be soft for forward navigation',0.0,0,0,0
12422,12422,"'should be string, function or array'",0.0,0,0,0
12423,12423,"'should be string, function, or array'",0.0,0,0,0
12424,12424,'should be subscribable',0.0,0,0,0
12425,12425,'should be taken even in absence of other transitions',0.0,0,0,0
12426,12426,'should be unsubscribable',0.0,0,0,0
12427,12427,'should block for crawler correctly',0.0,0,0,0
12428,12428,'should block rendering for bots and return 404 status',0.0,0,0,0
12429,12429,'should break the build if a page is missing root layout',0.0,0,0,0
12430,12430,'should bubble up events that nested states cannot handle',0.0,0,0,0
12431,12431,'should bubble up the events to the parent elements',0.0,0,0,0
12432,12432,'should build /api/hello and /api/edge as an api route with edge runtime',0.0,0,0,0
12433,12433,'should build /app-valid-runtime as a dynamic page with the edge runtime',0.0,0,0,0
12434,12434,'should build /edge as a dynamic page with the edge runtime',0.0,0,0,0
12435,12435,'should build /node-ssr as a dynamic page with the nodejs runtime',0.0,0,0,0
12436,12436,'should build /static as a static page with the nodejs runtime',0.0,0,0,0
12437,12437,'should build favicon.ico as a custom route',0.0,0,0,0
12438,12438,'should build static files into static route',0.0,0,0,0
12439,12439,'should bundle css resources into chunks',0.0,0,0,0
12440,12440,'should bundle external libraries if they are on the action layer',0.0,0,0,0
12441,12441,'should bust data cache with symbol',0.0,0,0,0
12442,12442,'should bust data cache',0.0,0,0,0
12443,12443,'should bypass fetch cache with cache-control: no-cache',0.0,0,0,0
12444,12444,'should cache correctly for cache: no-store',0.0,0,0,0
12445,12445,'should cache correctly for fetchCache = default-cache',0.0,0,0,0
12446,12446,'should cache correctly for fetchCache = force-cache',0.0,0,0,0
12447,12447,'should cache correctly handle JSON body',0.0,0,0,0
12448,12448,'should cache correctly with POST method and revalidate',0.0,0,0,0
12449,12449,'should cache correctly with authorization header and revalidate',0.0,0,0,0
12450,12450,'should cache correctly with cookie header and revalidate',0.0,0,0,0
12451,12451,'should cache correctly with post method and revalidate edge',0.0,0,0,0
12452,12452,'should cache correctly with post method and revalidate',0.0,0,0,0
12453,12453,'should cache correctly with utf8 encoding edge',0.0,0,0,0
12454,12454,'should cache correctly with utf8 encoding',0.0,0,0,0
12455,12455,'should calculate the entry set for external transitions in parallel states',0.0,0,0,0
12456,12456,'should call EventHandler.off',0.0,0,0,0
12457,12457,'should call Popper and detect navbar on update',0.0,0,0,0
12458,12458,'should call ScrollBarHelper to handle scrollBar on body',0.0,0,0,0
12459,12459,"'should call `hide` on resize, if element\'s position is not fixed any more'",0.0,0,0,0
12460,12460,'should call `maybeEnableCycle` on mouse out with pause equal to hover',0.0,0,0,0
12461,12461,'should call `scrollTop` if element doesn\'t not support `scrollTo`',0.0,0,0,0
12462,12462,'should call a callback when input value changed',0.0,0,0,0
12463,12463,'should call a scrollspy method',0.0,0,0,0
12464,12464,'should call a tab method',0.0,0,0,0
12465,12465,'should call a toast method',0.0,0,0,0
12466,12466,'should call a tooltip method',0.0,0,0,0
12467,12467,'should call adjust dialog',0.0,0,0,0
12468,12468,'should call an onDone callback immediately if the service is already done',0.0,0,0,0
12469,12469,'should call complete() once a final state is reached',0.0,0,0,0
12470,12470,'should call complete() once the interpreter is stopped',0.0,0,0,0
12471,12471,'should call data expressions on nested final nodes',0.0,0,0,0
12472,12472,'should call delegated listener just once',0.0,0,0,0
12473,12473,'should call each exit handler only once when the service gets stopped',0.0,0,0,0
12474,12474,'should call exit actions in reversed document order when the service gets stopped',0.0,0,0,0
12475,12475,'should call exit actions of parallel states in reversed document order when the service gets stopped after earlier region transition',0.0,0,0,0
12476,12476,'should call exit actions of parallel states in reversed document order when the service gets stopped after later region transition',0.0,0,0,0
12477,12477,'should call exit actions of parallel states in reversed document order when the service gets stopped after multiple regions transition',0.0,0,0,0
12478,12478,'should call exit actions when machine gets stopped immediately',0.0,0,0,0
12479,12479,"'should call hide first, if another modal is open'",0.0,0,0,0
12480,12480,"'should call hide first, if another offcanvas is open'",0.0,0,0,0
12481,12481,'should call hide method if show class is present',0.0,0,0,0
12482,12482,"'should call hide when a element with data-bs-dismiss=""offcanvas"" is clicked'",0.0,0,0,0
12483,12483,'should call initial custom actions when starting a service',0.0,0,0,0
12484,12484,'should call invoke creator with raised event',0.0,0,0,0
12485,12485,'should call listener just once',0.0,0,0,0
12486,12486,'should call mixed custom and builtin actions in the definitions order',0.0,0,0,0
12487,12487,'should call next()/prev() instance methods when clicking the respective direction buttons',0.0,0,0,0
12488,12488,'should call offcanvas method',0.0,0,0,0
12489,12489,'should call onDone when resolved (async)',0.0,0,0,0
12490,12490,'should call onError handler when React invokes error handler',0.0,0,0,0
12491,12491,'should call onError only on the state which has invoked failed service',0.0,0,0,0
12492,12492,'should call onError upon error (async)',0.0,0,0,0
12493,12493,'should call onError upon error (sync)',0.0,0,0,0
12494,12494,'should call pause method on mouse over with pause equal to hover',0.0,0,0,0
12495,12495,'should call popper update',0.0,0,0,0
12496,12496,'should call raised transition builtin actions with raised event',0.0,0,0,0
12497,12497,'should call raised transition custom actions with raised event',0.0,0,0,0
12498,12498,'should call setContent once',0.0,0,0,0
12499,12499,'should call show method if show class is not present',0.0,0,0,0
12500,12500,'should call show method',0.0,0,0,0
12501,12501,'should call title function',0.0,0,0,0
12502,12502,'should call to if the config is a number',0.0,0,0,0
12503,12503,"'should call toggle and hide the tooltip when trigger is ""click""'",0.0,0,0,0
12504,12504,"'should call toggle and show the tooltip when trigger is ""click""'",0.0,0,0,0
12505,12505,'should call transition actions in document order for same-level parallel regions',0.0,0,0,0
12506,12506,'should call transition actions in document order for states at different levels of parallel regions',0.0,0,0,0
12507,12507,'should call updateExample function for example',0.0,0,0,0
12508,12508,'should cancel delayed events',0.0,0,0,0
12509,12509,'should capitalize the display name',0.0,0,0,0
12510,12510,'should capture correct context values on subsequent transitions',0.0,0,0,0
12511,12511,'should carry actions from previous transitions within same step',0.0,0,0,0
12512,12512,'should change document title in isolated mode',0.0,0,0,0
12513,12513,'should change document title',0.0,0,0,0
12514,12514,'should change the config using the update callback',0.0,0,0,0
12515,12515,'should check for automatic transitions even after microsteps are done (with `always`)',0.0,0,0,0
12516,12516,'should check for automatic transitions even after microsteps are done',0.0,0,0,0
12517,12517,'should check guards with interim states',0.0,0,0,0
12518,12518,'should check type for array',0.0,0,0,0
12519,12519,'should check type for boolean',0.0,0,0,0
12520,12520,'should check type for directory path',0.0,0,0,0
12521,12521,'should check type for file path',0.0,0,0,0
12522,12522,'should check type for function',0.0,0,0,0
12523,12523,'should check type for number',0.0,0,0,0
12524,12524,'should check type for object',0.0,0,0,0
12525,12525,'should check type for relative directory path and absolutize it',0.0,0,0,0
12526,12526,'should check type for relative file path and absolutize it',0.0,0,0,0
12527,12527,'should check type for string',0.0,0,0,0
12528,12528,'should check type of the config object',0.0,0,0,0
12529,12529,'should choose the final candidate without a cond if none others match',0.0,0,0,0
12530,12530,'should choose the first candidate target that matches the cond (B)',0.0,0,0,0
12531,12531,'should choose the first candidate target that matches the cond (C)',0.0,0,0,0
12532,12532,'should choose the first candidate target that matches the cond (D)',0.0,0,0,0
12533,12533,'should clear all scheduled events when the interpreter gets stopped',0.0,0,0,0
12534,12534,'should clear console on second mount',0.0,0,0,0
12535,12535,'should clear interval if there is one',0.0,0,0,0
12536,12536,'should clear selection if above the first section',0.0,0,0,0
12537,12537,'should clear timeout if toast is interacted with keyboard',0.0,0,0,0
12538,12538,'should clear timeout if toast is interacted with mouse',0.0,0,0,0
12539,12539,'should clear timeout if toast is shown again before it is hidden',0.0,0,0,0
12540,12540,'should close alert with fade class',0.0,0,0,0
12541,12541,'should close an alert without instantiating it manually with the parent selector',0.0,0,0,0
12542,12542,'should close an alert without instantiating it manually',0.0,0,0,0
12543,12543,'should close an alert',0.0,0,0,0
12544,12544,"'should close dropdown (only) by clicking inside the dropdown menu when it has data-attribute `data-bs-auto-close=""inside""`'",0.0,0,0,0
12545,12545,"'should close dropdown (only) by clicking outside the dropdown menu when it has data-attribute `data-bs-auto-close=""outside""`'",0.0,0,0,0
12546,12546,"'should close dropdown using `escape` button, and return focus to its trigger'",0.0,0,0,0
12547,12547,"'should close modal when a click occurred on a data-bs-dismiss=""modal"" with ""bs-target"" outside of modal element'",0.0,0,0,0
12548,12548,"'should close modal when a click occurred on data-bs-dismiss=""modal"" inside modal'",0.0,0,0,0
12549,12549,'should close modal when clicking outside of modal-content',0.0,0,0,0
12550,12550,'should close modal when escape key is pressed with keyboard = true and backdrop is static',0.0,0,0,0
12551,12551,'should close the dropdown if the user clicks on a text field that is not contained within dropdown-menu',0.0,0,0,0
12552,12552,'should close toast when close element with data-bs-dismiss attribute is set',0.0,0,0,0
12553,12553,'should collapse accordion children but not nested accordion children',0.0,0,0,0
12554,12554,'should collapse only the first collapse',0.0,0,0,0
12555,12555,'should communicate with the child machine (invoke on created machine)',0.0,0,0,0
12556,12556,'should communicate with the child machine (invoke on machine)',0.0,0,0,0
12557,12557,'should communicate with the child machine (invoke on state)',0.0,0,0,0
12558,12558,'should compile with a typestate value that is a union',0.0,0,0,0
12559,12559,'should compile with conditional matches even without a specified Typestate',0.0,0,0,0
12560,12560,'should compile with typed matches (createMachine)',0.0,0,0,0
12561,12561,'should compose passed class names',0.0,0,0,0
12562,12562,'should console.error a message if called with multiple keys',0.0,0,0,0
12563,12563,'should contain IsolateButton in toolbars if pagePerSection is false',0.0,0,0,0
12564,12564,'should contain default meta tags in error page',0.0,0,0,0
12565,12565,'should contain og package files in middleware',0.0,0,0,0
12566,12566,'should contain styled-jsx styles during SSR',0.0,0,0,0
12567,12567,'should continue cycling if it was already',0.0,0,0,0
12568,12568,'should convert title and content to string if numbers',0.0,0,0,0
12569,12569,'should copy files correctly',0.0,0,0,0
12570,12570,'should copy text on click',0.0,0,0,0
12571,12571,'should correct skip URL normalizing in middleware',0.0,0,0,0
12572,12572,'should correctly collect global css imports and mark them as side effects',0.0,0,0,0
12573,12573,'should correctly extract events from events having union of strings as their `type`',0.0,0,0,0
12574,12574,"'should correctly handle fetchCache = ""force-no-store""'",0.0,0,0,0
12575,12575,'should correctly handle multi-level generateStaticParams when some levels are missing',0.0,0,0,0
12576,12576,'should correctly handle navigation between multiple root layouts',0.0,0,0,0
12577,12577,'should correctly include headers instance in cache key',0.0,0,0,0
12578,12578,'should correctly render component returning null',0.0,0,0,0
12579,12579,'should correctly render component returning undefined',0.0,0,0,0
12580,12580,'should correctly render layout returning null',0.0,0,0,0
12581,12581,'should correctly render layout returning undefined',0.0,0,0,0
12582,12582,'should correctly render page returning null',0.0,0,0,0
12583,12583,'should correctly render page returning undefined',0.0,0,0,0
12584,12584,'should correctly select navigation element on backward scrolling when each target section height is 100%',0.0,0,0,0
12585,12585,'should correctly skip caching POST fetch for POST handler',0.0,0,0,0
12586,12586,'should correctly update when changing catchall segment',0.0,0,0,0
12587,12587,'should correctly update when changing param segment',0.0,0,0,0
12588,12588,'should correctly update when changing static segment',0.0,0,0,0
12589,12589,'should create a carousel',0.0,0,0,0
12590,12590,'should create a collapse',0.0,0,0,0
12591,12591,'should create a dropdown',0.0,0,0,0
12592,12592,'should create a modal with given config',0.0,0,0,0
12593,12593,'should create a modal',0.0,0,0,0
12594,12594,'should create a offcanvas with given config',0.0,0,0,0
12595,12595,'should create a popover with a config object',0.0,0,0,0
12596,12596,'should create a popover',0.0,0,0,0
12597,12597,'should create a scrollspy with given config',0.0,0,0,0
12598,12598,'should create a scrollspy',0.0,0,0,0
12599,12599,'should create a tab',0.0,0,0,0
12600,12600,'should create a toast',0.0,0,0,0
12601,12601,'should create a tooltip',0.0,0,0,0
12602,12602,'should create an inert instance of the given State',0.0,0,0,0
12603,12603,'should create an inert instance of the given stateValue and context',0.0,0,0,0
12604,12604,'should create an offcanvas',0.0,0,0,0
12605,12605,'should create carousel and go to the next slide on click (using links as controls)',0.0,0,0,0
12606,12606,'should create carousel and go to the next slide on click (with real button controls)',0.0,0,0,0
12607,12607,'should create carousel and go to the next slide on click with data-bs-slide-to',0.0,0,0,0
12608,12608,'should create dynamically a tab',0.0,0,0,0
12609,12609,'should create invocations from machines in nested states',0.0,0,0,0
12610,12610,'should create invoke based on context updated by entry actions of the same state',0.0,0,0,0
12611,12611,'should create new alert instance and call close',0.0,0,0,0
12612,12612,'should create new button instance and call toggle',0.0,0,0,0
12613,12613,'should create offset modifier correctly when offset option is a function',0.0,0,0,0
12614,12614,'should create offset modifier correctly when offset option is a string into data attribute',0.0,0,0,0
12615,12615,'should create offset modifier when offset is passed as a function',0.0,0,0,0
12616,12616,'should create offset modifier when offset option is passed in data attribute',0.0,0,0,0
12617,12617,'should create scrollspy on window load event',0.0,0,0,0
12618,12618,'should create socket URL',0.0,0,0,0
12619,12619,'should create the 404 mapping and copy the file to pages',0.0,0,0,0
12620,12620,'should create the tip element and return it',0.0,0,0,0
12621,12621,'should create updates (form example)',0.0,0,0,0
12622,12622,'should create updates',0.0,0,0,0
12623,12623,'should customize the next/prev events',0.0,0,0,0
12624,12624,'should de-register element event listeners',0.0,0,0,0
12625,12625,'should dedupe server data requests',0.0,0,0,0
12626,12626,'should deduplicate styles on the module level',0.0,0,0,0
12627,12627,'should deep clone array of primitives',0.0,0,0,0
12628,12628,'should deep clone array with nested objects',0.0,0,0,0
12629,12629,'should deep clone simple objects',0.0,0,0,0
12630,12630,'should deeply preserve action order when .preserveActionOrder = true',0.0,0,0,0
12631,12631,'should defer a single send event for a delayed transition with multiple conditions (#886)',0.0,0,0,0
12632,12632,'should defer events sent to an uninitialized service',0.0,0,0,0
12633,12633,'should define a plugin on the jQuery instance',0.0,0,0,0
12634,12634,'should deliver events sent from the entry actions to a service invoked in the same state',0.0,0,0,0
12635,12635,'should deliver events sent from the exit actions to a service invoked in the same state',0.0,0,0,0
12636,12636,'should deliver events sent to other actors when using batched events',0.0,0,0,0
12637,12637,'should destroy a carousel',0.0,0,0,0
12638,12638,'should destroy a collapse',0.0,0,0,0
12639,12639,'should destroy a tooltip after it is shown and hidden',0.0,0,0,0
12640,12640,'should destroy a tooltip and remove it from the dom',0.0,0,0,0
12641,12641,'should destroy a tooltip and reset it\'s initial title',0.0,0,0,0
12642,12642,'should destroy a tooltip',0.0,0,0,0
12643,12643,'should destroy old popper references on toggle',0.0,0,0,0
12644,12644,'should destroy',0.0,0,0,0
12645,12645,'should detect an invalid machine',0.0,0,0,0
12646,12646,'should detect if the parameter is an element or not and return Boolean',0.0,0,0,0
12647,12647,'should detect jQuery element',0.0,0,0,0
12648,12648,'should determine either server or client component page file as leaf node page',0.0,0,0,0
12649,12649,'should determine other files under layout routes as non leaf node',0.0,0,0,0
12650,12650,'should determine the resolved initial state from the transient state',0.0,0,0,0
12651,12651,'should determine the resolved state from a root transient state',0.0,0,0,0
12652,12652,'should determine top level metadata routes',0.0,0,0,0
12653,12653,'should disable tooltip',0.0,0,0,0
12654,12654,'should disallow string actions for non-simple actions',0.0,0,0,0
12655,12655,'should discard not processed events in the case of error condition',0.0,0,0,0
12656,12656,'should disconnect existing observer',0.0,0,0,0
12657,12657,'should display all parallel route params with useParams',0.0,0,0,0
12658,12658,'should display error digest for error in server component with default error boundary',0.0,0,0,0
12659,12659,'should dispose a button',0.0,0,0,0
12660,12660,'should dispose a modal',0.0,0,0,0
12661,12661,'should dispose a scrollspy',0.0,0,0,0
12662,12662,'should dispose a tab',0.0,0,0,0
12663,12663,'should dispose an alert',0.0,0,0,0
12664,12664,'should dispose an component',0.0,0,0,0
12665,12665,'should dispose an offcanvas',0.0,0,0,0
12666,12666,'should dispose dropdown with Popper',0.0,0,0,0
12667,12667,'should dispose dropdown',0.0,0,0,0
12668,12668,'should dispose of previous histories',0.0,0,0,0
12669,12669,'should dispose of the callback (if disposal function provided)',0.0,0,0,0
12670,12670,'should do nothing if a modal is shown',0.0,0,0,0
12671,12671,'should do nothing if a modal is transitioning',0.0,0,0,0
12672,12672,'should do nothing if a wrong index is provided',0.0,0,0,0
12673,12673,'should do nothing if already shown',0.0,0,0,0
12674,12674,'should do nothing if disabled',0.0,0,0,0
12675,12675,'should do nothing if is transitioning',0.0,0,0,0
12676,12676,'should do nothing if no carousel class on click on arrows',0.0,0,0,0
12677,12677,'should do nothing if no selector on click on arrows',0.0,0,0,0
12678,12678,'should do nothing if the content is a child of the element',0.0,0,0,0
12679,12679,'should do nothing if the element is null',0.0,0,0,0
12680,12680,'should do nothing if the tooltip is not shown',0.0,0,0,0
12681,12681,'should do nothing is the modal is not shown',0.0,0,0,0
12682,12682,'should do nothing is the modal is transitioning',0.0,0,0,0
12683,12683,'should do nothing when an element has nothing stored',0.0,0,0,0
12684,12684,'should do nothing when resource is empty',0.0,0,0,0
12685,12685,'should do nothing when the pressed key is not escape',0.0,0,0,0
12686,12686,'should do nothing when we call hide on a non shown toast',0.0,0,0,0
12687,12687,'should drop unused exports in a modern-apis page',0.0,0,0,0
12688,12688,'should elide import',0.0,0,0,0
12689,12689,'should emit noindex meta tag for not found page when streaming',0.0,0,0,0
12690,12690,'should emit refresh meta tag for redirect page when streaming',0.0,0,0,0
12691,12691,"'should emit the ""done.state.final.red"" event when all nested states are in their final states'",0.0,0,0,0
12692,12692,'should enable a tooltip',0.0,0,0,0
12693,12693,'should enable rule with empty object',0.0,0,0,0
12694,12694,'should enable selector delegation',0.0,0,0,0
12695,12695,'should enable smoothScroll',0.0,0,0,0
12696,12696,'should enable verbose mode in CleanWebpackPlugin',0.0,0,0,0
12697,12697,'should encode chunk path correctly',0.0,0,0,0
12698,12698,'should ensure the </body></html> suffix is at the end of the stream',0.0,0,0,0
12699,12699,'should enter all descendents when target is a descendent of current',0.0,0,0,0
12700,12700,'should enter initial states of parallel states',0.0,0,0,0
12701,12701,'should enter specific states in all regions',0.0,0,0,0
12702,12702,'should enter specific states in one region',0.0,0,0,0
12703,12703,'should enter specific states in some regions',0.0,0,0,0
12704,12704,'should equal equivalent node that has no nonce',0.0,0,0,0
12705,12705,"'should equal equivalent node that has same nonce property, even if the original node has no html nonce attribute value'",0.0,0,0,0
12706,12706,'should equal itself',0.0,0,0,0
12707,12707,'should error again when there is new conflict',0.0,0,0,0
12708,12708,'should error correctly for implementations called in response to internal events when there is no explicit event type',0.0,0,0,0
12709,12709,'should error correctly for invalid params from generateStaticParams',0.0,0,0,0
12710,12710,'should error if serverActions is not enabled',0.0,0,0,0
12711,12711,'should error if serverActionsBodySizeLimit config is a negative number',0.0,0,0,0
12712,12712,'should error if serverActionsBodySizeLimit config is a negative size',0.0,0,0,0
12713,12713,'should error if serverActionsBodySizeLimit config is invalid',0.0,0,0,0
12714,12714,'should error on a provided action where there are no inferred actions',0.0,0,0,0
12715,12715,'should error on a provided delay where there are no inferred delays',0.0,0,0,0
12716,12716,'should error on a provided guard where there are no inferred guards',0.0,0,0,0
12717,12717,'should error on a provided service where there are no declared services',0.0,0,0,0
12718,12718,'should error on bad object from getStaticProps',0.0,0,0,0
12719,12719,'should error on dynamic page without getStaticPaths returning fallback property',0.0,0,0,0
12720,12720,'should error on dynamic page without getStaticPaths',0.0,0,0,0
12721,12721,'should error on page load on static generation',0.0,0,0,0
12722,12722,'should error on page load',0.0,0,0,0
12723,12723,'should error on page navigation',0.0,0,0,0
12724,12724,'should error when id is missing in generateImageMetadata',0.0,0,0,0
12725,12725,'should error when id is missing in generateSitemaps',0.0,0,0,0
12726,12726,'should error when not in dev',0.0,0,0,0
12727,12727,'should error when passing invalid router state tree',0.0,0,0,0
12728,12728,'should error when use export output for server actions',0.0,0,0,0
12729,12729,'should error when using dynamic href in app dir',0.0,0,0,0
12730,12730,'should error when using dynamic href.pathname in app dir',0.0,0,0,0
12731,12731,'should escape streaming data correctly',0.0,0,0,0
12732,12732,'should evaluate custom guards',0.0,0,0,0
12733,12733,'should evaluate the expression (function) to determine the delay',0.0,0,0,0
12734,12734,'should evaluate the expression (string) to determine the delay',0.0,0,0,0
12735,12735,'should exclude',0.0,0,0,0
12736,12736,'should execute a function after a computed CSS transition duration and there was no transitionend event dispatched',0.0,0,0,0
12737,12737,'should execute a function when a transitionend event is dispatched',0.0,0,0,0
12738,12738,'should execute a multiple conditional actions',0.0,0,0,0
12739,12739,'should execute a single conditional action',0.0,0,0,0
12740,12740,'should execute actions when sending batched events',0.0,0,0,0
12741,12741,'should execute actions',0.0,0,0,0
12742,12742,'should execute all eventless transitions in the same microstep (with `always`)',0.0,0,0,0
12743,12743,'should execute all eventless transitions in the same microstep',0.0,0,0,0
12744,12744,'should execute all internal events one after the other',0.0,0,0,0
12745,12745,'should execute an after transition after starting from a persisted state',0.0,0,0,0
12746,12746,'should execute an after transition after starting from a state resolved using `machine.getInitialState`',0.0,0,0,0
12747,12747,'should execute builtin actions correctly when stopping an interpreter',0.0,0,0,0
12748,12748,"'should execute callback if readyState is not ""loading""'",0.0,0,0,0
12749,12749,'should execute callback on click',0.0,0,0,0
12750,12750,'should execute callbacks when DOMContentLoaded is fired and should not add more than one listener',0.0,0,0,0
12751,12751,'should execute events (`exec` property)',0.0,0,0,0
12752,12752,'should execute events (function)',0.0,0,0,0
12753,12753,'should execute exit actions of the settled state of the last initiated microstep after executing all actions from that microstep',0.0,0,0,0
12754,12754,'should execute exit actions of the settled state of the last initiated microstep',0.0,0,0,0
12755,12755,'should execute final child state actions first',0.0,0,0,0
12756,12756,'should execute from absolute paths',0.0,0,0,0
12757,12757,'should execute if arg is function & return the result',0.0,0,0,0
12758,12758,'should execute if arg is function',0.0,0,0,0
12759,12759,'should execute initial actions when re-starting a service that transitioned to a different state',0.0,0,0,0
12760,12760,'should execute initial actions when re-starting a service',0.0,0,0,0
12761,12761,'should execute initial entry action',0.0,0,0,0
12762,12762,'should execute matchesState on a State given the parent state value',0.0,0,0,0
12763,12763,'should execute referenced custom actions correctly when stopping an interpreter',0.0,0,0,0
12764,12764,'should exit all substates when superstates exits (A_EVENT)',0.0,0,0,0
12765,12765,'should exit and enter the state for self-transitions (deep)',0.0,0,0,0
12766,12766,'should exit and enter the state for self-transitions (shallow)',0.0,0,0,0
12767,12767,'should exit children of parallel state nodes',0.0,0,0,0
12768,12768,'should exit current node and enter target node when target is not a descendent or ancestor of current',0.0,0,0,0
12769,12769,'should exit current node and reenter target node when target is ancestor of current',0.0,0,0,0
12770,12770,'should exit deep and enter deep (A_P)',0.0,0,0,0
12771,12771,'should exit deep and enter deep (A_S)',0.0,0,0,0
12772,12772,'should exit deep and enter deep (D_P)',0.0,0,0,0
12773,12773,'should exit deep and enter deep (D_S)',0.0,0,0,0
12774,12774,'should exit deep descendant during a self-transition',0.0,0,0,0
12775,12775,'should exit substate when machine handles event (MACHINE_EVENT)',0.0,0,0,0
12776,12776,'should exit substates and superstates when exiting (B_EVENT)',0.0,0,0,0
12777,12777,'should exit substates and superstates when exiting (C_EVENT)',0.0,0,0,0
12778,12778,'should exit superstates when exiting (D_EVENT)',0.0,0,0,0
12779,12779,'should export client module references in esm',0.0,0,0,0
12780,12780,'should expose default setting to allow to override them',0.0,0,0,0
12781,12781,'should expose default setting types for read',0.0,0,0,0
12782,12782,'should extract doclets',0.0,0,0,0
12783,12783,'should fall back on returning the module as a whole',0.0,0,0,0
12784,12784,'should fallback rewrite non-matching API request',0.0,0,0,0
12785,12785,'should fallback to default if no pattern matched',0.0,0,0,0
12786,12786,'should fallback to localhost if metadataBase is missing for absolute urls resolving',0.0,0,0,0
12787,12787,'should fallback to using wildcard transition definition (if specified)',0.0,0,0,0
12788,12788,'should fetch /_next/data correctly with mismatched href and as',0.0,0,0,0
12789,12789,'should fetch data for getServerSideProps without reloading',0.0,0,0,0
12790,12790,'should fetch data for getStaticProps without reloading',0.0,0,0,0
12791,12791,'should fill params into dynamic routes url of metadata images',0.0,0,0,0
12792,12792,'should fill params into routes groups url of static images',0.0,0,0,0
12793,12793,'should filter correctly after middleware rewrite',0.0,0,0,0
12794,12794,'should filter list when search field contains a query',0.0,0,0,0
12795,12795,'should filter module rules correctly',0.0,0,0,0
12796,12796,'should filter out components without examples if skipComponentsWithoutExample=true',0.0,0,0,0
12797,12797,'should filter section names',0.0,0,0,0
12798,12798,'should find calls to require in code',0.0,0,0,0
12799,12799,'should find children',0.0,0,0,0
12800,12800,'should find collapse children if they have collapse class too not only data-bs-parent',0.0,0,0,0
12801,12801,'should find config file automatically',0.0,0,0,0
12802,12802,'should find elements globally',0.0,0,0,0
12803,12803,'should find elements',0.0,0,0,0
12804,12804,'should find the rootElement if passed as a string',0.0,0,0,0
12805,12805,'should fire hide and hidden event without a clickEvent if event type is not click',0.0,0,0,0
12806,12806,'should fire hide and hidden events',0.0,0,0,0
12807,12807,"'should fire slid event with: direction, relatedTarget, from and to'",0.0,0,0,0
12808,12808,"'should fire slide event with: direction, relatedTarget, from and to'",0.0,0,0,0
12809,12809,'should flag itself as no longer active',0.0,0,0,0
12810,12810,'should focus next/previous element when using keyboard navigation',0.0,0,0,0
12811,12811,'should focus on trigger element after closing offcanvas',0.0,0,0,0
12812,12812,'should focus the trigger on hide',0.0,0,0,0
12813,12813,'should follow always transition',0.0,0,0,0
12814,12814,'should force SSR correctly for headers usage',0.0,0,0,0
12815,12815,'should force focus inside focus trap if it can',0.0,0,0,0
12816,12816,'should force focus on itself if there is no focusable content',0.0,0,0,0
12817,12817,'should format transitions properly',0.0,0,0,0
12818,12818,'should forward DOM attributes onto resulting HTML',0.0,0,0,0
12819,12819,'should forward an event to a service (dynamic)',0.0,0,0,0
12820,12820,'should forward an event to a service',0.0,0,0,0
12821,12821,'should forward events to a spawned actor when { autoForward: true }',0.0,0,0,0
12822,12822,'should forward events to services if autoForward: true before processing them (when sending batches)',0.0,0,0,0
12823,12823,'should forward events to services if autoForward: true before processing them',0.0,0,0,0
12824,12824,'should forward events to services if autoForward: true',0.0,0,0,0
12825,12825,'should forward slot properties to the toolbar',0.0,0,0,0
12826,12826,'should fully refetch the page after 30 seconds',0.0,0,0,0
12827,12827,'should genenerate rand when draft mode enabled',0.0,0,0,0
12828,12828,'should generate TypeScript user imports with absolute paths',0.0,0,0,0
12829,12829,'should generate TypeScript user imports with relative paths',0.0,0,0,0
12830,12830,'should generate app-build-manifest correctly',0.0,0,0,0
12831,12831,'should generate build traces correctly',0.0,0,0,0
12832,12832,'should generate correct client manifest for dynamic chunks',0.0,0,0,0
12833,12833,'should generate edge SSR manifests for Node.js',0.0,0,0,0
12834,12834,'should generate html response by streaming correctly',0.0,0,0,0
12835,12835,'should generate matchers correctly in middleware manifest',0.0,0,0,0
12836,12836,'should generate static data during build and use it',0.0,0,0,0
12837,12837,'should generate static paths of dynamic sitemap in production',0.0,0,0,0
12838,12838,'should generate the right number of paths',0.0,0,0,0
12839,12839,'should generate uid',0.0,0,0,0
12840,12840,'should generate unique path for image routes under group routes',0.0,0,0,0
12841,12841,'should generate user imports with absolute paths',0.0,0,0,0
12842,12842,'should generate user imports with relative paths',0.0,0,0,0
12843,12843,"'should get Plugin and execute the given method, when a click occurred on data-bs-dismiss=""PluginName""'",0.0,0,0,0
12844,12844,'should get correct result back from `can` immediately',0.0,0,0,0
12845,12845,'should get data attribute in kebab case',0.0,0,0,0
12846,12846,'should get element from data-bs-target',0.0,0,0,0
12847,12847,'should get element from href if no data-bs-target set',0.0,0,0,0
12848,12848,'should get elements from data-bs-target',0.0,0,0,0
12849,12849,"'should get elements in array, from href if no data-bs-target set'",0.0,0,0,0
12850,12850,'should get interval from data attribute on the active item element',0.0,0,0,0
12851,12851,'should get only bs-prefixed data attributes without bs namespace',0.0,0,0,0
12852,12852,'should get selector from data-bs-target',0.0,0,0,0
12853,12853,'should get selector from href if data-bs-target equal to #',0.0,0,0,0
12854,12854,'should get selector from href if no data-bs-target set',0.0,0,0,0
12855,12855,'should get shortest paths from array of paths',0.0,0,0,0
12856,12856,'should get simple paths from array of paths',0.0,0,0,0
12857,12857,'should get transition from element',0.0,0,0,0
12858,12858,'should give catchall params just to last layout',0.0,0,0,0
12859,12859,'should give optional catchall params just to last layout',0.0,0,0,0
12860,12860,'should globalize all components in isolated mode',0.0,0,0,0
12861,12861,'should globalize all components',0.0,0,0,0
12862,12862,'should go directly to the provided index',0.0,0,0,0
12863,12863,'should go to next item if right arrow key is pressed',0.0,0,0,0
12864,12864,'should go to previous item if left arrow key is pressed',0.0,0,0,0
12865,12865,'should go to the deep history (explicit)',0.0,0,0,0
12866,12866,'should go to the deepest history',0.0,0,0,0
12867,12867,'should go to the initial state when no history present (explicit)',0.0,0,0,0
12868,12868,'should go to the initial state when no history present',0.0,0,0,0
12869,12869,'should go to the most recently visited state (explicit)',0.0,0,0,0
12870,12870,'should go to the most recently visited state by a transient transition',0.0,0,0,0
12871,12871,'should go to the most recently visited state',0.0,0,0,0
12872,12872,'should go to the shallow history',0.0,0,0,0
12873,12873,'should guard against transition',0.0,0,0,0
12874,12874,'should guess a displayName for components that react-docgen was not able to recognize',0.0,0,0,0
12875,12875,'should handle 404 urls that start with basePath',0.0,0,0,0
12876,12876,'should handle :scope selectors',0.0,0,0,0
12877,12877,'should handle RSC with fetch',0.0,0,0,0
12878,12878,'should handle amp as the first parameter',0.0,0,0,0
12879,12879,'should handle amp as the last parameter',0.0,0,0,0
12880,12880,'should handle amp as the middle parameter',0.0,0,0,0
12881,12881,'should handle amp as the only parameter',0.0,0,0,0
12882,12882,'should handle api routes in pages',0.0,0,0,0
12883,12883,'should handle arbitrary props',0.0,0,0,0
12884,12884,'should handle as on next/link',0.0,0,0,0
12885,12885,'should handle basic actions correctly',0.0,0,0,0
12886,12886,'should handle catch-all segments link',0.0,0,0,0
12887,12887,'should handle circular structures in context',0.0,0,0,0
12888,12888,'should handle circular structures in events',0.0,0,0,0
12889,12889,'should handle config passed and toggle existing alert',0.0,0,0,0
12890,12890,'should handle config passed and toggle existing button',0.0,0,0,0
12891,12891,'should handle css modules imports inside transpiled modules',0.0,0,0,0
12892,12892,'should handle de-duping correctly',0.0,0,0,0
12893,12893,'should handle dynamicParams: false correctly',0.0,0,0,0
12894,12894,'should handle dynamicParams: true correctly',0.0,0,0,0
12895,12895,'should handle edge only routes',0.0,0,0,0
12896,12896,'should handle edge rsc hmr',0.0,0,0,0
12897,12897,'should handle event delegation',0.0,0,0,0
12898,12898,'should handle external async module libraries correctly',0.0,0,0,0
12899,12899,'should handle external css modules in pages',0.0,0,0,0
12900,12900,'should handle external css modules',0.0,0,0,0
12901,12901,'should handle external next/font',0.0,0,0,0
12902,12902,'should handle fallback only page correctly HTML',0.0,0,0,0
12903,12903,'should handle fallback only page correctly data',0.0,0,0,0
12904,12904,'should handle fill',0.0,0,0,0
12905,12905,'should handle getServerSideProps',0.0,0,0,0
12906,12906,'should handle global css imports inside transpiled modules',0.0,0,0,0
12907,12907,'should handle global scss imports inside transpiled modules',0.0,0,0,0
12908,12908,'should handle hash in initial url',0.0,0,0,0
12909,12909,'should handle hmr updates to the file icon',0.0,0,0,0
12910,12910,'should handle loader',0.0,0,0,0
12911,12911,'should handle loading eager',0.0,0,0,0
12912,12912,'should handle manifest.[ext] dynamic routes',0.0,0,0,0
12913,12913,'should handle metadataBase for urls resolved as only URL type',0.0,0,0,0
12914,12914,'should handle middleware rewrite with body correctly',0.0,0,0,0
12915,12915,'should handle more files than concurrency',0.0,0,0,0
12916,12916,'should handle mouseenter/mouseleave like the native counterpart',0.0,0,0,0
12917,12917,'should handle nested tabs',0.0,0,0,0
12918,12918,'should handle next.config.js rewrite with body correctly',0.0,0,0,0
12919,12919,'should handle next/dynamic in SSR correctly',0.0,0,0,0
12920,12920,'should handle next/dynamic in hydration correctly',0.0,0,0,0
12921,12921,'should handle next/link back to initially loaded page',0.0,0,0,0
12922,12922,'should handle no pagesDir',0.0,0,0,0
12923,12923,'should handle on-demand revalidate for fallback: blocking',0.0,0,0,0
12924,12924,'should handle on-demand revalidate for fallback: false',0.0,0,0,0
12925,12925,'should handle onclick',0.0,0,0,0
12926,12926,'should handle optional catch-all segments link',0.0,0,0,0
12927,12927,'should handle optional segments root',0.0,0,0,0
12928,12928,'should handle optional segments',0.0,0,0,0
12929,12929,'should handle partial-gen-params with default dynamicParams correctly',0.0,0,0,0
12930,12930,'should handle partial-gen-params with layout dynamicParams = false correctly',0.0,0,0,0
12931,12931,'should handle partial-gen-params with page dynamicParams = false correctly',0.0,0,0,0
12932,12932,'should handle preventdefault',0.0,0,0,0
12933,12933,'should handle priority',0.0,0,0,0
12934,12934,'should handle quality',0.0,0,0,0
12935,12935,'should handle redirect in an async page',0.0,0,0,0
12936,12936,'should handle redirect to a relative URL in a single pass',0.0,0,0,0
12937,12937,'should handle regular redirects',0.0,0,0,0
12938,12938,'should handle removed tabs',0.0,0,0,0
12939,12939,'should handle required segments root as not found',0.0,0,0,0
12940,12940,'should handle required segments',0.0,0,0,0
12941,12941,'should handle revalidating HTML correctly with blocking and seed',0.0,0,0,0
12942,12942,'should handle revalidating HTML correctly with blocking',0.0,0,0,0
12943,12943,'should handle revalidating HTML correctly',0.0,0,0,0
12944,12944,'should handle revalidating JSON correctly with blocking and seed',0.0,0,0,0
12945,12945,'should handle revalidating JSON correctly with blocking',0.0,0,0,0
12946,12946,'should handle revalidating JSON correctly',0.0,0,0,0
12947,12947,'should handle robots.[ext] dynamic routes',0.0,0,0,0
12948,12948,'should handle route handlers in app router',0.0,0,0,0
12949,12949,'should handle router.refresh without resetting state',0.0,0,0,0
12950,12950,'should handle scss modules imports inside transpiled modules',0.0,0,0,0
12951,12951,'should handle shallow navigation correctly (dynamic page)',0.0,0,0,0
12952,12952,'should handle shallow navigation correctly (non-dynamic page)',0.0,0,0,0
12953,12953,'should handle simultaneous orthogonal transitions',0.0,0,0,0
12954,12954,'should handle sitemap.[ext] dynamic routes',0.0,0,0,0
12955,12955,'should handle sizes',0.0,0,0,0
12956,12956,'should handle ssr: false in pages when appDir is enabled',0.0,0,0,0
12957,12957,'should handle static dynamic rewrite from middleware correctly',0.0,0,0,0
12958,12958,'should handle static rewrite from next.config.js correctly',0.0,0,0,0
12959,12959,'should handle streaming server components correctly',0.0,0,0,0
12960,12960,'should handle style',0.0,0,0,0
12961,12961,'should handle throw ENOENT correctly',0.0,0,0,0
12962,12962,'should handle trace files correctly for route groups (nodejs only)',0.0,0,0,0
12963,12963,'should handle typescript paths alias correctly',0.0,0,0,0
12964,12964,'should handle unicode search params',0.0,0,0,0
12965,12965,'should handle various kinds of exports correctly',0.0,0,0,0
12966,12966,'should hard navigate on 404 for data request',0.0,0,0,0
12967,12967,'should hard push',0.0,0,0,0
12968,12968,'should hard replace',0.0,0,0,0
12969,12969,'should have /favicon.ico as route',0.0,0,0,0
12970,12970,'should have 1 required parameter for constructor',0.0,0,0,0
12971,12971,'should have all parallel states represented in the state value (2)',0.0,0,0,0
12972,12972,'should have all parallel states represented in the state value',0.0,0,0,0
12973,12973,'should have basePath field on Router',0.0,0,0,0
12974,12974,'should have condition in the transition',0.0,0,0,0
12975,12975,'should have consistent query and params handling',0.0,0,0,0
12976,12976,'should have correct client references keys in manifest',0.0,0,0,0
12977,12977,'should have correct dynamic route params for middleware rewrite to dynamic route',0.0,0,0,0
12978,12978,'should have correct dynamic route params on client-transition to dynamic route',0.0,0,0,0
12979,12979,'should have correct env',0.0,0,0,0
12980,12980,'should have correct files in manifest',0.0,0,0,0
12981,12981,'should have correct head tags after hydration',0.0,0,0,0
12982,12982,'should have correct head tags from a fragment',0.0,0,0,0
12983,12983,'should have correct head tags in initial document',0.0,0,0,0
12984,12984,'should have correct href for a link to /',0.0,0,0,0
12985,12985,'should have correct href for a link',0.0,0,0,0
12986,12986,'should have correct preferredRegion values in manifest',0.0,0,0,0
12987,12987,'should have correct prerender-manifest entries',0.0,0,0,0
12988,12988,'should have correct query for pages/api dynamic',0.0,0,0,0
12989,12989,'should have correct query for pages/api',0.0,0,0,0
12990,12990,'should have correct query info for dynamic route after query hydration',0.0,0,0,0
12991,12991,'should have correct query values for rewrite to ssg page',0.0,0,0,0
12992,12992,'should have correct query/params on /[id]',0.0,0,0,0
12993,12993,'should have correct query/params on dynamic rewrite',0.0,0,0,0
12994,12994,'should have correct query/params on index',0.0,0,0,0
12995,12995,'should have correct query/params on rewrite',0.0,0,0,0
12996,12996,'should have correct req.url and query for direct visit dynamic page rewrite direct with internal query',0.0,0,0,0
12997,12997,'should have correct req.url and query for direct visit dynamic page rewrite direct',0.0,0,0,0
12998,12998,'should have correct req.url and query for direct visit dynamic page rewrite param',0.0,0,0,0
12999,12999,'should have correct req.url and query for direct visit dynamic page with query',0.0,0,0,0
13000,13000,'should have correct req.url and query for direct visit dynamic page',0.0,0,0,0
13001,13001,'should have correct req.url and query for direct visit',0.0,0,0,0
13002,13002,'should have correct route params for chained rewrite from middleware to config rewrite',0.0,0,0,0
13003,13003,'should have correct route params for rewrite from config dynamic route',0.0,0,0,0
13004,13004,'should have correct route params for rewrite from config non-dynamic route',0.0,0,0,0
13005,13005,'should have correct router paths on first load of /',0.0,0,0,0
13006,13006,'should have correct router paths on first load of /hello',0.0,0,0,0
13007,13007,'should have correct searchParams and params (client)',0.0,0,0,0
13008,13008,'should have correct searchParams and params (server)',0.0,0,0,0
13009,13009,'should have correct size in build output',0.0,0,0,0
13010,13010,'should have correct styles at /',0.0,0,0,0
13011,13011,'should have correct styles at /client',0.0,0,0,0
13012,13012,'should have correct values at /',0.0,0,0,0
13013,13013,'should have correct values at /client',0.0,0,0,0
13014,13014,'should have correct values in function config manifest',0.0,0,0,0
13015,13015,'should have current head tags from a _document getInitialProps',0.0,0,0,0
13016,13016,'should have data routes in routes-manifest',0.0,0,0,0
13017,13017,'should have default getComponentPathLine implementation',0.0,0,0,0
13018,13018,'should have default getExampleFilename implementation',0.0,0,0,0
13019,13019,'should have default title based on package.json name',0.0,0,0,0
13020,13020,'should have default values',0.0,0,0,0
13021,13021,'should have generated a static 404 page',0.0,0,0,0
13022,13022,'should have gsp in __NEXT_DATA__',0.0,0,0,0
13023,13023,'should have gssp in __NEXT_DATA__',0.0,0,0,0
13024,13024,'should have history on transient transitions',0.0,0,0,0
13025,13025,'should have icons as route',0.0,0,0,0
13026,13026,'should have init header for NextResponse.redirect',0.0,0,0,0
13027,13027,'should have initial actions computed without assign actions',0.0,0,0,0
13028,13028,'should have initial context updated by initial assign actions',0.0,0,0,0
13029,13029,'should have initial parallel states',0.0,0,0,0
13030,13030,'should have inner layers take precedence over outer layers',0.0,0,0,0
13031,13031,'should have kept existing activities',0.0,0,0,0
13032,13032,'should have kept same activities after self transition',0.0,0,0,0
13033,13033,'should have kept same activities',0.0,0,0,0
13034,13034,'should have logs from cache-handler',0.0,0,0,0
13035,13035,'should have no transitions for the initial state',0.0,0,0,0
13036,13036,'should have original req.url for /_next/data request dynamic page with query',0.0,0,0,0
13037,13037,'should have original req.url for /_next/data request dynamic page',0.0,0,0,0
13038,13038,'should have original req.url for /_next/data request with query',0.0,0,0,0
13039,13039,'should have original req.url for /_next/data request',0.0,0,0,0
13040,13040,'should have proper tree-shaking for known modules in CJS',0.0,0,0,0
13041,13041,'should have props for afterFiles rewrite to SSG page',0.0,0,0,0
13042,13042,'should have same title and page value on initial load',0.0,0,0,0
13043,13043,'should have same title and page value when navigating',0.0,0,0,0
13044,13044,'should have set-cookie header on enable',0.0,0,0,0
13045,13045,'should have set-cookie header with redirect location',0.0,0,0,0
13046,13046,'should have started deep initial activities',0.0,0,0,0
13047,13047,'should have started initial activities',0.0,0,0,0
13048,13048,'should have stopped after automatic transitions',0.0,0,0,0
13049,13049,'should have the canonical url pathname on rewrite',0.0,0,0,0
13050,13050,'should have the canonical url search params on rewrite',0.0,0,0,0
13051,13051,'should have the correct initial state',0.0,0,0,0
13052,13052,'should have the correct pathname',0.0,0,0,0
13053,13053,'should have the correct router parameters after it is ready',0.0,0,0,0
13054,13054,'should have the correct search params on middleware rewrite',0.0,0,0,0
13055,13055,'should have the correct search params on rewrite',0.0,0,0,0
13056,13056,'should have the correct search params',0.0,0,0,0
13057,13057,'should have the correct values',0.0,0,0,0
13058,13058,'should have the custom config in the manifest',0.0,0,0,0
13059,13059,'should have the origin (id) from the sending callback service',0.0,0,0,0
13060,13060,'should have the origin (id) from the sending machine service',0.0,0,0,0
13061,13061,'should have transitions for the sent event',0.0,0,0,0
13062,13062,'should have valid middleware field in manifest',0.0,0,0,0
13063,13063,'should have values from canonical url on rewrite',0.0,0,0,0
13064,13064,'should have warning',0.0,0,0,0
13065,13065,'should hide a collapsed element',0.0,0,0,0
13066,13066,'should hide a dropdown and destroy popper',0.0,0,0,0
13067,13067,'should hide a dropdown',0.0,0,0,0
13068,13068,'should hide a modal',0.0,0,0,0
13069,13069,'should hide a popover',0.0,0,0,0
13070,13070,'should hide a shown element if user click on backdrop',0.0,0,0,0
13071,13071,'should hide a shown element',0.0,0,0,0
13072,13072,'should hide a tooltip on mobile',0.0,0,0,0
13073,13073,'should hide a tooltip without animation',0.0,0,0,0
13074,13074,'should hide a tooltip',0.0,0,0,0
13075,13075,'should hide if esc is pressed and backdrop is static',0.0,0,0,0
13076,13076,'should hide if esc is pressed',0.0,0,0,0
13077,13077,'should hide multiple collapsed elements',0.0,0,0,0
13078,13078,'should hide scrollbar and reset it to its initial value - respecting css rules',0.0,0,0,0
13079,13079,'should hide scrollbar and reset it to its initial value',0.0,0,0,0
13080,13080,'should highlight code in description (fenced code block)',0.0,0,0,0
13081,13081,'should highlight code in description (regular code block)',0.0,0,0,0
13082,13082,'should highlight code with specified language',0.0,0,0,0
13083,13083,'should highlight code',0.0,0,0,0
13084,13084,"'should honor dynamic = ""force-static"" correctly (lazy)'",0.0,0,0,0
13085,13085,"'should honor dynamic = ""force-static"" correctly'",0.0,0,0,0
13086,13086,'should honor fetch cache correctly (edge)',0.0,0,0,0
13087,13087,'should honor fetch cache correctly',0.0,0,0,0
13088,13088,'should honor fetch cache in generateStaticParams',0.0,0,0,0
13089,13089,'should hydrate empty shell to handle server-side rendering errors',0.0,0,0,0
13090,13090,"'should hydrate properties, and make them configurable'",0.0,0,0,0
13091,13091,'should ignore certain Webpack plugins',0.0,0,0,0
13092,13092,'should ignore certain sections',0.0,0,0,0
13093,13093,'should ignore components option there’s sections options',0.0,0,0,0
13094,13094,'should ignore devtool settings in production',0.0,0,0,0
13095,13095,'should ignore error if unhandled error and not on strict mode (async)',0.0,0,0,0
13096,13096,'should ignore items without name',0.0,0,0,0
13097,13097,"'should ignore keyboard events for <input>s and <textarea>s within dropdown-menu, except for escape key'",0.0,0,0,0
13098,13098,'should ignore keyboard events if data-bs-keyboard=false',0.0,0,0,0
13099,13099,'should ignore keyboard events within <input>s and <textarea>s',0.0,0,0,0
13100,13100,'should ignore mouse events if data-bs-pause=false',0.0,0,0,0
13101,13101,'should ignore other inline styles when trying to restore body defaults ',0.0,0,0,0
13102,13102,'should ignore parallel state history',0.0,0,0,0
13103,13103,'should ignore parent state actions for same-parent substates',0.0,0,0,0
13104,13104,'should ignore transitionend events from nested elements',0.0,0,0,0
13105,13105,'should immediately execute a function when waitForTransition parameter is false',0.0,0,0,0
13106,13106,'should immediately reject for an actor in its final state that does not match the predicate',0.0,0,0,0
13107,13107,'should immediately resolve for an actor in its final state that matches the predicate',0.0,0,0,0
13108,13108,'should include all defined rules and no extra / undefined rules',0.0,0,0,0
13109,13109,'should include css imported in MDX pages',0.0,0,0,0
13110,13110,'should include css imported in client not-found.js',0.0,0,0,0
13111,13111,'should include css imported in client template.js',0.0,0,0,0
13112,13112,'should include css imported in error.js',0.0,0,0,0
13113,13113,'should include css imported in loading.js',0.0,0,0,0
13114,13114,'should include css imported in root not-found.js',0.0,0,0,0
13115,13115,'should include css imported in server not-found.js',0.0,0,0,0
13116,13116,'should include css imported in server template.js',0.0,0,0,0
13117,13117,'should include css modules and global css after page transition',0.0,0,0,0
13118,13118,'should include default og font files in file trace',0.0,0,0,0
13119,13119,'should include document html and body',0.0,0,0,0
13120,13120,'should include generated dynamic internal event in the provided parameter if schema.services is not provided',0.0,0,0,0
13121,13121,'should include init event in the provided parameter type if necessary',0.0,0,0,0
13122,13122,'should include it client-side',0.0,0,0,0
13123,13123,'should include it server-side',0.0,0,0,0
13124,13124,'should include layouts when no direct parent layout',0.0,0,0,0
13125,13125,'should include parent document when no direct parent layout',0.0,0,0,0
13126,13126,'should include root layout css for root not-found.js',0.0,0,0,0
13127,13127,'should indicate that it is not changed if initial state',0.0,0,0,0
13128,13128,'should infer an action object with narrowed event type',0.0,0,0,0
13129,13129,'should infer context correctly when actions are not specified',0.0,0,0,0
13130,13130,'should infer context type from `config.context` when there is no `schema.context`',0.0,0,0,0
13131,13131,'should infer inline function parameters when for a wildcard transition',0.0,0,0,0
13132,13132,'should infer inline function parameters when narrowing transition actions based on the event type',0.0,0,0,0
13133,13133,'should infer types from provided schema',0.0,0,0,0
13134,13134,"'should init carousels with data-bs-ride=""carousel"" on load'",0.0,0,0,0
13135,13135,'should initialize the service',0.0,0,0,0
13136,13136,'should inject dynamic metadata properly to head',0.0,0,0,0
13137,13137,'should insert preload tags for beforeInteractive and afterInteractive scripts',0.0,0,0,0
13138,13138,'should internally unsubscribe when the predicate immediately matches the current state',0.0,0,0,0
13139,13139,'should invoke a null actor if spawned outside of a service',0.0,0,0,0
13140,13140,'should invoke a service if other service gets stopped in subsequent microstep (#1180)',0.0,0,0,0
13141,13141,'should invoke actors (when sending batch)',0.0,0,0,0
13142,13142,'should invoke actors',0.0,0,0,0
13143,13143,'should join two paths',0.0,0,0,0
13144,13144,'should just create a button instance without calling toggle',0.0,0,0,0
13145,13145,'should just create an alert instance without calling close',0.0,0,0,0
13146,13146,'should just detect navbar on update',0.0,0,0,0
13147,13147,'should keep full inks as is',0.0,0,0,0
13148,13148,'should keep non data requests in their original shape',0.0,0,0,0
13149,13149,'should keep querystring on static page',0.0,0,0,0
13150,13150,'should keep reference to state instance after destructuring',0.0,0,0,0
13151,13151,'should keep the React router instance the same when changing the search params',0.0,0,0,0
13152,13152,'should keep the context type on the state after using `state.matches`',0.0,0,0,0
13153,13153,"'should keep tip hidden, if it was already hidden before'",0.0,0,0,0
13154,13154,'should keep used exports and react in a modern-apis page with JSX (client)',0.0,0,0,0
13155,13155,'should keep used exports in a modern-apis page (client)',0.0,0,0,0
13156,13156,'should keep used exports in a modern-apis page (server)',0.0,0,0,0
13157,13157,'should lazily create context for all interpreter instances created from the same machine template created by `withConfig`',0.0,0,0,0
13158,13158,'should leave alone array destructuring of hooks',0.0,0,0,0
13159,13159,'should leave alone array spread of hooks',0.0,0,0,0
13160,13160,'should leave url unchanged when no apm parameter is present',0.0,0,0,0
13161,13161,'should limit event type provided to a delay',0.0,0,0,0
13162,13162,'should limit event type provided to a guard',0.0,0,0,0
13163,13163,'should limit event type provided to a service',0.0,0,0,0
13164,13164,'should limit event type provided to an action',0.0,0,0,0
13165,13165,'should limit states with filter option',0.0,0,0,0
13166,13166,'should link correctly with next/link without mpa navigation to the page',0.0,0,0,0
13167,13167,'should list transitions',0.0,0,0,0
13168,13168,'should listen to an event',0.0,0,0,0
13169,13169,'should listen to events declared at top state',0.0,0,0,0
13170,13170,'should listen to multiple events',0.0,0,0,0
13171,13171,'should listen to multiple listeners',0.0,0,0,0
13172,13172,'should load a fast refresh page',0.0,0,0,0
13173,13173,'should load matches in client matchers correctly',0.0,0,0,0
13174,13174,'should load page when fetching a large amount of data',0.0,0,0,0
13175,13175,'should load scripts with defer in head',0.0,0,0,0
13176,13176,'should log a string',0.0,0,0,0
13177,13177,'should log an expression',0.0,0,0,0
13178,13178,'should log error in console and browser in dev mode',0.0,0,0,0
13179,13179,'should log error when href has repeated forward-slashes',0.0,0,0,0
13180,13180,'should log warning message with removed experimental config - complex key',0.0,0,0,0
13181,13181,'should log warning message with removed experimental config',0.0,0,0,0
13182,13182,'should lookup string actions in options',0.0,0,0,0
13183,13183,'should lowercase JSON keys',0.0,0,0,0
13184,13184,'should lowercase modifiers',0.0,0,0,0
13185,13185,'should maintain state after unhandled event',0.0,0,0,0
13186,13186,'should maintain the child state when targetless transition is handled by parent',0.0,0,0,0
13187,13187,"'should manage bs attribute `data-bs-popper`=""static"" when display set to static'",0.0,0,0,0
13188,13188,"'should manage bs attribute `data-bs-popper`=""static"" when dropdown is in navbar'",0.0,0,0,0
13189,13189,'should mark static contain metadata routes as edge functions',0.0,0,0,0
13190,13190,'should match a value from a pattern with the state (compound)',0.0,0,0,0
13191,13191,"'should match a value from a pattern with the state (compound, ancestor)'",0.0,0,0,0
13192,13192,'should match a value from a pattern with the state (parallel)',0.0,0,0,0
13193,13193,'should match a value from a pattern with the state (simple)',0.0,0,0,0
13194,13194,'should match a value from a pattern with the state value',0.0,0,0,0
13195,13195,'should match has cookie on client routing',0.0,0,0,0
13196,13196,'should match has cookie',0.0,0,0,0
13197,13197,'should match has header value',0.0,0,0,0
13198,13198,'should match has header',0.0,0,0,0
13199,13199,'should match has host',0.0,0,0,0
13200,13200,'should match has query on client routing',0.0,0,0,0
13201,13201,'should match has query',0.0,0,0,0
13202,13202,'should match hostname pattern with double asterisk',0.0,0,0,0
13203,13203,'should match hostname pattern with single asterisk at beginning',0.0,0,0,0
13204,13204,'should match hostname pattern with single asterisk at end',0.0,0,0,0
13205,13205,'should match hostname pattern with single asterisk by itself',0.0,0,0,0
13206,13206,'should match hostname pattern with single asterisk in middle',0.0,0,0,0
13207,13207,'should match initialState',0.0,0,0,0
13208,13208,'should match literal hostname',0.0,0,0,0
13209,13209,'should match literal protocol and hostname',0.0,0,0,0
13210,13210,"'should match literal protocol, hostname, no port'",0.0,0,0,0
13211,13211,"'should match literal protocol, hostname, port 42'",0.0,0,0,0
13212,13212,"'should match literal protocol, hostname, port, pathname'",0.0,0,0,0
13213,13213,'should match many requires in the same line correctly',0.0,0,0,0
13214,13214,'should match missing header correctly',0.0,0,0,0
13215,13215,'should match missing query correctly',0.0,0,0,0
13216,13216,'should match more specific route along with dynamic routes',0.0,0,0,0
13217,13217,'should match parallel routes in route groups',0.0,0,0,0
13218,13218,'should match parallel routes',0.0,0,0,0
13219,13219,'should match pathname pattern with double asterisk',0.0,0,0,0
13220,13220,'should match pathname pattern with single asterisk at the beginning',0.0,0,0,0
13221,13221,'should match pathname pattern with single asterisk at the end',0.0,0,0,0
13222,13222,'should match pathname pattern with single asterisk by itself',0.0,0,0,0
13223,13223,'should match pathname pattern with single asterisk in the middle',0.0,0,0,0
13224,13224,'should match require invocations',0.0,0,0,0
13225,13225,'should match simple strings and nothing else',0.0,0,0,0
13226,13226,'should match source path',0.0,0,0,0
13227,13227,'should match transition states',0.0,0,0,0
13228,13228,'should merge Create React App Webpack config',0.0,0,0,0
13229,13229,'should merge an object and a function',0.0,0,0,0
13230,13230,'should merge cookies from middleware and API routes correctly',0.0,0,0,0
13231,13231,'should merge cookies from middleware and edge API routes correctly',0.0,0,0,0
13232,13232,'should merge default editorConfig with options provided by the user',0.0,0,0,0
13233,13233,'should merge two objects',0.0,0,0,0
13234,13234,'should merge user webpack config',0.0,0,0,0
13235,13235,'should merge webpackConfig but ignore output section',0.0,0,0,0
13236,13236,'should merge webpackConfig config option as a function',0.0,0,0,0
13237,13237,'should merge webpackConfig config option',0.0,0,0,0
13238,13238,'should minify css',0.0,0,0,0
13239,13239,'should mix/match string state values and object state values',0.0,0,0,0
13240,13240,'should narrow context using typestates',0.0,0,0,0
13241,13241,'should narrow down the event type in the expression',0.0,0,0,0
13242,13242,'should narrow events down to the specified types',0.0,0,0,0
13243,13243,'should navigate an absolute local url with basePath',0.0,0,0,0
13244,13244,'should navigate an absolute local url without basePath',0.0,0,0,0
13245,13245,'should navigate an absolute url',0.0,0,0,0
13246,13246,'should navigate back correctly to a dynamic route',0.0,0,0,0
13247,13247,'should navigate between pages successfully',0.0,0,0,0
13248,13248,'should navigate client side correctly',0.0,0,0,0
13249,13249,'should navigate correctly from another',0.0,0,0,0
13250,13250,'should navigate correctly from index',0.0,0,0,0
13251,13251,'should navigate correctly with matchers',0.0,0,0,0
13252,13252,'should navigate to /404 correctly client-side',0.0,0,0,0
13253,13253,'should navigate to /_error correctly client-side',0.0,0,0,0
13254,13254,'should navigate to /about',0.0,0,0,0
13255,13255,'should navigate to a normal page and back',0.0,0,0,0
13256,13256,'should navigate to catch-all page with brackets in param as object',0.0,0,0,0
13257,13257,'should navigate to catch-all page with brackets in param as string',0.0,0,0,0
13258,13258,'should navigate to dynamic page with brackets in param as object',0.0,0,0,0
13259,13259,'should navigate to dynamic page with brackets in param as string',0.0,0,0,0
13260,13260,'should navigate to external site and back',0.0,0,0,0
13261,13261,'should navigate to index page with getStaticProps',0.0,0,0,0
13262,13262,'should navigate to nested pages',0.0,0,0,0
13263,13263,'should navigate to pages dynamic route from pages page if it overlaps with an app page',0.0,0,0,0
13264,13264,'should navigate to static path correctly',0.0,0,0,0
13265,13265,'should navigate to the page without refresh',0.0,0,0,0
13266,13266,'should navigate when prefetch is false',0.0,0,0,0
13267,13267,'should navigate with a link with prefetch=false',0.0,0,0,0
13268,13268,'should never show fallback for page not in getStaticPaths when blocking',0.0,0,0,0
13269,13269,'should normalize data requests into page requests',0.0,0,0,0
13270,13270,'should normalize data',0.0,0,0,0
13271,13271,'should normalize json data',0.0,0,0,0
13272,13272,'should not add anything as a global variable if there is no component name',0.0,0,0,0
13273,13273,'should not add empty Markdown chunks',0.0,0,0,0
13274,13274,'should not add event listener if the event is not a string',0.0,0,0,0
13275,13275,'should not add fade class',0.0,0,0,0
13276,13276,'should not add header with basePath when set to false',0.0,0,0,0
13277,13277,'should not add header without basePath without disabling',0.0,0,0,0
13278,13278,'should not add the aria-label attribute if the attribute already exists',0.0,0,0,0
13279,13279,'should not add the aria-label attribute if the element has text content',0.0,0,0,0
13280,13280,'should not add touch event listeners if touch = false',0.0,0,0,0
13281,13281,'should not add touch event listeners if touch is not supported',0.0,0,0,0
13282,13282,'should not add touch event listeners if touch supported = false',0.0,0,0,0
13283,13283,'should not adjust the inline body padding when it does not overflow',0.0,0,0,0
13284,13284,"'should not adjust the inline body padding when it does not overflow, even on a scaled display'",0.0,0,0,0
13285,13285,'should not adjust the inline margin and padding of sticky and fixed elements when element do not have full width',0.0,0,0,0
13286,13286,'should not affect css orders during HMR',0.0,0,0,0
13287,13287,'should not allow a machine service returning a different type than the explicitly declared one in the given schema.services',0.0,0,0,0
13288,13288,'should not allow a promise service returning a different type than the explicitly declared one in the given schema.services',0.0,0,0,0
13289,13289,'should not allow an invalid tag with `hasTag`',0.0,0,0,0
13290,13290,'should not allow an unknown action',0.0,0,0,0
13291,13291,'should not allow an unknown delay',0.0,0,0,0
13292,13292,'should not allow an unknown guard',0.0,0,0,0
13293,13293,'should not allow an unknown service',0.0,0,0,0
13294,13294,'should not allow invalid object `matches`',0.0,0,0,0
13295,13295,'should not allow invalid string `matches`',0.0,0,0,0
13296,13296,'should not allow pinch with touch events',0.0,0,0,0
13297,13297,'should not allow to create a service out of a machine with missing implementations',0.0,0,0,0
13298,13298,'should not allow using actions if creators have not been configured',0.0,0,0,0
13299,13299,'should not allow using events if creators have not been configured',0.0,0,0,0
13300,13300,'should not announce the initital title',0.0,0,0,0
13301,13301,"'should not append the backdrop html if it is not ""shown""'",0.0,0,0,0
13302,13302,'should not apply client router filter on shallow',0.0,0,0,0
13303,13303,'should not apply rsc syntax checks in pages/api',0.0,0,0,0
13304,13304,'should not apply trailing slash on load on client',0.0,0,0,0
13305,13305,'should not apply trailing slash redirect (with slash)',0.0,0,0,0
13306,13306,'should not apply trailing slash redirect (without slash)',0.0,0,0,0
13307,13307,'should not apply trailing slash to links on client',0.0,0,0,0
13308,13308,'should not auto hide if focus leaves but mouse pointer remains inside',0.0,0,0,0
13309,13309,'should not auto hide if mouse pointer leaves but focus remains inside',0.0,0,0,0
13310,13310,'should not bailout when not using searchParams',0.0,0,0,0
13311,13311,'should not be called if element argument is null',0.0,0,0,0
13312,13312,'should not be changed on unknown transitions',0.0,0,0,0
13313,13313,'should not break HMR when CSS is imported in a server component',0.0,0,0,0
13314,13314,'should not break on circular objects',0.0,0,0,0
13315,13315,'should not bundle `ImageResponse` into the page worker',0.0,0,0,0
13316,13316,'should not cache correctly with POST method request init',0.0,0,0,0
13317,13317,'should not cache non-ok statusCode',0.0,0,0,0
13318,13318,"'should not call delay callbacks if it is not ""shown""'",0.0,0,0,0
13319,13319,'should not call next when the page is not visible',0.0,0,0,0
13320,13320,'should not call show method',0.0,0,0,0
13321,13321,'should not call toggle on disabled elements',0.0,0,0,0
13322,13322,'should not cause an infinite loop when forwarding to undefined',0.0,0,0,0
13323,13323,'should not cause error when removing loading.js',0.0,0,0,0
13324,13324,'should not change tab tabpanels descendants on accordion',0.0,0,0,0
13325,13325,'should not clear console on initial mount',0.0,0,0,0
13326,13326,'should not clear selection if above the first section and first section is at the top',0.0,0,0,0
13327,13327,'should not clone classes',0.0,0,0,0
13328,13328,"'should not close dropdown by clicking inside or outside the dropdown menu when it has data-attribute `data-bs-auto-close=""false""`'",0.0,0,0,0
13329,13329,'should not close modal when clicking on an element removed from modal content',0.0,0,0,0
13330,13330,'should not close modal when clicking on modal-content',0.0,0,0,0
13331,13331,'should not close modal when clicking outside of modal-content if backdrop = false',0.0,0,0,0
13332,13332,'should not close modal when clicking outside of modal-content if backdrop = static',0.0,0,0,0
13333,13333,'should not close modal when escape key is pressed with keyboard = false',0.0,0,0,0
13334,13334,'should not close the dropdown if the user clicks on a text field within dropdown-menu',0.0,0,0,0
13335,13335,'should not close the dropdown if the user clicks on a textarea within dropdown-menu',0.0,0,0,0
13336,13336,'should not collapse the dropdown when clicking a select option nested in the dropdown',0.0,0,0,0
13337,13337,'should not consume server.js file extension',0.0,0,0,0
13338,13338,'should not contain IsolateButton in toolbars if pagePerSection is true',0.0,0,0,0
13339,13339,'should not contain _rsc query while navigating from app to pages',0.0,0,0,0
13340,13340,'should not contain _rsc query while navigating from pages to app',0.0,0,0,0
13341,13341,'should not contain headers already sent error',0.0,0,0,0
13342,13342,'should not contain installed react/react-dom version in client chunks',0.0,0,0,0
13343,13343,'should not contain pages css in app dir page',0.0,0,0,0
13344,13344,'should not continue if the provided is the same compare to the current one',0.0,0,0,0
13345,13345,'should not convert URLs to auto links',0.0,0,0,0
13346,13346,'should not crash for class declarations',0.0,0,0,0
13347,13347,'should not crash on child machine sync completion during self-initialization',0.0,0,0,0
13348,13348,'should not crash on child observable sync completion during self-initialization',0.0,0,0,0
13349,13349,'should not crash on child promise-like sync completion during self-initialization',0.0,0,0,0
13350,13350,'should not crash when registering machine with very deep context when serializer manages to replace it',0.0,0,0,0
13351,13351,'should not crash without optional `options` parameter being provided',0.0,0,0,0
13352,13352,'should not create duplicate link tags during HMR',0.0,0,0,0
13353,13353,'should not create new root layout when nested (optional)',0.0,0,0,0
13354,13354,'should not defer events after initialization',0.0,0,0,0
13355,13355,'should not do additional pushState when already on the page',0.0,0,0,0
13356,13356,'should not double-serialize invoke transitions',0.0,0,0,0
13357,13357,'should not drop unused exports by default in a page',0.0,0,0,0
13358,13358,'should not drop unused exports by default',0.0,0,0,0
13359,13359,'should not effect metadata images convention like files under pages directory',0.0,0,0,0
13360,13360,'should not elide import',0.0,0,0,0
13361,13361,'should not emit metadata files into bad paths',0.0,0,0,0
13362,13362,'should not enable smoothScroll',0.0,0,0,0
13363,13363,'should not enter exited state when targeting its ancestor and when its former descendant gets selected through initial state',0.0,0,0,0
13364,13364,'should not enter exited state when targeting its ancestor and when its latter descendant gets selected through initial state',0.0,0,0,0
13365,13365,'should not equal node with different html attribute value',0.0,0,0,0
13366,13366,'should not equal node with different nonce value',0.0,0,0,0
13367,13367,'should not error if the backdrop no longer has a parent',0.0,0,0,0
13368,13368,'should not error on /object in prod',0.0,0,0,0
13369,13369,'should not error on /string in prod',0.0,0,0,0
13370,13370,'should not error when flushing cache files',0.0,0,0,0
13371,13371,'should not error when trying to show a tooltip that has been removed from the dom',0.0,0,0,0
13372,13372,'should not error with dynamic server usage with force-static',0.0,0,0,0
13373,13373,'should not error with force-dynamic and catch-all routes',0.0,0,0,0
13374,13374,'should not error with generateStaticParams and authed data on revalidate',0.0,0,0,0
13375,13375,'should not error with generateStaticParams and dynamic data',0.0,0,0,0
13376,13376,'should not escape targetless child state nodes',0.0,0,0,0
13377,13377,'should not execute a function a second time after a computed CSS transition duration and if a transitionend event has already been dispatched',0.0,0,0,0
13378,13378,'should not execute actions if execute is false',0.0,0,0,0
13379,13379,'should not execute actions if execute is true (default)',0.0,0,0,0
13380,13380,'should not execute actions of the last known non-initial state when re-starting a service',0.0,0,0,0
13381,13381,'should not execute assignments',0.0,0,0,0
13382,13382,'should not execute if arg is not function & return default argument',0.0,0,0,0
13383,13383,'should not execute transitions after being stopped',0.0,0,0,0
13384,13384,'should not expose action content in sourcemaps',0.0,0,0,0
13385,13385,'should not fail to emit',0.0,0,0,0
13386,13386,'should not fail to update incremental cache',0.0,0,0,0
13387,13387,'should not fallback before invalid JSON is returned from getStaticProps when blocking fallback',0.0,0,0,0
13388,13388,'should not fetch again when a static page was prefetched when navigating to it twice',0.0,0,0,0
13389,13389,'should not fetch again when a static page was prefetched',0.0,0,0,0
13390,13390,'should not fetch data on mount',0.0,0,0,0
13391,13391,'should not fetch prerender data on mount',0.0,0,0,0
13392,13392,'should not fire closed event',0.0,0,0,0
13393,13393,'should not fire hidden event',0.0,0,0,0
13394,13394,'should not fire hidden when hide is prevented',0.0,0,0,0
13395,13395,'should not fire shown event when show is prevented',0.0,0,0,0
13396,13396,'should not fire shown event',0.0,0,0,0
13397,13397,'should not fire shown when show is prevented',0.0,0,0,0
13398,13398,'should not fire shown when tab has disabled attribute',0.0,0,0,0
13399,13399,'should not fire shown when tab has disabled class',0.0,0,0,0
13400,13400,'should not fire shown when tab is already active',0.0,0,0,0
13401,13401,'should not fire slid when slide is prevented',0.0,0,0,0
13402,13402,'should not focus on opened tab',0.0,0,0,0
13403,13403,"'should not focus on trigger element after closing offcanvas, if it is not visible'",0.0,0,0,0
13404,13404,'should not focus the trigger if the modal is not shown',0.0,0,0,0
13405,13405,'should not focus the trigger if the modal is not visible',0.0,0,0,0
13406,13406,'should not forward events to a spawned actor by default',0.0,0,0,0
13407,13407,'should not forward events to a spawned actor when { autoForward: false }',0.0,0,0,0
13408,13408,'should not generate rand when draft mode disabled during next start',0.0,0,0,0
13409,13409,'should not have JS preload links',0.0,0,0,0
13410,13410,'should not have actions for unhandled events (deep)',0.0,0,0,0
13411,13411,'should not have actions for unhandled events (shallow)',0.0,0,0,0
13412,13412,'should not have any history',0.0,0,0,0
13413,13413,'should not have attempted sending invalid payload',0.0,0,0,0
13414,13414,'should not have cache tags header for non-minimal mode',0.0,0,0,0
13415,13415,'should not have conflicts for similar pattern page paths between app and pages',0.0,0,0,0
13416,13416,'should not have duplicate config warnings',0.0,0,0,0
13417,13417,'should not have duplicate preload tags on navigation',0.0,0,0,0
13418,13418,'should not have eslint warnings when no eslint config',0.0,0,0,0
13419,13419,'should not have experimental undici warning',0.0,0,0,0
13420,13420,'should not have gsp in __NEXT_DATA__ for non-GSP page',0.0,0,0,0
13421,13421,'should not have gssp in __NEXT_DATA__ for non-GSSP page',0.0,0,0,0
13422,13422,'should not have prefetch error for static path',0.0,0,0,0
13423,13423,'should not have trailing slash redirects in manifest',0.0,0,0,0
13424,13424,'should not have un-necessary data request on rewrite',0.0,0,0,0
13425,13425,'should not have unexpected errors',0.0,0,0,0
13426,13426,'should not have warning',0.0,0,0,0
13427,13427,'should not hide a dropdown if hide event is prevented',0.0,0,0,0
13428,13428,'should not hide a dropdown if the element contains .disabled',0.0,0,0,0
13429,13429,'should not hide a dropdown if the element is disabled',0.0,0,0,0
13430,13430,'should not hide a dropdown if the menu is not shown',0.0,0,0,0
13431,13431,'should not hide a modal if hide is prevented',0.0,0,0,0
13432,13432,'should not hide a tooltip if hide event is prevented',0.0,0,0,0
13433,13433,'should not hide if esc is not pressed',0.0,0,0,0
13434,13434,'should not hide if esc is pressed but with keyboard = false',0.0,0,0,0
13435,13435,'should not hide if user clicks on static backdrop',0.0,0,0,0
13436,13436,'should not hide tooltip if leave event occurs and enter event occurs within the hide delay',0.0,0,0,0
13437,13437,'should not hide tooltip if leave event occurs and interaction remains inside trigger',0.0,0,0,0
13438,13438,'should not hoist meta[itemProp] to head',0.0,0,0,0
13439,13439,'should not include edge api routes and edge ssr routes into dev middleware manifest',0.0,0,0,0
13440,13440,'should not include parent when not in parent directory',0.0,0,0,0
13441,13441,"'should not initialize and add element record to Data (caching), if argument `element` is not an HTML element'",0.0,0,0,0
13442,13442,'should not invoke a service if it gets stopped immediately by transitioning away in microstep',0.0,0,0,0
13443,13443,'should not join two paths with mismatched source/target states',0.0,0,0,0
13444,13444,'should not log 404 errors in ipc server',0.0,0,0,0
13445,13445,'should not log warning message without experimental config',0.0,0,0,0
13446,13446,'should not match other occurrences of require',0.0,0,0,0
13447,13447,'should not match',0.0,0,0,0
13448,13448,'should not misplace the backslash',0.0,0,0,0
13449,13449,'should not mix component cache when navigating between dynamic routes',0.0,0,0,0
13450,13450,'should not mix up bindings',0.0,0,0,0
13451,13451,'should not not fail when Wrapper wasn’t mounted',0.0,0,0,0
13452,13452,'should not on-demand revalidate for fallback: blocking with onlyGenerated if not generated',0.0,0,0,0
13453,13453,'should not open dropdown if escape key was pressed on the toggle',0.0,0,0,0
13454,13454,'should not output trace files for edge routes',0.0,0,0,0
13455,13455,'should not overflow when clicking outside of modal-content if backdrop = static',0.0,0,0,0
13456,13456,'should not overlap resolved state configuration in state resolution',0.0,0,0,0
13457,13457,'should not overlap with a instrumentation page',0.0,0,0,0
13458,13458,'should not override context if not defined',0.0,0,0,0
13459,13459,'should not overwrite NODE_ENV',0.0,0,0,0
13460,13460,'should not owerwrite user DefinePlugin',0.0,0,0,0
13461,13461,'should not perform full page navigation on router.refresh()',0.0,0,0,0
13462,13462,'should not preconnect when css is used but no fonts',0.0,0,0,0
13463,13463,'should not prefetch for a bot user agent',0.0,0,0,0
13464,13464,'should not prefetch non-SSG routes',0.0,0,0,0
13465,13465,'should not prefetch the page at all',0.0,0,0,0
13466,13466,"'should not prevent default when a click occurred on data-bs-dismiss=""modal"" where tagName is DIFFERENT than <a> or <area>'",0.0,0,0,0
13467,13467,'should not prevent event for input',0.0,0,0,0
13468,13468,'should not prevent keydown if key is not ARROW_LEFT or ARROW_RIGHT',0.0,0,0,0
13469,13469,'should not print warning when new typescript version is used with next build',0.0,0,0,0
13470,13470,'should not process data if `activeTarget` is same as given target',0.0,0,0,0
13471,13471,'should not process element without target',0.0,0,0,0
13472,13472,'should not propagate escape key events if dropdown is open',0.0,0,0,0
13473,13473,'should not provide the state from initial state',0.0,0,0,0
13474,13474,"'should not put data-attribute if element doesn\'t have the proper style property, should just remove style property if element didn\'t had one'",0.0,0,0,0
13475,13475,'should not queue multiple callbacks when clicking outside of modal-content and backdrop = static',0.0,0,0,0
13476,13476,'should not re create a carousel',0.0,0,0,0
13477,13477,'should not re create a collapse',0.0,0,0,0
13478,13478,'should not re create a dropdown',0.0,0,0,0
13479,13479,'should not re create a modal',0.0,0,0,0
13480,13480,'should not re create a popover',0.0,0,0,0
13481,13481,'should not re create a scrollspy',0.0,0,0,0
13482,13482,'should not re create a tab',0.0,0,0,0
13483,13483,'should not re create a toast',0.0,0,0,0
13484,13484,'should not re create a tooltip',0.0,0,0,0
13485,13485,'should not re create an offcanvas',0.0,0,0,0
13486,13486,'should not re-call getServerSideProps when updating query',0.0,0,0,0
13487,13487,'should not re-call getStaticProps when updating query',0.0,0,0,0
13488,13488,'should not re-execute exit/entry actions for transitions with undefined targets',0.0,0,0,0
13489,13489,'should not re-execute the script when re-rendering with CSP header',0.0,0,0,0
13490,13490,'should not read other cookies when draft mode disabled during next start',0.0,0,0,0
13491,13491,'should not reassign `process.env`',0.0,0,0,0
13492,13492,'should not recall previous actions',0.0,0,0,0
13493,13493,'should not recreate a new modal',0.0,0,0,0
13494,13494,'should not redirect with basePath when set to false',0.0,0,0,0
13495,13495,'should not redirect without basePath without disabling',0.0,0,0,0
13496,13496,'should not reinitialize a started service',0.0,0,0,0
13497,13497,'should not reinvoke root-level invocations',0.0,0,0,0
13498,13498,'should not reject immediately when passing Infinity as timeout',0.0,0,0,0
13499,13499,'should not reload the page',0.0,0,0,0
13500,13500,'should not remove a listener',0.0,0,0,0
13501,13501,'should not remove alert if close event is prevented',0.0,0,0,0
13502,13502,'should not remove all comments',0.0,0,0,0
13503,13503,'should not remove extra named export function declarations',0.0,0,0,0
13504,13504,'should not remove extra named export variable declarations',0.0,0,0,0
13505,13505,'should not remove fade class if no active pane is present',0.0,0,0,0
13506,13506,'should not remove quotes in the middle of the string',0.0,0,0,0
13507,13507,'should not render a code editor if noeditor option passed in example settings',0.0,0,0,0
13508,13508,'should not render a example with unknown type',0.0,0,0,0
13509,13509,'should not render component in isolation mode by default',0.0,0,0,0
13510,13510,'should not render components list if not defined',0.0,0,0,0
13511,13511,'should not render heading as deprecated by default',0.0,0,0,0
13512,13512,'should not render if image file is not specified',0.0,0,0,0
13513,13513,'should not render ignored props',0.0,0,0,0
13514,13514,'should not render noscript',0.0,0,0,0
13515,13515,'should not render section in isolation mode by default',0.0,0,0,0
13516,13516,'should not render sections if not defined',0.0,0,0,0
13517,13517,'should not render the @children slot when the @slot is not found',0.0,0,0,0
13518,13518,'should not request a path prefixed with default locale',0.0,0,0,0
13519,13519,'should not require all implementations when creating machine',0.0,0,0,0
13520,13520,'should not require implementations when creating machine using `createMachine`',0.0,0,0,0
13521,13521,'should not require implementations when creating machine using `model.createMachine`',0.0,0,0,0
13522,13522,'should not rerender layout when navigating between routes in the same layout',0.0,0,0,0
13523,13523,'should not restart activities from a compound state',0.0,0,0,0
13524,13524,'should not retain previous history',0.0,0,0,0
13525,13525,'should not return data for fallback: false and missing dynamic page',0.0,0,0,0
13526,13526,'should not return disabled elements',0.0,0,0,0
13527,13527,'should not return invisible elements',0.0,0,0,0
13528,13528,'should not return jQuery if not present',0.0,0,0,0
13529,13529,'should not return jQuery object when present if data-bs-no-jquery',0.0,0,0,0
13530,13530,'should not revalidate / when revalidate is not used',0.0,0,0,0
13531,13531,'should not revalidate when set to false in blocking fallback mode',0.0,0,0,0
13532,13532,'should not revalidate when set to false',0.0,0,0,0
13533,13533,'should not rewrite with basePath when set to false',0.0,0,0,0
13534,13534,'should not rewrite without basePath without disabling',0.0,0,0,0
13535,13535,'should not run PnP test for older node versions',0.0,0,0,0
13536,13536,'should not run for next deploy',0.0,0,0,0
13537,13537,'should not run middleware for on-demand revalidate',0.0,0,0,0
13538,13538,'should not scroll to hash when scroll={false} is set',0.0,0,0,0
13539,13539,'should not scroll to top of document if page in viewport',0.0,0,0,0
13540,13540,'should not scroll when called alone',0.0,0,0,0
13541,13541,'should not scroll when the top of the page is in the viewport',0.0,0,0,0
13542,13542,'should not select wildcard for eventless transition (array `.on`)',0.0,0,0,0
13543,13543,'should not select wildcard for eventless transition (with `always`)',0.0,0,0,0
13544,13544,'should not select wildcard for eventless transition',0.0,0,0,0
13545,13545,'should not serve .client.js as a path',0.0,0,0,0
13546,13546,'should not serve .server.js as a path',0.0,0,0,0
13547,13547,'should not serve app path with underscore',0.0,0,0,0
13548,13548,'should not serve when layout is provided but no folder index',0.0,0,0,0
13549,13549,'should not setup debug logger in non-verbose mode',0.0,0,0,0
13550,13550,'should not share edge workers',0.0,0,0,0
13551,13551,'should not share flight data between requests',0.0,0,0,0
13552,13552,'should not show a disabled tooltip',0.0,0,0,0
13553,13553,'should not show a dropdown if show event is prevented',0.0,0,0,0
13554,13554,'should not show a dropdown if the element contains .disabled',0.0,0,0,0
13555,13555,'should not show a dropdown if the element is disabled',0.0,0,0,0
13556,13556,'should not show a dropdown if the menu is shown',0.0,0,0,0
13557,13557,'should not show a tooltip if show.bs.tooltip is prevented',0.0,0,0,0
13558,13558,'should not show deopted into client rendering warning',0.0,0,0,0
13559,13559,'should not show error for accessing res after gssp returns',0.0,0,0,0
13560,13560,'should not show error for invalid JSON returned from getServerSideProps',0.0,0,0,0
13561,13561,'should not show error for invalid JSON returned from getStaticProps on CST',0.0,0,0,0
13562,13562,'should not show error for invalid JSON returned from getStaticProps on SSR',0.0,0,0,0
13563,13563,'should not show error overlay for non conflict pages under app or pages dir',0.0,0,0,0
13564,13564,'should not show fallback for page in getStaticPaths when blocking',0.0,0,0,0
13565,13565,'should not show fallback for page in getStaticPaths',0.0,0,0,0
13566,13566,'should not show tooltip if leave event occurs before delay expires',0.0,0,0,0
13567,13567,'should not show warning from url prop being returned',0.0,0,0,0
13568,13568,'should not slide if arrow key is pressed and carousel is sliding',0.0,0,0,0
13569,13569,'should not slide if the carousel is sliding',0.0,0,0,0
13570,13570,'should not slide when swiping and carousel is sliding',0.0,0,0,0
13571,13571,'should not smoothScroll to element if it not handles a scrollspy section',0.0,0,0,0
13572,13572,'should not spawn actors when determining if an event is accepted',0.0,0,0,0
13573,13573,'should not start cycling if `ride`!==`carousel`',0.0,0,0,0
13574,13574,'should not start dev server on require',0.0,0,0,0
13575,13575,'should not start services only once when using withContext',0.0,0,0,0
13576,13576,'should not stop router.push() from scrolling',0.0,0,0,0
13577,13577,'should not supply query values to params in /_next/data request',0.0,0,0,0
13578,13578,'should not supply query values to params or useRouter dynamic page SSR',0.0,0,0,0
13579,13579,'should not supply query values to params or useRouter non-dynamic page SSR',0.0,0,0,0
13580,13580,'should not sync spawned actor state (default)',0.0,0,0,0
13581,13581,'should not sync spawned actor state when { sync: false }',0.0,0,0,0
13582,13582,'should not take care of disallowed data attributes',0.0,0,0,0
13583,13583,'should not take count to not visible sections',0.0,0,0,0
13584,13584,'should not throw Dynamic Server Usage error when using generateStaticParams with draftMode',0.0,0,0,0
13585,13585,'should not throw an error for unimplemented events',0.0,0,0,0
13586,13586,'should not throw an error if an event is sent to an uninitialized interpreter (default options)',0.0,0,0,0
13587,13587,'should not throw an error if an event is sent to an uninitialized interpreter if { deferEvents: true }',0.0,0,0,0
13588,13588,'should not throw any errors when re-fetching the route info',0.0,0,0,0
13589,13589,'should not throw error for on-demand revalidate for SSR path',0.0,0,0,0
13590,13590,'should not throw error running hide if popper hasn\'t been shown',0.0,0,0,0
13591,13591,'should not throw error',0.0,0,0,0
13592,13592,'should not throw for built-in events',0.0,0,0,0
13593,13593,'should not throw hidden.bs.dropdown event',0.0,0,0,0
13594,13594,'should not throw if process function returns value for undefined required field',0.0,0,0,0
13595,13595,'should not throw shown.bs.dropdown event',0.0,0,0,0
13596,13596,'should not throw when a condition is present',0.0,0,0,0
13597,13597,'should not throw when parsing a script',0.0,0,0,0
13598,13598,'should not throw when query contains special characters',0.0,0,0,0
13599,13599,'should not toggle a dropdown if show event is prevented',0.0,0,0,0
13600,13600,'should not toggle a dropdown if the element contains .disabled',0.0,0,0,0
13601,13601,'should not toggle a dropdown if the element is disabled',0.0,0,0,0
13602,13602,'should not toggle a dropdown if the menu is shown',0.0,0,0,0
13603,13603,'should not transform css',0.0,0,0,0
13604,13604,'should not transition from illegal events',0.0,0,0,0
13605,13605,'should not transition if condition based on event is not met',0.0,0,0,0
13606,13606,'should not transition if no condition is met',0.0,0,0,0
13607,13607,'should not transition if state value matches current state value',0.0,0,0,0
13608,13608,'should not transition if string state path does not match current state value',0.0,0,0,0
13609,13609,'should not transition states for illegal transitions',0.0,0,0,0
13610,13610,'should not trap focus if focus equal to false',0.0,0,0,0
13611,13611,'should not trap focus if scroll is allowed',0.0,0,0,0
13612,13612,'should not traverse past filtered states',0.0,0,0,0
13613,13613,'should not trigger a transitionend event if another transitionend event had already happened',0.0,0,0,0
13614,13614,'should not trigger hidden event',0.0,0,0,0
13615,13615,'should not trigger hidden if hide is prevented',0.0,0,0,0
13616,13616,'should not trigger hidden',0.0,0,0,0
13617,13617,'should not trigger shown event',0.0,0,0,0
13618,13618,'should not trigger shown if show is prevented',0.0,0,0,0
13619,13619,"'should not try to remove Node on remove method if it is not ""shown""'",0.0,0,0,0
13620,13620,'should not update URL for a 404',0.0,0,0,0
13621,13621,'should not update when stopped',0.0,0,0,0
13622,13622,"'should not use ""static"" Popper in navbar'",0.0,0,0,0
13623,13623,'should not use Popper if display set to static',0.0,0,0,0
13624,13624,'should not use a wildcard when a guarded transition matches',0.0,0,0,0
13625,13625,'should not use a wildcard when an unguarded transition matches',0.0,0,0,0
13626,13626,'should not use actions as possible inference sites 1',0.0,0,0,0
13627,13627,'should not use actions as possible inference sites 2',0.0,0,0,0
13628,13628,'should not use actions as possible inference sites',0.0,0,0,0
13629,13629,'should not use native api to sanitize if a custom function passed',0.0,0,0,0
13630,13630,'should not use wildcard transition over explicit one when using object `.on` config - even if wildcard comes first',0.0,0,0,0
13631,13631,'should not warn for accessing res after gssp returns',0.0,0,0,0
13632,13632,'should not warn for flag in output',0.0,0,0,0
13633,13633,'should not warn with eslint config in package.json',0.0,0,0,0
13634,13634,'should not widen literal types defined in `schema.context` based on `config.context`',0.0,0,0,0
13635,13635,'should notify subscribers of the current state upon subscription (onTransition)',0.0,0,0,0
13636,13636,'should notify subscribers of the current state upon subscription (subscribe)',0.0,0,0,0
13637,13637,"'should null, if element is not scrollable'",0.0,0,0,0
13638,13638,'should omit `bs-config` data attribute',0.0,0,0,0
13639,13639,'should omit element\'s data attribute `config` if is not an object',0.0,0,0,0
13640,13640,'should on-demand revalidate for fallback: blocking with onlyGenerated if generated',0.0,0,0,0
13641,13641,'should on-demand revalidate for revalidate: false',0.0,0,0,0
13642,13642,'should on-demand revalidate that returns notFound: true',0.0,0,0,0
13643,13643,'should only contain middleware route in dev middleware manifest',0.0,0,0,0
13644,13644,'should only execute matched actions',0.0,0,0,0
13645,13645,'should only get bs-prefixed data attribute',0.0,0,0,0
13646,13646,'should only include the same style once in the flight data',0.0,0,0,0
13647,13647,'should only pass params that apply to the layout',0.0,0,0,0
13648,13648,'should only remove bs-prefixed data attribute',0.0,0,0,0
13649,13649,'should only render noscript element when lazy loading',0.0,0,0,0
13650,13650,'should only scroll to the parallel route that was navigated to',0.0,0,0,0
13651,13651,'should only send events once to the inspector after restarting a service',0.0,0,0,0
13652,13652,'should only show warning once per page when large amount of page data is returned',0.0,0,0,0
13653,13653,'should only spawn actors defined on initial state once',0.0,0,0,0
13654,13654,'should only spawn an actor in an initial state of a child that gets invoked in the initial state of a parent when the parent gets started',0.0,0,0,0
13655,13655,'should only spawn an initial actor once when it synchronously responds with an event',0.0,0,0,0
13656,13656,"'should only switch ""active"" class on current target specified w element'",0.0,0,0,0
13657,13657,"'should only switch ""active"" class on current target'",0.0,0,0,0
13658,13658,'should only trigger inserted event if a new tooltip element was created',0.0,0,0,0
13659,13659,'should only warn for accessing res if not streaming',0.0,0,0,0
13660,13660,'should open a code editor by default if showCode=true option specified in style guide config',0.0,0,0,0
13661,13661,'should open a code editor by default if showcode=true option passed in example settings',0.0,0,0,0
13662,13662,'should open a code editor',0.0,0,0,0
13663,13663,'should open dropdown when pressing keydown or keyup',0.0,0,0,0
13664,13664,'should open the dropdown and focus on the first item when using ArrowDown for the first time',0.0,0,0,0
13665,13665,'should open the dropdown and focus on the last item when using ArrowUp for the first time',0.0,0,0,0
13666,13666,"'should open the dropdown when clicking the child element inside `data-bs-toggle=""dropdown""`'",0.0,0,0,0
13667,13667,'should optimize routes without multiple generation API as static routes',0.0,0,0,0
13668,13668,'should output HTML/RSC files for static paths',0.0,0,0,0
13669,13669,'should output debug info for static bailouts',0.0,0,0,0
13670,13670,'should output routes-manifest correctly',0.0,0,0,0
13671,13671,'should output traces',0.0,0,0,0
13672,13672,'should override config theme variables with config styles',0.0,0,0,0
13673,13673,'should override context (second argument)',0.0,0,0,0
13674,13674,'should override guards and actions',0.0,0,0,0
13675,13675,'should override theme variables with config theme',0.0,0,0,0
13676,13676,'should override with rewrite externally correctly',0.0,0,0,0
13677,13677,'should override with rewrite internally correctly',0.0,0,0,0
13678,13678,'should overwrite data if something is already stored',0.0,0,0,0
13679,13679,'should pages path with a underscore at the root',0.0,0,0,0
13680,13680,'should parse a plain value',0.0,0,0,0
13681,13681,'should parse edge runtime correctly',0.0,0,0,0
13682,13682,'should parse element\'s data attribute `config` and any rest attributes. The programmatically given should excel all. Data attribute `config` should excel only Defaults',0.0,0,0,0
13683,13683,"'should parse element\'s data attributes and merge it with default config, plug these given during method call. The programmatically given should excel all'",0.0,0,0,0
13684,13684,'should parse element\'s data attributes and merge it with default config. Element\'s data attributes must excel Defaults',0.0,0,0,0
13685,13685,'should parse examples settings correctly',0.0,0,0,0
13686,13686,'should parse expires',0.0,0,0,0
13687,13687,'should parse max-age',0.0,0,0,0
13688,13688,'should parse modifiers as JSON',0.0,0,0,0
13689,13689,'should parse modifiers as a space-separated string',0.0,0,0,0
13690,13690,'should parse nodejs runtime correctly',0.0,0,0,0
13691,13691,'should parse path',0.0,0,0,0
13692,13692,'should parse query values on mount correctly',0.0,0,0,0
13693,13693,'should parse relative url on special protocol',0.0,0,0,0
13694,13694,'should parse relative url when start with dot',0.0,0,0,0
13695,13695,'should parse relative url',0.0,0,0,0
13696,13696,'should parse ssr info with variable exported gSSP correctly',0.0,0,0,0
13697,13697,'should parse static runtime correctly',0.0,0,0,0
13698,13698,'should parse the full url with current origin',0.0,0,0,0
13699,13699,'should parse with all the options',0.0,0,0,0
13700,13700,'should pass a class name to a button',0.0,0,0,0
13701,13701,'should pass a class name to a link',0.0,0,0,0
13702,13702,'should pass active flag to active slot',0.0,0,0,0
13703,13703,'should pass an environment to a user config',0.0,0,0,0
13704,13704,'should pass correct nextRuntime values',0.0,0,0,0
13705,13705,'should pass depth to heading',0.0,0,0,0
13706,13706,'should pass devtool settings in development',0.0,0,0,0
13707,13707,'should pass props from getServerSideProps in root layout',0.0,0,0,0
13708,13708,'should pass query for data request on navigation',0.0,0,0,0
13709,13709,'should pass query for data request',0.0,0,0,0
13710,13710,"'should pass rendered description, usage, examples, etc. to the renderer'",0.0,0,0,0
13711,13711,'should pass slot ID to onClick handler',0.0,0,0,0
13712,13712,'should pass style guide config and stats to callback',0.0,0,0,0
13713,13713,'should pass style guide config to callback',0.0,0,0,0
13714,13714,'should pass template context to HTML plugin',0.0,0,0,0
13715,13715,'should pass template function to HTML plugin',0.0,0,0,0
13716,13716,'should pass updateExample function from config to chunkify',0.0,0,0,0
13717,13717,'should pass value to a custom process function',0.0,0,0,0
13718,13718,'should perform deep updates correctly',0.0,0,0,0
13719,13719,'should perform hard navigation for direct urls',0.0,0,0,0
13720,13720,'should perform hard navigation for rewritten urls',0.0,0,0,0
13721,13721,'should perform multiple updates correctly',0.0,0,0,0
13722,13722,'should pick configured metadataBase instead of deployment url for canonical url',0.0,0,0,0
13723,13723,'should pick up opengraph-image and twitter-image as static metadata files',0.0,0,0,0
13724,13724,'should possible to stop listening an event',0.0,0,0,0
13725,13725,'should prefer prefered.js before preferred/index.js',0.0,0,0,0
13726,13726,'should prefetch again after 5 mins if the link is visible again',0.0,0,0,0
13727,13727,'should prefetch pages correctly in viewport with <Link>',0.0,0,0,0
13728,13728,'should prefetch pages correctly when manually called',0.0,0,0,0
13729,13729,'should prefetch partially a dynamic page',0.0,0,0,0
13730,13730,'should prefetch the full page',0.0,0,0,0
13731,13731,'should prefix metadata og image with basePath',0.0,0,0,0
13732,13732,'should preload correctly with client components',0.0,0,0,0
13733,13733,'should preload correctly with layout using fonts',0.0,0,0,0
13734,13734,'should preload correctly with page using fonts',0.0,0,0,0
13735,13735,'should preload correctly with server components',0.0,0,0,0
13736,13736,'should prepend requires as webpack entries',0.0,0,0,0
13737,13737,'should preserve action order when .preserveActionOrder = true',0.0,0,0,0
13738,13738,'should preserve custom css class',0.0,0,0,0
13739,13739,'should preserve provided action type for the meta object',0.0,0,0,0
13740,13740,'should preserve state.nextEvents using machine.resolveState',0.0,0,0,0
13741,13741,'should preserve the given State if there are no actions',0.0,0,0,0
13742,13742,'should preserve typestate for state node returned by StateNode.withConfig.',0.0,0,0,0
13743,13743,"'should prevent default when a click occurred on data-bs-dismiss=""modal"" where tagName is <a> or <area>'",0.0,0,0,0
13744,13744,'should prevent default when the trigger is <a> or <area>',0.0,0,0,0
13745,13745,'should prevent the heading level from exceeding the maximum allowed by the Heading component',0.0,0,0,0
13746,13746,'should prevent url change if click on nested elements',0.0,0,0,0
13747,13747,'should print an error when exporting a default handler in dev',0.0,0,0,0
13748,13748,'should print error for conflicting app/page',0.0,0,0,0
13749,13749,'should print warning when old typescript version is used with next build',0.0,0,0,0
13750,13750,'should prioritize returning equivalent state mapping',0.0,0,0,0
13751,13751,'should process event only once',0.0,0,0,0
13752,13752,'should process events in the same order they were hit',0.0,0,0,0
13753,13753,'should process initialization before other events',0.0,0,0,0
13754,13754,'should process more than one event',0.0,0,0,0
13755,13755,'should produce a partial state machine with a binary toggle',0.0,0,0,0
13756,13756,'should produce response with url from fetch',0.0,0,0,0
13757,13757,'should propagate escape key events if dropdown is closed',0.0,0,0,0
13758,13758,'should propagate unstable_cache tags correctly',0.0,0,0,0
13759,13759,"'should properly error when dynamic = ""error"" page uses dynamic'",0.0,0,0,0
13760,13760,'should properly evaluate deep flat parallel states',0.0,0,0,0
13761,13761,'should properly maintain tooltip state if leave event occurs and enter event occurs during hide transition',0.0,0,0,0
13762,13762,'should properly register machine states',0.0,0,0,0
13763,13763,'should properly transition a nested state',0.0,0,0,0
13764,13764,'should properly transition according to onEntry events on an initial state',0.0,0,0,0
13765,13765,'should properly transition based on an event',0.0,0,0,0
13766,13766,'should properly transition states based on event-like object',0.0,0,0,0
13767,13767,'should properly transition states based on string event',0.0,0,0,0
13768,13768,'should properly transition to relative substate',0.0,0,0,0
13769,13769,'should properly transition when in a complex nested state',0.0,0,0,0
13770,13770,'should properly transition when in a simple nested state',0.0,0,0,0
13771,13771,'should properly transition when raising events for a parallel state',0.0,0,0,0
13772,13772,'should properly work with hasMatch',0.0,0,0,0
13773,13773,'should provide a narrowed down expression event type when used as a transition action',0.0,0,0,0
13774,13774,'should provide context to a condition expression',0.0,0,0,0
13775,13775,'should provide correct query value for dynamic page',0.0,0,0,0
13776,13776,'should provide data params to a service creator',0.0,0,0,0
13777,13777,'should provide event to a condition expression',0.0,0,0,0
13778,13778,'should provide invoke definitions',0.0,0,0,0
13779,13779,'should provide meta._event to assigner',0.0,0,0,0
13780,13780,'should provide original _next/data URL with skipMiddlewareUrlNormalize',0.0,0,0,0
13781,13781,'should provide previous state for serializeState()',0.0,0,0,0
13782,13782,'should provide stateGuard.state to a condition expression',0.0,0,0,0
13783,13783,'should provide the assign action',0.0,0,0,0
13784,13784,'should provide the default TEvent to transition actions when there is no specific TEvent configured',0.0,0,0,0
13785,13785,'should provide the original action and state to the exec function',0.0,0,0,0
13786,13786,'should provide the resolved data when invoked with a promise factory',0.0,0,0,0
13787,13787,'should provide the resolved data when invoked with a promise service',0.0,0,0,0
13788,13788,'should provide the state in regular transitions (assigner)',0.0,0,0,0
13789,13789,'should provide the state in regular transitions (prop assigner)',0.0,0,0,0
13790,13790,'should push external url without affecting hooks',0.0,0,0,0
13791,13791,'should push to external url',0.0,0,0,0
13792,13792,'should put aria attributes',0.0,0,0,0
13793,13793,"'should raise a ""done.state.*"" event when a pseudostate of a history type is directly on a parallel state'",0.0,0,0,0
13794,13794,"'should raise a ""done.state.*"" event when all child states reach final state'",0.0,0,0,0
13795,13795,'should re-enter a parallel with full history',0.0,0,0,0
13796,13796,'should re-enter a parallel with partial history',0.0,0,0,0
13797,13797,'should re-enter each regions of parallel state correctly',0.0,0,0,0
13798,13798,'should re-enter multiple history states',0.0,0,0,0
13799,13799,'should re-render the layout on the server when it had a default child route',0.0,0,0,0
13800,13800,'should re-show tip if it was already shown',0.0,0,0,0
13801,13801,'should re-use the cache for 30 seconds',0.0,0,0,0
13802,13802,"'should re-use the cache for the full page, only for 5 mins'",0.0,0,0,0
13803,13803,'should re-use the cache only for 30 seconds',0.0,0,0,0
13804,13804,'should re-use the full cache for only 30 seconds',0.0,0,0,0
13805,13805,'should read a config file',0.0,0,0,0
13806,13806,'should read data attributes and override default config',0.0,0,0,0
13807,13807,'should read other cookies when draft mode enabled',0.0,0,0,0
13808,13808,'should receive an emitted error',0.0,0,0,0
13809,13809,'should receive and process all events sent simultaneously',0.0,0,0,0
13810,13810,'should receive correct _event (log action)',0.0,0,0,0
13811,13811,'should receive done event from an immediately completed observable when self-initializing',0.0,0,0,0
13812,13812,'should recover if error is thrown while processing event',0.0,0,0,0
13813,13813,'should recover if error is thrown while processing the queue',0.0,0,0,0
13814,13814,'should recover on font loader error',0.0,0,0,0
13815,13815,'should recursively filter sections and components by name',0.0,0,0,0
13816,13816,'should recursively process all sections and components',0.0,0,0,0
13817,13817,'should redirect client-side',0.0,0,0,0
13818,13818,'should redirect correctly with redirect in next.config.js',0.0,0,0,0
13819,13819,'should redirect from middleware correctly',0.0,0,0,0
13820,13820,'should redirect from middleware with link navigation',0.0,0,0,0
13821,13821,'should redirect from middleware',0.0,0,0,0
13822,13822,'should redirect from next.config.js correctly',0.0,0,0,0
13823,13823,'should redirect from next.config.js with link navigation',0.0,0,0,0
13824,13824,'should redirect from next.config.js',0.0,0,0,0
13825,13825,'should redirect in a client component',0.0,0,0,0
13826,13826,'should redirect in a server component',0.0,0,0,0
13827,13827,'should redirect paths without trailing-slash and render when slash is appended',0.0,0,0,0
13828,13828,'should redirect route when clicking link',0.0,0,0,0
13829,13829,'should redirect route when requesting it directly by browser',0.0,0,0,0
13830,13830,'should redirect route when requesting it directly',0.0,0,0,0
13831,13831,'should redirect the same for direct visit and client-transition',0.0,0,0,0
13832,13832,'should redirect to external url',0.0,0,0,0
13833,13833,"'should redirect to external url, initiating only once'",0.0,0,0,0
13834,13834,'should redirect trailing slash correctly',0.0,0,0,0
13835,13835,'should redirect trailing slash on root correctly',0.0,0,0,0
13836,13836,'should redirect using catchall from next.config.js correctly',0.0,0,0,0
13837,13837,'should redirect with basePath by default',0.0,0,0,0
13838,13838,'should redirect without basePath when set to false',0.0,0,0,0
13839,13839,'should redirect',0.0,0,0,0
13840,13840,'should reenter leaf state during its self-transition',0.0,0,0,0
13841,13841,'should reenter parallel region when a parallel state gets reentered while targeting another region',0.0,0,0,0
13842,13842,'should reenter persisted state during external transition targeting a history state',0.0,0,0,0
13843,13843,'should reference actions defined in actions parameter of machine options (initial state)',0.0,0,0,0
13844,13844,'should reference actions defined in actions parameter of machine options',0.0,0,0,0
13845,13845,'should refetch below the fold after 30 seconds',0.0,0,0,0
13846,13846,'should refetch the full page after 5 mins',0.0,0,0,0
13847,13847,'should rehydrate the state and the context if both are provided',0.0,0,0,0
13848,13848,'should rehydrate the state if the state if provided',0.0,0,0,0
13849,13849,'should reject an invalid event type returned from an expression',0.0,0,0,0
13850,13850,'should reject an invalid event type',0.0,0,0,0
13851,13851,'should reject an invalid simple event type',0.0,0,0,0
13852,13852,'should reject transitioning from bad state configs',0.0,0,0,0
13853,13853,'should relative canonical url',0.0,0,0,0
13854,13854,'should release focus trap',0.0,0,0,0
13855,13855,'should reload @import styles during HMR',0.0,0,0,0
13856,13856,'should reload page on failed data request',0.0,0,0,0
13857,13857,'should reload the server when the instrumentation hook changes',0.0,0,0,0
13858,13858,'should remember first level state history',0.0,0,0,0
13859,13859,'should remember the activities even after an event',0.0,0,0,0
13860,13860,"'should remove ""collapsed"" class from target when collapse is shown'",0.0,0,0,0
13861,13861,"'should remove ""show"" class if body if tabbing outside of menu, with multiple dropdowns'",0.0,0,0,0
13862,13862,"'should remove ""show"" class if body is clicked, with multiple dropdowns'",0.0,0,0,0
13863,13863,"'should remove ""show"" class if tabbing outside of menu'",0.0,0,0,0
13864,13864,'should remove #/ from the address bar',0.0,0,0,0
13865,13865,'should remove `title` attribute if exists',0.0,0,0,0
13866,13866,'should remove a listener registered by .one',0.0,0,0,0
13867,13867,'should remove a listener',0.0,0,0,0
13868,13868,'should remove all comments',0.0,0,0,0
13869,13869,'should remove all event listeners',0.0,0,0,0
13870,13870,'should remove all the events',0.0,0,0,0
13871,13871,'should remove all the namespaced listeners if namespace is passed',0.0,0,0,0
13872,13872,'should remove combined named export specifiers',0.0,0,0,0
13873,13873,'should remove data attribute in kebab case',0.0,0,0,0
13874,13874,'should remove data for a given key',0.0,0,0,0
13875,13875,'should remove double quotes around the string',0.0,0,0,0
13876,13876,'should remove event listener on touch-enabled device that was added in show method',0.0,0,0,0
13877,13877,'should remove named export function declarations (async)',0.0,0,0,0
13878,13878,'should remove named export function declarations',0.0,0,0,0
13879,13879,'should remove named export variable declarations (async)',0.0,0,0,0
13880,13880,'should remove named export variable declarations',0.0,0,0,0
13881,13881,'should remove non-public methods',0.0,0,0,0
13882,13882,'should remove nothing for an unknown key',0.0,0,0,0
13883,13883,'should remove padding & margin if not existed before adjustment',0.0,0,0,0
13884,13884,'should remove re-exported function declarations',0.0,0,0,0
13885,13885,'should remove re-exported variable declarations (safe)',0.0,0,0,0
13886,13886,'should remove re-exported variable declarations',0.0,0,0,0
13887,13887,'should remove separate named export specifiers',0.0,0,0,0
13888,13888,'should remove single quotes around the string',0.0,0,0,0
13889,13889,'should remove tags not in allowlist',0.0,0,0,0
13890,13890,"'should remove the ""show"" class'",0.0,0,0,0
13891,13891,'should remove the all the namespaced listeners for native events',0.0,0,0,0
13892,13892,'should remove the backdrop html',0.0,0,0,0
13893,13893,'should remove the correct delegated event listener',0.0,0,0,0
13894,13894,'should remove the namespaced listeners',0.0,0,0,0
13895,13895,'should remove the specified namespaced listeners for native events',0.0,0,0,0
13896,13896,'should remove transition listeners',0.0,0,0,0
13897,13897,'should render /blog/first correctly',0.0,0,0,0
13898,13898,'should render /blog/second correctly',0.0,0,0,0
13899,13899,'should render 404 correctly when notFound is returned (dynamic)',0.0,0,0,0
13900,13900,'should render 404 correctly when notFound is returned (non-dynamic)',0.0,0,0,0
13901,13901,'should render 404 correctly when notFound is returned client-transition (dynamic)',0.0,0,0,0
13902,13902,'should render 404 correctly when notFound is returned client-transition (non-dynamic)',0.0,0,0,0
13903,13903,'should render <a>',0.0,0,0,0
13904,13904,'should render Image on its own',0.0,0,0,0
13905,13905,'should render JsDoc tags',0.0,0,0,0
13906,13906,'should render Link on its own',0.0,0,0,0
13907,13907,'should render Markdown',0.0,0,0,0
13908,13908,'should render MuiLink with <a>',0.0,0,0,0
13909,13909,'should render OpenGraph image meta tag correctly',0.0,0,0,0
13910,13910,'should render PropTypes.arrayOf',0.0,0,0,0
13911,13911,'should render PropTypes.arrayOf(PropTypes.shape)',0.0,0,0,0
13912,13912,'should render PropTypes.instanceOf',0.0,0,0,0
13913,13913,'should render PropTypes.objectOf',0.0,0,0,0
13914,13914,'should render PropTypes.objectOf(PropTypes.shape)',0.0,0,0,0
13915,13915,'should render PropTypes.oneOf',0.0,0,0,0
13916,13916,'should render PropTypes.oneOfType',0.0,0,0,0
13917,13917,"'should render PropTypes.shape defaultProps, falling back to Object'",0.0,0,0,0
13918,13918,'should render PropTypes.shape with description',0.0,0,0,0
13919,13919,'should render PropTypes.shape with formatted defaultProps',0.0,0,0,0
13920,13920,'should render PropTypes.shape',0.0,0,0,0
13921,13921,'should render PropTypes.string with a default value',0.0,0,0,0
13922,13922,'should render PropTypes.string',0.0,0,0,0
13923,13923,'should render PropTypes.string.isRequired',0.0,0,0,0
13924,13924,'should render StyleGuide component',0.0,0,0,0
13925,13925,'should render a blockquote',0.0,0,0,0
13926,13926,'should render a button with small styles',0.0,0,0,0
13927,13927,'should render a button',0.0,0,0,0
13928,13928,'should render a checkbox input',0.0,0,0,0
13929,13929,'should render a deprecated section heading',0.0,0,0,0
13930,13930,'should render a heading according to the level',0.0,0,0,0
13931,13931,'should render a heading with a wrapper that provides margin',0.0,0,0,0
13932,13932,'should render a heading',0.0,0,0,0
13933,13933,'should render a horizontal rule',0.0,0,0,0
13934,13934,'should render a link',0.0,0,0,0
13935,13935,'should render a page with context',0.0,0,0,0
13936,13936,'should render a pre',0.0,0,0,0
13937,13937,'should render a renderer',0.0,0,0,0
13938,13938,'should render a section heading',0.0,0,0,0
13939,13939,'should render a table',0.0,0,0,0
13940,13940,'should render active styles',0.0,0,0,0
13941,13941,'should render an error when componentDidCatch() is triggered',0.0,0,0,0
13942,13942,'should render an example placeholder after click',0.0,0,0,0
13943,13943,'should render an example placeholder',0.0,0,0,0
13944,13944,'should render an intercepted route at the top level from a nested path',0.0,0,0,0
13945,13945,'should render an intercepted route from a slot',0.0,0,0,0
13946,13946,'should render an ordered list',0.0,0,0,0
13947,13947,'should render an unordered list',0.0,0,0,0
13948,13948,'should render apple icon with dynamic routes',0.0,0,0,0
13949,13949,'should render argument without description',0.0,0,0,0
13950,13950,'should render argument without type',0.0,0,0,0
13951,13951,'should render argument',0.0,0,0,0
13952,13952,'should render arguments from JsDoc tags',0.0,0,0,0
13953,13953,'should render built-in 404 page for missing route if pagesDir is not presented',0.0,0,0,0
13954,13954,'should render check-lists',0.0,0,0,0
13955,13955,'should render children',0.0,0,0,0
13956,13956,'should render client-side with modules',0.0,0,0,0
13957,13957,'should render client-side',0.0,0,0,0
13958,13958,'should render code blocks without escaping',0.0,0,0,0
13959,13959,'should render code to be highlighted',0.0,0,0,0
13960,13960,'should render code',0.0,0,0,0
13961,13961,'should render colored text',0.0,0,0,0
13962,13962,'should render component in isolation mode',0.0,0,0,0
13963,13963,'should render component renderer',0.0,0,0,0
13964,13964,'should render component without a pathline',0.0,0,0,0
13965,13965,'should render component',0.0,0,0,0
13966,13966,'should render components list',0.0,0,0,0
13967,13967,'should render correctly for SSG pages that starts with api-docs',0.0,0,0,0
13968,13968,'should render correctly when notFound is false (dynamic)',0.0,0,0,0
13969,13969,'should render correctly when notFound is false (non-dynamic)',0.0,0,0,0
13970,13970,'should render correctly with context consumer',0.0,0,0,0
13971,13971,'should render css-in-js suspense boundary correctly',0.0,0,0,0
13972,13972,'should render custom class type',0.0,0,0,0
13973,13973,'should render deprecated JsDoc tags',0.0,0,0,0
13974,13974,'should render description in Markdown',0.0,0,0,0
13975,13975,'should render description',0.0,0,0,0
13976,13976,'should render docs',0.0,0,0,0
13977,13977,'should render emphasis and strong text',0.0,0,0,0
13978,13978,'should render examples',0.0,0,0,0
13979,13979,'should render function body in tooltip',0.0,0,0,0
13980,13980,'should render function defaultValue as code when null',0.0,0,0,0
13981,13981,'should render function defaultValue as code when undefined',0.0,0,0,0
13982,13982,'should render function type with body in tooltip',0.0,0,0,0
13983,13983,'should render heading as deprecated when @deprecated is present in tags',0.0,0,0,0
13984,13984,'should render headings',0.0,0,0,0
13985,13985,'should render icon and apple touch icon meta if their images are specified',0.0,0,0,0
13986,13986,'should render icon with dynamic routes',0.0,0,0,0
13987,13987,'should render images nested under page dir on /nested route',0.0,0,0,0
13988,13988,'should render images on / route',0.0,0,0,0
13989,13989,'should render images on /client route',0.0,0,0,0
13990,13990,'should render index correctly',0.0,0,0,0
13991,13991,'should render initial styles of css-in-js in edge SSR correctly',0.0,0,0,0
13992,13992,'should render initial styles of css-in-js in nodejs SSR correctly',0.0,0,0,0
13993,13993,'should render inline code with escaping',0.0,0,0,0
13994,13994,'should render intercepted route from a nested route',0.0,0,0,0
13995,13995,'should render intercepted route',0.0,0,0,0
13996,13996,'should render legacy images in edge runtime on /legacy-edge-runtime route',0.0,0,0,0
13997,13997,'should render legacy images under /legacy route',0.0,0,0,0
13998,13998,'should render link with <a>',0.0,0,0,0
13999,13999,'should render link with classname',0.0,0,0,0
14000,14000,'should render link with id',0.0,0,0,0
14001,14001,'should render link with multiple children',0.0,0,0,0
14002,14002,'should render link with trailing slash',0.0,0,0,0
14003,14003,'should render link',0.0,0,0,0
14004,14004,'should render links',0.0,0,0,0
14005,14005,'should render literal type',0.0,0,0,0
14006,14006,'should render loading.js in browser for slow layout and page',0.0,0,0,0
14007,14007,'should render loading.js in browser for slow layout',0.0,0,0,0
14008,14008,'should render loading.js in browser for slow page',0.0,0,0,0
14009,14009,'should render loading.js in initial html for slow layout and page',0.0,0,0,0
14010,14010,'should render loading.js in initial html for slow layout',0.0,0,0,0
14011,14011,'should render loading.js in initial html for slow page',0.0,0,0,0
14012,14012,'should render metadata in head even root layout is wrapped with Suspense',0.0,0,0,0
14013,14013,'should render methods table',0.0,0,0,0
14014,14014,'should render mixed nested lists',0.0,0,0,0
14015,14015,'should render modal when paired with parallel routes',0.0,0,0,0
14016,14016,'should render multi-byte characters correctly in streaming',0.0,0,0,0
14017,14017,'should render name as deprecated when tag deprecated is present',0.0,0,0,0
14018,14018,'should render nested parallel routes',0.0,0,0,0
14019,14019,'should render next/router correctly in edge runtime',0.0,0,0,0
14020,14020,'should render noscript element when placeholder=blur',0.0,0,0,0
14021,14021,'should render not found pages correctly and fallback to the default one',0.0,0,0,0
14022,14022,'should render nothing without props and methods',0.0,0,0,0
14023,14023,'should render null for empty tags',0.0,0,0,0
14024,14024,'should render object type with body in tooltip',0.0,0,0,0
14025,14025,'should render og image with opengraph-image dynamic routes',0.0,0,0,0
14026,14026,'should render og image with twitter-image dynamic routes',0.0,0,0,0
14027,14027,'should render optional type string',0.0,0,0,0
14028,14028,'should render ordered lists',0.0,0,0,0
14029,14029,'should render outside of Next.js without error',0.0,0,0,0
14030,14030,'should render page correctly under custom server',0.0,0,0,0
14031,14031,'should render paragraph as a <div>',0.0,0,0,0
14032,14032,'should render paragraph as a <p>',0.0,0,0,0
14033,14033,'should render paragraphs',0.0,0,0,0
14034,14034,'should render parameters',0.0,0,0,0
14035,14035,'should render pre-formatted text',0.0,0,0,0
14036,14036,'should render props table',0.0,0,0,0
14037,14037,'should render public method',0.0,0,0,0
14038,14038,'should render renderer with sections with nested components',0.0,0,0,0
14039,14039,'should render return from JsDoc tags',0.0,0,0,0
14040,14040,'should render return value',0.0,0,0,0
14041,14041,'should render returns',0.0,0,0,0
14042,14042,'should render ribbon if the ribbon is present in the config',0.0,0,0,0
14043,14043,'should render ribbon with a text',0.0,0,0,0
14044,14044,'should render ribbon with url',0.0,0,0,0
14045,14045,'should render root not-found with default metadata',0.0,0,0,0
14046,14046,'should render section in isolation mode',0.0,0,0,0
14047,14047,'should render section renderer',0.0,0,0,0
14048,14048,'should render sections if defined',0.0,0,0,0
14049,14049,'should render sections with nested components',0.0,0,0,0
14050,14050,'should render server components correctly',0.0,0,0,0
14051,14051,'should render server-side with modules',0.0,0,0,0
14052,14052,'should render server-side',0.0,0,0,0
14053,14053,'should render sized text',0.0,0,0,0
14054,14054,'should render styled-jsx styles in streaming',0.0,0,0,0
14055,14055,'should render styles during CSR (AMP)',0.0,0,0,0
14056,14056,'should render styles during CSR',0.0,0,0,0
14057,14057,'should render styles during SSR (AMP)',0.0,0,0,0
14058,14058,'should render text in a span',0.0,0,0,0
14059,14059,'should render text with a semantic tag and styles',0.0,0,0,0
14060,14060,'should render text with a title',0.0,0,0,0
14061,14061,'should render text',0.0,0,0,0
14062,14062,"'should render the 404 page when the file is removed, and restore the page when re-added'",0.0,0,0,0
14063,14063,'should render the correct page',0.0,0,0,0
14064,14064,'should render the correct sizes passed when a noscript element is rendered',0.0,0,0,0
14065,14065,'should render the template that holds state in a client component and reset on navigation',0.0,0,0,0
14066,14066,'should render the template that is a server component and rerender on navigation',0.0,0,0,0
14067,14067,'should render tuple type with body in tooltip',0.0,0,0,0
14068,14068,'should render type string with a default value',0.0,0,0,0
14069,14069,'should render type string',0.0,0,0,0
14070,14070,'should render underlined text',0.0,0,0,0
14071,14071,'should render union type with body in tooltip',0.0,0,0,0
14072,14072,'should render unknown proptype for a prop when a relevant proptype is not assigned',0.0,0,0,0
14073,14073,'should render unordered lists',0.0,0,0,0
14074,14074,'should render usage closed by default when showUsage config options is false',0.0,0,0,0
14075,14075,'should render usage opened by default when showUsage config options is true',0.0,0,0,0
14076,14076,'should render usage section',0.0,0,0,0
14077,14077,'should render welcome screen',0.0,0,0,0
14078,14078,'should render with block styles',0.0,0,0,0
14079,14079,'should render with context after change',0.0,0,0,0
14080,14080,'should render',0.0,0,0,0
14081,14081,'should renderer a button',0.0,0,0,0
14082,14082,'should renderer a link home in isolated mode',0.0,0,0,0
14083,14083,'should renderer a link to example isolated mode',0.0,0,0,0
14084,14084,'should renderer a link to isolated mode',0.0,0,0,0
14085,14085,'should renderer and editor',0.0,0,0,0
14086,14086,'should renderer null if there are not props or methods',0.0,0,0,0
14087,14087,'should renderer only active slot if onlyActive=true',0.0,0,0,0
14088,14088,'should renderer should render loader',0.0,0,0,0
14089,14089,'should renderer slots and pass props',0.0,0,0,0
14090,14090,'should renderer slots in id/render format',0.0,0,0,0
14091,14091,'should renerate prefixed class names',0.0,0,0,0
14092,14092,'should replace NODE_ENV in !== statement (prod)',0.0,0,0,0
14093,14093,'should replace NODE_ENV in === statement (prod)',0.0,0,0,0
14094,14094,'should replace NODE_ENV in statement (dev)',0.0,0,0,0
14095,14095,'should replace NODE_ENV on client (dev)',0.0,0,0,0
14096,14096,'should replace NODE_ENV on client (prod)',0.0,0,0,0
14097,14097,'should replace NODE_ENV on server',0.0,0,0,0
14098,14098,'should replace all occurrences of __COMPONENT__ with provided query.componentName',0.0,0,0,0
14099,14099,'should replace leading and trailing spaces with a visible character',0.0,0,0,0
14100,14100,'should replace process.browser (1)',0.0,0,0,0
14101,14101,'should replace process.browser (2)',0.0,0,0,0
14102,14102,'should replace process.browser (3)',0.0,0,0,0
14103,14103,'should replace process.browser (4)',0.0,0,0,0
14104,14104,'should replace process.browser (5)',0.0,0,0,0
14105,14105,'should replace to external url',0.0,0,0,0
14106,14106,'should replace typeof window expression !== object top level serverside',0.0,0,0,0
14107,14107,'should replace typeof window expression !== object top level',0.0,0,0,0
14108,14108,'should replace typeof window expression nested',0.0,0,0,0
14109,14109,'should replace typeof window expression top level (client)',0.0,0,0,0
14110,14110,'should replace typeof window expression top level (server)',0.0,0,0,0
14111,14111,'should replace typeof window expression top level serverside',0.0,0,0,0
14112,14112,'should replace typeof window expression top level',0.0,0,0,0
14113,14113,'should replace typeof window in !== expression top level',0.0,0,0,0
14114,14114,'should replace typeof window in === expression nested',0.0,0,0,0
14115,14115,'should replace typeof window in === expression top level',0.0,0,0,0
14116,14116,'should report a type error for an invalid event',0.0,0,0,0
14117,14117,'should report an error when the stop action returns an invalid actor ref',0.0,0,0,0
14118,14118,'should report any internal transition assignments as changed',0.0,0,0,0
14119,14119,'should report entering a final state as changed',0.0,0,0,0
14120,14120,'should represent a statechart as a directed graph',0.0,0,0,0
14121,14121,'should represent the ID (state node)',0.0,0,0,0
14122,14122,'should represent the ID',0.0,0,0,0
14123,14123,'should represent the flat nested parallel states in the state value',0.0,0,0,0
14124,14124,'should request a path prefixed with non-default locale',0.0,0,0,0
14125,14125,'should require actions on wildcard transitions to handle all event types',0.0,0,0,0
14126,14126,'should resolve .config.cjs',0.0,0,0,0
14127,14127,'should resolve .config.js',0.0,0,0,0
14128,14128,'should resolve .config.json',0.0,0,0,0
14129,14129,'should resolve .done',0.0,0,0,0
14130,14130,'should resolve 3rd party package exports based on the react-server condition',0.0,0,0,0
14131,14131,'should resolve a String state',0.0,0,0,0
14132,14132,'should resolve correctly when the predicate immediately matches the current state',0.0,0,0,0
14133,14133,'should resolve css imports from outside with src folder presented',0.0,0,0,0
14134,14134,'should resolve different kinds of components correctly',0.0,0,0,0
14135,14135,'should resolve down',0.0,0,0,0
14136,14136,'should resolve dynamic route after rewrite correctly',0.0,0,0,0
14137,14137,'should resolve from a state config object',0.0,0,0,0
14138,14138,'should resolve getInitialProps',0.0,0,0,0
14139,14139,'should resolve initial assign actions before starting a service',0.0,0,0,0
14140,14140,'should resolve module without error in edge runtime',0.0,0,0,0
14141,14141,'should resolve package.json',0.0,0,0,0
14142,14142,'should resolve parallel states with flat child states',0.0,0,0,0
14143,14143,'should resolve rc.js',0.0,0,0,0
14144,14144,'should resolve rc.json',0.0,0,0,0
14145,14145,'should resolve send event expressions',0.0,0,0,0
14146,14146,'should resolve sendParent event expressions',0.0,0,0,0
14147,14147,'should resolve the state configuration (implicit via events)',0.0,0,0,0
14148,14148,'should resolve the state value',0.0,0,0,0
14149,14149,'should resolve the subset react in server components based on the react-server condition',0.0,0,0,0
14150,14150,'should resolve to an empty object if getInitialProps is missing',0.0,0,0,0
14151,14151,'should resolve transitioning from partially valid states',0.0,0,0,0
14152,14152,'should resolve transitions from empty states',0.0,0,0,0
14153,14153,'should respect `delimiter` option for deeply nested states',0.0,0,0,0
14154,14154,'should respect basePath in amphtml link rel',0.0,0,0,0
14155,14155,'should respect custom caching header',0.0,0,0,0
14156,14156,'should respect the history mechanism',0.0,0,0,0
14157,14157,'should respect the size set in serverActionsBodySizeLimit',0.0,0,0,0
14158,14158,'should respect threshold option markup',0.0,0,0,0
14159,14159,'should respect threshold option',0.0,0,0,0
14160,14160,'should respond for catch-all deep folder',0.0,0,0,0
14161,14161,'should respond from index',0.0,0,0,0
14162,14162,'should respond to _next/data for [id] correctly',0.0,0,0,0
14163,14163,'should respond to _next/data for index correctly',0.0,0,0,0
14164,14164,'should respond to dynamic route correctly',0.0,0,0,0
14165,14165,'should respond to index correctly',0.0,0,0,0
14166,14166,'should respond to normal API request',0.0,0,0,0
14167,14167,'should respond to normal dynamic API request',0.0,0,0,0
14168,14168,'should respond with 307 status code in client component',0.0,0,0,0
14169,14169,'should respond with 307 status code in server component',0.0,0,0,0
14170,14170,'should respond with 400 on decode failure',0.0,0,0,0
14171,14171,'should respond with 405 for POST to static page',0.0,0,0,0
14172,14172,'should restore the scroll position on navigating back',0.0,0,0,0
14173,14173,'should result in correct border width',0.0,0,0,0
14174,14174,'should retain extra named export specifiers',0.0,0,0,0
14175,14175,'should retain tags with valid URLs',0.0,0,0,0
14176,14176,'should retrieve cookies in a server component in the edge runtime',0.0,0,0,0
14177,14177,"'should return ""all"" mode by default'",0.0,0,0,0
14178,14178,"'should return ""false"" if ""touchstart"" not exists in document element and ""navigator.maxTouchPoints"" are zero (0)'",0.0,0,0,0
14179,14179,"'should return ""true"" if ""touchstart"" exists in document element)'",0.0,0,0,0
14180,14180,'should return .type or .flowType property',0.0,0,0,0
14181,14181,'should return 0 if body is not overflowing',0.0,0,0,0
14182,14182,'should return 0 if the element do not possess transition',0.0,0,0,0
14183,14183,'should return 0 if the element is undefined or null',0.0,0,0,0
14184,14184,'should return 0 when cache-control is empty string',0.0,0,0,0
14185,14185,'should return 0 when cache-control is no-cache',0.0,0,0,0
14186,14186,'should return 0 when cache-control is null',0.0,0,0,0
14187,14187,'should return 0 when cache-control max-age is not a number',0.0,0,0,0
14188,14188,'should return 0 when no cache-control provided',0.0,0,0,0
14189,14189,'should return 413 for body equal to 10mb',0.0,0,0,0
14190,14190,'should return 413 for body greater than 1mb',0.0,0,0,0
14191,14191,'should return 413 for body greater than 5kb',0.0,0,0,0
14192,14192,'should return 413 for body greater than 5mb',0.0,0,0,0
14193,14193,'should return API methods',0.0,0,0,0
14194,14194,'should return HTML/data correctly for pre-rendered page',0.0,0,0,0
14195,14195,'should return Markdown for all tags',0.0,0,0,0
14196,14196,'should return Markdown for multiple authors',0.0,0,0,0
14197,14197,'should return Markdown for one author',0.0,0,0,0
14198,14198,'should return a RegExp',0.0,0,0,0
14199,14199,'should return a State instance',0.0,0,0,0
14200,14200,'should return a development config',0.0,0,0,0
14201,14201,'should return a file path with the correct case if a file exists',0.0,0,0,0
14202,14202,'should return a function',0.0,0,0,0
14203,14203,'should return a home URL',0.0,0,0,0
14204,14204,'should return a list of patterns',0.0,0,0,0
14205,14205,'should return a mapping of arrays of simple paths to all states',0.0,0,0,0
14206,14206,'should return a mapping of shortest paths to all states (parallel)',0.0,0,0,0
14207,14207,'should return a mapping of shortest paths to all states',0.0,0,0,0
14208,14208,'should return a mapping of simple paths to all states (parallel)',0.0,0,0,0
14209,14209,'should return a module from the map',0.0,0,0,0
14210,14210,'should return a nochrome URL',0.0,0,0,0
14211,14211,'should return a path from a specified from-state',0.0,0,0,0
14212,14212,'should return a path to the last entered state by the event sequence',0.0,0,0,0
14213,14213,'should return a production config',0.0,0,0,0
14214,14214,'should return a shallow copy of a component with example filtered by given index',0.0,0,0,0
14215,14215,'should return a shallow copy of a section with example filtered by given index',0.0,0,0,0
14216,14216,'should return a single empty path for the initial state',0.0,0,0,0
14217,14217,'should return a toast instance',0.0,0,0,0
14218,14218,'should return actions for parallel machines',0.0,0,0,0
14219,14219,'should return actual value for non-empty field with default value',0.0,0,0,0
14220,14220,'should return alert instance',0.0,0,0,0
14221,14221,'should return all components if all of them match query',0.0,0,0,0
14222,14222,'should return all content pages',0.0,0,0,0
14223,14223,'should return all state paths as strings',0.0,0,0,0
14224,14224,'should return an absolute anchor URL',0.0,0,0,0
14225,14225,'should return an absolute home URL',0.0,0,0,0
14226,14226,'should return an absolute isolated URL',0.0,0,0,0
14227,14227,'should return an absolute isolated example URL',0.0,0,0,0
14228,14228,'should return an absolute nochrome URL',0.0,0,0,0
14229,14229,'should return an absolute path to user Webpack config located in project root folder',0.0,0,0,0
14230,14230,'should return an anchor URL',0.0,0,0,0
14231,14231,'should return an array of all nodes (parallel)',0.0,0,0,0
14232,14232,'should return an array of all nodes',0.0,0,0,0
14233,14233,'should return an empty array in pages',0.0,0,0,0
14234,14234,'should return an empty object for null',0.0,0,0,0
14235,14235,'should return an empty object if hash contains no component name',0.0,0,0,0
14236,14236,'should return an error message',0.0,0,0,0
14237,14237,'should return an error when JSON is invalid',0.0,0,0,0
14238,14238,'should return an instance',0.0,0,0,0
14239,14239,"'should return an integer greater than zero, if body is overflowing'",0.0,0,0,0
14240,14240,'should return an isolated URL',0.0,0,0,0
14241,14241,'should return an isolated example URL',0.0,0,0,0
14242,14242,'should return an isolated example=0 URL',0.0,0,0,0
14243,14243,'should return an object for props with doclets',0.0,0,0,0
14244,14244,'should return an object for props without description',0.0,0,0,0
14245,14245,'should return an object for props',0.0,0,0,0
14246,14246,'should return any element with non negative tab index',0.0,0,0,0
14247,14247,'should return any from a typegenless machine',0.0,0,0,0
14248,14248,'should return avif',0.0,0,0,0
14249,14249,'should return back the config object',0.0,0,0,0
14250,14250,'should return button instance',0.0,0,0,0
14251,14251,'should return cache-control MAX-AGE uppercase',0.0,0,0,0
14252,14252,'should return cache-control S-MAXAGE',0.0,0,0,0
14253,14253,'should return cache-control for a quoted value',0.0,0,0,0
14254,14254,'should return cache-control max-age lowercase',0.0,0,0,0
14255,14255,'should return cache-control s-maxage lowercase',0.0,0,0,0
14256,14256,'should return cache-control s-maxage with spaces',0.0,0,0,0
14257,14257,'should return cache-control s-maxage without spaces',0.0,0,0,0
14258,14258,'should return carousel instance',0.0,0,0,0
14259,14259,'should return collapse instance',0.0,0,0,0
14260,14260,'should return component name for component isolation mode',0.0,0,0,0
14261,14261,'should return component name for example isolation mode',0.0,0,0,0
14262,14262,'should return components at any level with exact name',0.0,0,0,0
14263,14263,'should return components with exact name',0.0,0,0,0
14264,14264,'should return contenteditable elements',0.0,0,0,0
14265,14265,'should return context of a machine',0.0,0,0,0
14266,14266,'should return context of a typegened machine',0.0,0,0,0
14267,14267,'should return correct component paths: array of of relative paths',0.0,0,0,0
14268,14268,'should return correct component paths: default glob pattern',0.0,0,0,0
14269,14269,'should return correct component paths: function returning absolute paths',0.0,0,0,0
14270,14270,'should return correct component paths: function returning relative paths',0.0,0,0,0
14271,14271,'should return correct component paths: glob',0.0,0,0,0
14272,14272,'should return correct values for root layout',0.0,0,0,0
14273,14273,'should return correct values in layout after last segment',0.0,0,0,0
14274,14274,'should return correct values in layout before catchall segment',0.0,0,0,0
14275,14275,'should return correct values in layout before param segment',0.0,0,0,0
14276,14276,'should return correct values in layout before static segment',0.0,0,0,0
14277,14277,'should return data correctly for SSG pages that starts with api-docs',0.0,0,0,0
14278,14278,'should return data correctly for dynamic page (non-seeded)',0.0,0,0,0
14279,14279,'should return data correctly for dynamic page',0.0,0,0,0
14280,14280,'should return data correctly when props is a promise',0.0,0,0,0
14281,14281,'should return data correctly',0.0,0,0,0
14282,14282,'should return default value for empty non-required field',0.0,0,0,0
14283,14283,'should return development Webpack config',0.0,0,0,0
14284,14284,'should return dropdown instance',0.0,0,0,0
14285,14285,'should return element offset height to force the reflow',0.0,0,0,0
14286,14286,'should return empty array if elements not found',0.0,0,0,0
14287,14287,'should return empty array if no components of sections match query',0.0,0,0,0
14288,14288,'should return empty array if no selector',0.0,0,0,0
14289,14289,'should return empty list when nothing found',0.0,0,0,0
14290,14290,'should return entry action defined on parallel state',0.0,0,0,0
14291,14291,'should return error response for hoc auth wrappers in edge runtime',0.0,0,0,0
14292,14292,'should return events for a machine',0.0,0,0,0
14293,14293,'should return events for a typegened machine',0.0,0,0,0
14294,14294,'should return events for an interpreter',0.0,0,0,0
14295,14295,'should return events for createModel',0.0,0,0,0
14296,14296,'should return fallback for non-crawler correctly',0.0,0,0,0
14297,14297,'should return false for a forbidden transition',0.0,0,0,0
14298,14298,'should return false for an unknown event',0.0,0,0,0
14299,14299,'should return false for states created without a machine',0.0,0,0,0
14300,14300,'should return false if a state is not a substate of a superstate',0.0,0,0,0
14301,14301,'should return false if a state value is not a substate of a superstate value',0.0,0,0,0
14302,14302,'should return false if an ancestor element is display none',0.0,0,0,0
14303,14303,'should return false if an ancestor element is visibility hidden',0.0,0,0,0
14304,14304,'should return false if body is not overflowing',0.0,0,0,0
14305,14305,'should return false if parent state is more specific than child state',0.0,0,0,0
14306,14306,"'should return false if the element has disabled attribute with ""false"" value, or doesn\'t have attribute'",0.0,0,0,0
14307,14307,"'should return false if the element is hidden, but not via display or visibility'",0.0,0,0,0
14308,14308,'should return false if the element is not defined',0.0,0,0,0
14309,14309,'should return false if the element is not disabled ',0.0,0,0,0
14310,14310,'should return false if the element is not visible with display none',0.0,0,0,0
14311,14311,'should return false if the element is not visible with visibility hidden',0.0,0,0,0
14312,14312,'should return false if the element provided is not a dom element',0.0,0,0,0
14313,14313,'should return false if there is no content',0.0,0,0,0
14314,14314,'should return false if there is no webpack config',0.0,0,0,0
14315,14315,'should return false if two state values are not equivalent',0.0,0,0,0
14316,14316,'should return false if two states are not equivalent',0.0,0,0,0
14317,14317,'should return false when a guarded transition disallows the transition',0.0,0,0,0
14318,14318,"'should return filtered list, should ignore case'",0.0,0,0,0
14319,14319,'should return first component if pagePerSection and hash is empty',0.0,0,0,0
14320,14320,"'should return first element if active not exists or not given and shouldGetNext is either true, or false with cycling being disabled'",0.0,0,0,0
14321,14321,'should return first section if pagePerSection and hash is empty',0.0,0,0,0
14322,14322,'should return icon',0.0,0,0,0
14323,14323,'should return important part of hash if it contains component name',0.0,0,0,0
14324,14324,'should return initial list with empty query',0.0,0,0,0
14325,14325,'should return jQuery object when present',0.0,0,0,0
14326,14326,'should return jpg',0.0,0,0,0
14327,14327,'should return last element if active not exists or not given and shouldGetNext is false but cycling is enabled',0.0,0,0,0
14328,14328,'should return modal instance',0.0,0,0,0
14329,14329,'should return multiple paths for equivalent transitions',0.0,0,0,0
14330,14330,'should return nested actions in the correct (child to parent) order',0.0,0,0,0
14331,14331,'should return nested sections',0.0,0,0,0
14332,14332,'should return new instance when there is no Offcanvas instance',0.0,0,0,0
14333,14333,'should return new instance when there is no alert instance',0.0,0,0,0
14334,14334,'should return new instance when there is no button instance',0.0,0,0,0
14335,14335,'should return new instance when there is no carousel instance with given configuration',0.0,0,0,0
14336,14336,'should return new instance when there is no carousel instance',0.0,0,0,0
14337,14337,'should return new instance when there is no collapse instance with given configuration',0.0,0,0,0
14338,14338,'should return new instance when there is no collapse instance',0.0,0,0,0
14339,14339,'should return new instance when there is no dropdown instance with given configuration',0.0,0,0,0
14340,14340,'should return new instance when there is no dropdown instance',0.0,0,0,0
14341,14341,'should return new instance when there is no modal instance with given configuration',0.0,0,0,0
14342,14342,'should return new instance when there is no modal instance',0.0,0,0,0
14343,14343,'should return new instance when there is no offcanvas instance with given configuration',0.0,0,0,0
14344,14344,'should return new instance when there is no popover instance with given configuration',0.0,0,0,0
14345,14345,'should return new instance when there is no popover instance',0.0,0,0,0
14346,14346,'should return new instance when there is no scrollspy instance with given configuration',0.0,0,0,0
14347,14347,'should return new instance when there is no scrollspy instance',0.0,0,0,0
14348,14348,'should return new instance when there is no tab instance',0.0,0,0,0
14349,14349,'should return new instance when there is no toast instance with given configuration',0.0,0,0,0
14350,14350,'should return new instance when there is no toast instance',0.0,0,0,0
14351,14351,'should return new instance when there is no tooltip instance with given configuration',0.0,0,0,0
14352,14352,'should return new instance when there is no tooltip instance',0.0,0,0,0
14353,14353,"'should return next element or first, if is last and ""isCycleAllowed = true""'",0.0,0,0,0
14354,14354,'should return next element or same if is last',0.0,0,0,0
14355,14355,'should return next element with an extra element between',0.0,0,0,0
14356,14356,'should return next element with comments or text nodes between',0.0,0,0,0
14357,14357,'should return next element',0.0,0,0,0
14358,14358,'should return no paths if the target does not match the last entered state',0.0,0,0,0
14359,14359,'should return non-empty required field as is',0.0,0,0,0
14360,14360,'should return not return elements with negative tab index',0.0,0,0,0
14361,14361,'should return null for unknown elements',0.0,0,0,0
14362,14362,'should return null for unknown keys',0.0,0,0,0
14363,14363,'should return null if a selector from a href is a url without an anchor',0.0,0,0,0
14364,14364,'should return null if all slots render null',0.0,0,0,0
14365,14365,'should return null if element not found',0.0,0,0,0
14366,14366,'should return null if no selector',0.0,0,0,0
14367,14367,'should return null if selector not found',0.0,0,0,0
14368,14368,'should return null if shadow dom is not available',0.0,0,0,0
14369,14369,'should return null if the ribbon is not present in the config',0.0,0,0,0
14370,14370,'should return null if there is no instance',0.0,0,0,0
14371,14371,'should return null in pages',0.0,0,0,0
14372,14372,'should return null stringified when null is passed',0.0,0,0,0
14373,14373,'should return null when component has no name',0.0,0,0,0
14374,14374,'should return null when the list is empty',0.0,0,0,0
14375,14375,'should return null when there is no alert instance',0.0,0,0,0
14376,14376,'should return null when there is no button instance',0.0,0,0,0
14377,14377,'should return null when there is no carousel instance',0.0,0,0,0
14378,14378,'should return null when there is no collapse instance',0.0,0,0,0
14379,14379,'should return null when there is no dropdown instance',0.0,0,0,0
14380,14380,'should return null when there is no instance',0.0,0,0,0
14381,14381,'should return null when there is no modal instance',0.0,0,0,0
14382,14382,'should return null when there is no offcanvas instance',0.0,0,0,0
14383,14383,'should return null when there is no popover instance',0.0,0,0,0
14384,14384,'should return null when there is no toast instance',0.0,0,0,0
14385,14385,'should return null when there is no tooltip instance',0.0,0,0,0
14386,14386,'should return null when we do not find a shadow root',0.0,0,0,0
14387,14387,'should return object with package.json contents',0.0,0,0,0
14388,14388,'should return offcanvas instance',0.0,0,0,0
14389,14389,'should return one component',0.0,0,0,0
14390,14390,'should return one element',0.0,0,0,0
14391,14391,'should return one example from a component',0.0,0,0,0
14392,14392,'should return one example from a section',0.0,0,0,0
14393,14393,'should return one section',0.0,0,0,0
14394,14394,'should return only elements with specific tag names',0.0,0,0,0
14395,14395,'should return optional options for a typegen-based machine by default',0.0,0,0,0
14396,14396,'should return options for a typegen-less machine',0.0,0,0,0
14397,14397,'should return parents',0.0,0,0,0
14398,14398,'should return path to Create React App Webpack config',0.0,0,0,0
14399,14399,'should return plugin NAME',0.0,0,0,0
14400,14400,'should return plugin data key',0.0,0,0,0
14401,14401,'should return plugin default config',0.0,0,0,0
14402,14402,'should return plugin default type config',0.0,0,0,0
14403,14403,'should return plugin default type',0.0,0,0,0
14404,14404,'should return plugin defaults',0.0,0,0,0
14405,14405,'should return plugin event key',0.0,0,0,0
14406,14406,'should return plugin name',0.0,0,0,0
14407,14407,'should return plugin version',0.0,0,0,0
14408,14408,'should return png',0.0,0,0,0
14409,14409,'should return popover instance',0.0,0,0,0
14410,14410,'should return possible state values from a typegened machine',0.0,0,0,0
14411,14411,'should return prerendered page for correctly',0.0,0,0,0
14412,14412,'should return previous element or same if is first',0.0,0,0,0
14413,14413,'should return previous element with an extra element between',0.0,0,0,0
14414,14414,'should return previous element with comments or text nodes between',0.0,0,0,0
14415,14415,'should return previous element',0.0,0,0,0
14416,14416,'should return production Webpack config',0.0,0,0,0
14417,14417,'should return require statement for @example doclet only when the file exists',0.0,0,0,0
14418,14418,'should return require statement for @example doclet',0.0,0,0,0
14419,14419,'should return required options for a typegen-based machine with a flag',0.0,0,0,0
14420,14420,'should return scrollspy instance',0.0,0,0,0
14421,14421,"'should return section name for example isolation mode, if no components are passed'",0.0,0,0,0
14422,14422,'should return section name for section isolation mode',0.0,0,0,0
14423,14423,'should return settings as an empty object',0.0,0,0,0
14424,14424,'should return state from a machine with context',0.0,0,0,0
14425,14425,'should return state from a machine without context',0.0,0,0,0
14426,14426,'should return state from a service created based on a model without any concrete events',0.0,0,0,0
14427,14427,'should return state type from a service that has concrete event type',0.0,0,0,0
14428,14428,'should return style guide title for the all view',0.0,0,0,0
14429,14429,'should return superstate mapping when deep substate is not found',0.0,0,0,0
14430,14430,'should return superstate mapping when substate is not found',0.0,0,0,0
14431,14431,'should return svg',0.0,0,0,0
14432,14432,'should return tab instance',0.0,0,0,0
14433,14433,'should return that',0.0,0,0,0
14434,14434,'should return the `vary` header from edge runtime',0.0,0,0,0
14435,14435,'should return the `vary` header from pages for flight requests',0.0,0,0,0
14436,14436,'should return the anchor if a selector from a href is a url',0.0,0,0,0
14437,14437,'should return the correct initial state (deep parallel)',0.0,0,0,0
14438,14438,'should return the correct initial state (parallel)',0.0,0,0,0
14439,14439,'should return the correct initial state',0.0,0,0,0
14440,14440,'should return the created tip element',0.0,0,0,0
14441,14441,'should return the decoded targetName when router name is not English such as Chinese',0.0,0,0,0
14442,14442,'should return the entry actions of an initial state (deep)',0.0,0,0,0
14443,14443,'should return the entry actions of an initial state (parallel)',0.0,0,0,0
14444,14444,'should return the entry actions of an initial state',0.0,0,0,0
14445,14445,'should return the entry and exit actions of a deep transition',0.0,0,0,0
14446,14446,'should return the entry and exit actions of a nested transition',0.0,0,0,0
14447,14447,'should return the entry and exit actions of a transition',0.0,0,0,0
14448,14448,'should return the equivalent state if no transition occurs',0.0,0,0,0
14449,14449,'should return the file name without extension',0.0,0,0,0
14450,14450,'should return the first mapping found of a state',0.0,0,0,0
14451,14451,'should return the initial state value',0.0,0,0,0
14452,14452,'should return the initial state',0.0,0,0,0
14453,14453,'should return the instance when exists without given configuration',0.0,0,0,0
14454,14454,'should return the module',0.0,0,0,0
14455,14455,'should return the same on empty string',0.0,0,0,0
14456,14456,'should return the set of events accepted by machine',0.0,0,0,0
14457,14457,'should return the shadow root when found',0.0,0,0,0
14458,14458,'should return the title',0.0,0,0,0
14459,14459,'should return this instance',0.0,0,0,0
14460,14460,'should return to a previous slide if the provided index is lower than the current',0.0,0,0,0
14461,14461,'should return toast instance',0.0,0,0,0
14462,14462,'should return tooltip instance',0.0,0,0,0
14463,14463,'should return top level section',0.0,0,0,0
14464,14464,'should return true for a simple event that results in a transition to a different state',0.0,0,0,0
14465,14465,'should return true for a targetless transition with actions',0.0,0,0,0
14466,14466,'should return true for an event object that results in a context change',0.0,0,0,0
14467,14467,'should return true for an event object that results in a new action',0.0,0,0,0
14468,14468,'should return true for an event object that results in a transition to a different state',0.0,0,0,0
14469,14469,'should return true for an external self-transition with reentry action',0.0,0,0,0
14470,14470,'should return true for an external self-transition with transition action',0.0,0,0,0
14471,14471,'should return true for an external self-transition without actions',0.0,0,0,0
14472,14472,'should return true if a parallel state value is a substate of a superstate value',0.0,0,0,0
14473,14473,'should return true if a state is a substate of a superstate',0.0,0,0,0
14474,14474,'should return true if a state value is a substate of a superstate value',0.0,0,0,0
14475,14475,"'should return true if an ancestor element is visibility hidden, but reverted'",0.0,0,0,0
14476,14476,'should return true if body is overflowing',0.0,0,0,0
14477,14477,'should return true if its a closed details element',0.0,0,0,0
14478,14478,"'should return true if the element has class ""disabled"" but disabled attribute is false'",0.0,0,0,0
14479,14479,"'should return true if the element has class ""disabled""'",0.0,0,0,0
14480,14480,'should return true if the element has disabled attribute',0.0,0,0,0
14481,14481,'should return true if the element is a visible summary in a closed details element',0.0,0,0,0
14482,14482,'should return true if the element is not defined',0.0,0,0,0
14483,14483,'should return true if the element is visible inside an open details element',0.0,0,0,0
14484,14484,'should return true if the element is visible',0.0,0,0,0
14485,14485,'should return true if the element provided is not a dom element',0.0,0,0,0
14486,14486,'should return true if there is content',0.0,0,0,0
14487,14487,'should return true if two parallel states are equivalent',0.0,0,0,0
14488,14488,'should return true if two state values are equivalent',0.0,0,0,0
14489,14489,'should return true if two states are equivalent',0.0,0,0,0
14490,14490,'should return true when a guarded transition allows the transition',0.0,0,0,0
14491,14491,'should return true when non-first parallel region changes value',0.0,0,0,0
14492,14492,'should return true when transition targets a state that is already part of the current configuration but the final state value changes',0.0,0,0,0
14493,14493,'should return type name',0.0,0,0,0
14494,14494,'should return undefined for unmapped states',0.0,0,0,0
14495,14495,'should return undefined if a file doesn’t exist',0.0,0,0,0
14496,14496,'should return undefined if no runtime is specified',0.0,0,0,0
14497,14497,'should return undefined stringified when undefined is passed',0.0,0,0,0
14498,14498,'should return undefined when no sections found',0.0,0,0,0
14499,14499,'should return valid pathname',0.0,0,0,0
14500,14500,"'should return valid, parsable JS'",0.0,0,0,0
14501,14501,'should return value-based paths',0.0,0,0,0
14502,14502,'should return version number',0.0,0,0,0
14503,14503,'should return version',0.0,0,0,0
14504,14504,'should return webp',0.0,0,0,0
14505,14505,'should return webpackConfig option as is',0.0,0,0,0
14506,14506,'should return webpackConfig with user webpack config',0.0,0,0,0
14507,14507,'should reuse the inline flight response without sending extra requests',0.0,0,0,0
14508,14508,'should revalidate all fetches during on-demand revalidate',0.0,0,0,0
14509,14509,'should revalidate correctly with config and fetch revalidate',0.0,0,0,0
14510,14510,'should revalidate on-demand revalidate with preview cookie',0.0,0,0,0
14511,14511,'should revalidate the page when revalidate is configured',0.0,0,0,0
14512,14512,'should reveal the current state after transition',0.0,0,0,0
14513,14513,'should reveal the current state',0.0,0,0,0
14514,14514,'should rewrite correctly for non-SSG/SSP page',0.0,0,0,0
14515,14515,'should rewrite correctly when navigating via history after query update',0.0,0,0,0
14516,14516,'should rewrite correctly when navigating via history',0.0,0,0,0
14517,14517,'should rewrite from middleware correctly',0.0,0,0,0
14518,14518,'should rewrite from next.config.js correctly',0.0,0,0,0
14519,14519,'should rewrite the same for direct visit and client-transition',0.0,0,0,0
14520,14520,'should rewrite to fallback: true page successfully',0.0,0,0,0
14521,14521,'should rewrite with basePath by default',0.0,0,0,0
14522,14522,'should rewrite without basePath when set to false',0.0,0,0,0
14523,14523,'should run data fetch in parallel',0.0,0,0,0
14524,14524,'should run data in layout and page',0.0,0,0,0
14525,14525,'should run services in parallel',0.0,0,0,0
14526,14526,'should run the edge instrumentation compiled version with the edge runtime',0.0,0,0,0
14527,14527,'should run the instrumentation hook',0.0,0,0,0
14528,14528,'should sanitize template and work with multiple regex',0.0,0,0,0
14529,14529,'should sanitize template by removing tags with XSS',0.0,0,0,0
14530,14530,'should schedule events in a FIFO queue',0.0,0,0,0
14531,14531,'should scroll to the specified hash',0.0,0,0,0
14532,14532,'should scroll to top of document if possible while giving focus to page',0.0,0,0,0
14533,14533,'should scroll to top of document when navigating between to pages without layout when',0.0,0,0,0
14534,14534,'should scroll to top of document when navigating between to pages without layout',0.0,0,0,0
14535,14535,'should scroll when clicking in JS',0.0,0,0,0
14536,14536,'should select eventless transition before processing raised events (with `always`)',0.0,0,0,0
14537,14537,'should select eventless transition before processing raised events',0.0,0,0,0
14538,14538,'should select eventless transition for array `.on` config',0.0,0,0,0
14539,14539,'should select subsequent transient transitions even in absence of other transitions',0.0,0,0,0
14540,14540,'should select wildcard over explicit event type for array `.on` config (according to document order)',0.0,0,0,0
14541,14541,'should send web vitals to Vercel analytics',0.0,0,0,0
14542,14542,'should send web-vitals to vercel-insights',0.0,0,0,0
14543,14543,'should separate Markdown and component examples',0.0,0,0,0
14544,14544,'should serialize the machine',0.0,0,0,0
14545,14545,'should serve /index as separate page',0.0,0,0,0
14546,14546,'should serve app path with %5F',0.0,0,0,0
14547,14547,'should serve app/page.server.js at /',0.0,0,0,0
14548,14548,'should serve client-side',0.0,0,0,0
14549,14549,'should serve dynamic parameter',0.0,0,0,0
14550,14550,'should serve dynamic route from pages',0.0,0,0,0
14551,14551,'should serve from app',0.0,0,0,0
14552,14552,'should serve from pages',0.0,0,0,0
14553,14553,'should serve from public',0.0,0,0,0
14554,14554,'should serve nested parent',0.0,0,0,0
14555,14555,'should serve page as a segment name correctly',0.0,0,0,0
14556,14556,'should serve pages path with underscore',0.0,0,0,0
14557,14557,'should serve polyfills for browsers that do not support modules',0.0,0,0,0
14558,14558,'should serve public file with basePath correctly',0.0,0,0,0
14559,14559,'should serve server-side',0.0,0,0,0
14560,14560,'should serve shared component',0.0,0,0,0
14561,14561,'should server prerendered path correctly for SSG pages that starts with api-docs',0.0,0,0,0
14562,14562,'should set .modal\'s scroll top to 0',0.0,0,0,0
14563,14563,'should set aliases',0.0,0,0,0
14564,14564,'should set all components’ modules as a global variables',0.0,0,0,0
14565,14565,'should set an interval',0.0,0,0,0
14566,14566,'should set components’ displayName to a name property',0.0,0,0,0
14567,14567,'should set data attribute in kebab case',0.0,0,0,0
14568,14568,'should set data attribute prefixed with bs',0.0,0,0,0
14569,14569,'should set default caching header',0.0,0,0,0
14570,14570,'should set delay to undefined if expression not found',0.0,0,0,0
14571,14571,'should set fetch user agent correctly',0.0,0,0,0
14572,14572,'should set initialState before the first render',0.0,0,0,0
14573,14573,'should set is transitioning if fade class is present',0.0,0,0,0
14574,14574,'should set modal body scroll top to 0 if modal body do not exists',0.0,0,0,0
14575,14575,'should set phases correctly',0.0,0,0,0
14576,14576,'should set query correctly',0.0,0,0,0
14577,14577,'should set the correct href for items when isolated links should be used',0.0,0,0,0
14578,14578,'should set the correct href for items',0.0,0,0,0
14579,14579,'should set the return value of getComponent as a global variable',0.0,0,0,0
14580,14580,'should set tip content',0.0,0,0,0
14581,14581,'should set title and content from functions',0.0,0,0,0
14582,14582,'should set two set-cookie headers',0.0,0,0,0
14583,14583,'should setup custom logger function',0.0,0,0,0
14584,14584,'should setup debug logger in verbose mode',0.0,0,0,0
14585,14585,'should should call show method',0.0,0,0,0
14586,14586,'should show 404 for page not under the /docs prefix',0.0,0,0,0
14587,14587,'should show a collapsed element on width',0.0,0,0,0
14588,14588,'should show a collapsed element',0.0,0,0,0
14589,14589,'should show a dropdown',0.0,0,0,0
14590,14590,'should show a hidden element',0.0,0,0,0
14591,14591,'should show a modal and append the element',0.0,0,0,0
14592,14592,'should show a modal without backdrop',0.0,0,0,0
14593,14593,'should show a modal',0.0,0,0,0
14594,14594,'should show a popover with just content without having header',0.0,0,0,0
14595,14595,'should show a popover with just title without having body using data-attribute to get config',0.0,0,0,0
14596,14596,'should show a popover with just title without having body',0.0,0,0,0
14597,14597,'should show a popover with provided custom class',0.0,0,0,0
14598,14598,'should show a popover',0.0,0,0,0
14599,14599,'should show a tooltip on mobile',0.0,0,0,0
14600,14600,'should show a tooltip relative to placement option',0.0,0,0,0
14601,14601,'should show a tooltip when hovering a child element',0.0,0,0,0
14602,14602,'should show a tooltip with a dom element container',0.0,0,0,0
14603,14603,'should show a tooltip with a jquery element container',0.0,0,0,0
14604,14604,'should show a tooltip with a selector in container',0.0,0,0,0
14605,14605,'should show a tooltip with custom class provided as a function in config',0.0,0,0,0
14606,14606,'should show a tooltip with custom class provided as a string in config',0.0,0,0,0
14607,14607,'should show a tooltip with custom class provided in data attributes',0.0,0,0,0
14608,14608,'should show a tooltip with placement as a function',0.0,0,0,0
14609,14609,'should show a tooltip without the animation',0.0,0,0,0
14610,14610,'should show a tooltip',0.0,0,0,0
14611,14611,'should show an error path trace',0.0,0,0,0
14612,14612,'should show and hide a dropdown',0.0,0,0,0
14613,14613,'should show and hide backdrop after counting transition duration if it is animated',0.0,0,0,0
14614,14614,'should show and hide backdrop without a delay if it is not animated',0.0,0,0,0
14615,14615,'should show error for accessing res after gssp returns',0.0,0,0,0
14616,14616,'should show error for accessing res through props promise after gssp returns',0.0,0,0,0
14617,14617,'should show error for extra keys returned from getServerSideProps',0.0,0,0,0
14618,14618,'should show error for invalid JSON returned from getServerSideProps',0.0,0,0,0
14619,14619,'should show error for invalid JSON returned from getStaticProps on CST',0.0,0,0,0
14620,14620,'should show error for invalid JSON returned from getStaticProps on SSR',0.0,0,0,0
14621,14621,'should show error overlay for /',0.0,0,0,0
14622,14622,'should show error overlay for /another',0.0,0,0,0
14623,14623,'should show fallback before invalid JSON is returned from getStaticProps',0.0,0,0,0
14624,14624,'should show layout eagerly when prefetched with loading one level down',0.0,0,0,0
14625,14625,'should show meta data in transitions',0.0,0,0,0
14626,14626,'should show meta data',0.0,0,0,0
14627,14627,'should show multiple collapsed elements',0.0,0,0,0
14628,14628,'should show that a machine has not reached its final state',0.0,0,0,0
14629,14629,'should show that a machine has reached its final state',0.0,0,0,0
14630,14630,'should show the hello page under the /docs prefix',0.0,0,0,0
14631,14631,'should show the other-page page under the /docs prefix',0.0,0,0,0
14632,14632,'should show the version on state nodes',0.0,0,0,0
14633,14633,'should show tooltip if leave event hasn\'t occurred before delay expires',0.0,0,0,0
14634,14634,'should show warning every time page with large amount of page data is returned',0.0,0,0,0
14635,14635,'should show warning when large amount of page data is returned',0.0,0,0,0
14636,14636,'should skip adding when existing (longhand)',0.0,0,0,0
14637,14637,'should skip adding when existing (shorthand)',0.0,0,0,0
14638,14638,'should skip adding when unrelated',0.0,0,0,0
14639,14639,'should skip cache in draft mode',0.0,0,0,0
14640,14640,'should skip components without example file',0.0,0,0,0
14641,14641,'should skip deploy',0.0,0,0,0
14642,14642,'should skip dev',0.0,0,0,0
14643,14643,'should skip disabled element when using keyboard navigation',0.0,0,0,0
14644,14644,'should skip for deploy for now',0.0,0,0,0
14645,14645,'should skip for deploy mode for now',0.0,0,0,0
14646,14646,'should skip for deploy temporarily',0.0,0,0,0
14647,14647,'should skip for deploy',0.0,0,0,0
14648,14648,'should skip for non-next start',0.0,0,0,0
14649,14649,'should skip hidden element when using keyboard navigation',0.0,0,0,0
14650,14650,'should skip next deploy for now',0.0,0,0,0
14651,14651,'should skip next deploy',0.0,0,0,0
14652,14652,'should skip next dev for now',0.0,0,0,0
14653,14653,'should skip sections without matches inside',0.0,0,0,0
14654,14654,'should skip temporarily',0.0,0,0,0
14655,14655,'should skip tests for next-deploy and react 17',0.0,0,0,0
14656,14656,"'should skip when present (multi, array)'",0.0,0,0,0
14657,14657,"'should skip when present (multi, array, wrong order)'",0.0,0,0,0
14658,14658,'should skip',0.0,0,0,0
14659,14659,'should smoothScroll to the proper observable element on anchor click',0.0,0,0,0
14660,14660,'should smoothscroll to observable with anchor link that contains a french word as id',0.0,0,0,0
14661,14661,'should soft push',0.0,0,0,0
14662,14662,'should sort edge SSR routes correctly',0.0,0,0,0
14663,14663,'should sort mixed props (required props should come first)',0.0,0,0,0
14664,14664,'should sort optional props',0.0,0,0,0
14665,14665,'should sort properties by default',0.0,0,0,0
14666,14666,'should sort required props',0.0,0,0,0
14667,14667,'should spawn null actors if not used within a service',0.0,0,0,0
14668,14668,'should specify the correct document order for each state node',0.0,0,0,0
14669,14669,'should ssr dynamically when detected automatically with fetch cache option',0.0,0,0,0
14670,14670,'should ssr dynamically when forced via config',0.0,0,0,0
14671,14671,'should start activities',0.0,0,0,0
14672,14672,'should start all services at once',0.0,0,0,0
14673,14673,'should start cycling if `ride`===`carousel`',0.0,0,0,0
14674,14674,'should start deeply nested service (machine as invoke config)',0.0,0,0,0
14675,14675,"'should start services (explicit machine, invoke = config)'",0.0,0,0,0
14676,14676,"'should start services (explicit machine, invoke = machine)'",0.0,0,0,0
14677,14677,'should start services (external machines)',0.0,0,0,0
14678,14678,'should start services (machine as invoke config)',0.0,0,0,0
14679,14679,'should start the service with initial state by default',0.0,0,0,0
14680,14680,'should stay at the start when the prev method is called and wrap is false',0.0,0,0,0
14681,14681,'should stay on the same state for undefined transitions',0.0,0,0,0
14682,14682,'should stick to the url without trailing /page suffix',0.0,0,0,0
14683,14683,'should still auto hide after being interacted with mouse and keyboard',0.0,0,0,0
14684,14684,'should stop a child actor when reaching a final state',0.0,0,0,0
14685,14685,'should stop activities upon stopping the service',0.0,0,0,0
14686,14686,'should stop activities',0.0,0,0,0
14687,14687,'should stop machine if unhandled error and on strict mode (async)',0.0,0,0,0
14688,14688,'should stop processing events if error condition is met',0.0,0,0,0
14689,14689,'should store data for an element with a given key and return it',0.0,0,0,0
14690,14690,'should strip comments and spaces from css',0.0,0,0,0
14691,14691,'should strongly type action implementations with model.createMachine(...)',0.0,0,0,0
14692,14692,'should strongly type action implementations',0.0,0,0,0
14693,14693,'should successfully detect app route during prefetch',0.0,0,0,0
14694,14694,'should successfully serialize value with unsafe toJSON when serializer manages to replace it',0.0,0,0,0
14695,14695,'should supply params values for catchall correctly',0.0,0,0,0
14696,14696,'should supply query values SSR',0.0,0,0,0
14697,14697,'should support .bind',0.0,0,0,0
14698,14698,'should support 9.4 regression',0.0,0,0,0
14699,14699,'should support Fragment syntax',0.0,0,0,0
14700,14700,'should support HMR for CSS imports in client components',0.0,0,0,0
14701,14701,'should support HMR for CSS imports in server components',0.0,0,0,0
14702,14702,'should support HMR with sass/scss',0.0,0,0,0
14703,14703,'should support Link with basePath prefixed',0.0,0,0,0
14704,14704,'should support `basePath`',0.0,0,0,0
14705,14705,'should support actions from client without JS',0.0,0,0,0
14706,14706,'should support alternate tags',0.0,0,0,0
14707,14707,'should support appLinks tags',0.0,0,0,0
14708,14708,'should support apple related tags `itunes` and `appWebApp`',0.0,0,0,0
14709,14709,'should support babel in app dir',0.0,0,0,0
14710,14710,'should support babel-style memoized function',0.0,0,0,0
14711,14711,'should support basic complex descriptor icons field',0.0,0,0,0
14712,14712,'should support basic object icons field',0.0,0,0,0
14713,14713,'should support basic string icons field',0.0,0,0,0
14714,14714,'should support chained .bind',0.0,0,0,0
14715,14715,'should support class exports 2',0.0,0,0,0
14716,14716,'should support class exports',0.0,0,0,0
14717,14717,'should support combinatorial machines (single-state)',0.0,0,0,0
14718,14718,'should support commonjs',0.0,0,0,0
14719,14719,'should support css modules inside client components',0.0,0,0,0
14720,14720,'should support css modules inside client layouts',0.0,0,0,0
14721,14721,'should support css modules inside client page',0.0,0,0,0
14722,14722,'should support css modules inside client pages',0.0,0,0,0
14723,14723,'should support css modules inside server layouts',0.0,0,0,0
14724,14724,'should support css modules inside server pages',0.0,0,0,0
14725,14725,'should support default twitter app card',0.0,0,0,0
14726,14726,'should support default twitter player card',0.0,0,0,0
14727,14727,'should support default twitter summary card',0.0,0,0,0
14728,14728,'should support default twitter summary_large_image card',0.0,0,0,0
14729,14729,'should support edge runtime of image routes',0.0,0,0,0
14730,14730,'should support etag header in the web server',0.0,0,0,0
14731,14731,'should support export { _ as default } with a class',0.0,0,0,0
14732,14732,'should support export { _ as default } with other specifiers',0.0,0,0,0
14733,14733,'should support export { _ as default }',0.0,0,0,0
14734,14734,'should support exporting multiple star re-exports',0.0,0,0,0
14735,14735,'should support external css imports',0.0,0,0,0
14736,14736,'should support formData and redirect without JS',0.0,0,0,0
14737,14737,'should support formData and redirect',0.0,0,0,0
14738,14738,'should support full re-export',0.0,0,0,0
14739,14739,'should support generate multi images with generateImageMetadata',0.0,0,0,0
14740,14740,'should support generate multi sitemaps with generateSitemaps',0.0,0,0,0
14741,14741,'should support generateMetadata export',0.0,0,0,0
14742,14742,'should support global css inside client layouts',0.0,0,0,0
14743,14743,'should support global css inside client pages',0.0,0,0,0
14744,14744,'should support global css inside layout',0.0,0,0,0
14745,14745,'should support global css inside server pages',0.0,0,0,0
14746,14746,'should support global sass/scss inside client layouts',0.0,0,0,0
14747,14747,'should support global sass/scss inside client pages',0.0,0,0,0
14748,14748,'should support global sass/scss inside server layouts',0.0,0,0,0
14749,14749,'should support global sass/scss inside server pages',0.0,0,0,0
14750,14750,'should support headers and cookies',0.0,0,0,0
14751,14751,'should support headers in client imported actions',0.0,0,0,0
14752,14752,'should support hmr with conflicts',0.0,0,0,0
14753,14753,'should support hoc auth wrappers',0.0,0,0,0
14754,14754,'should support importing actions in client components',0.0,0,0,0
14755,14755,'should support importing the same action module instance in both server and action layers',0.0,0,0,0
14756,14756,'should support intercepting routes with a middleware rewrite',0.0,0,0,0
14757,14757,'should support intercepting with beforeFiles rewrites',0.0,0,0,0
14758,14758,'should support layout files in parallel routes',0.0,0,0,0
14759,14759,'should support lazy catchall route',0.0,0,0,0
14760,14760,'should support li > .dropdown-item',0.0,0,0,0
14761,14761,'should support multi-level server component imports',0.0,0,0,0
14762,14762,'should support multiple arguments',0.0,0,0,0
14763,14763,'should support native modules in server component',0.0,0,0,0
14764,14764,'should support nested lazy catchall route',0.0,0,0,0
14765,14765,'should support nested parallel routes',0.0,0,0,0
14766,14766,'should support next/link in server components',0.0,0,0,0
14767,14767,'should support next/script and render in correct order',0.0,0,0,0
14768,14768,'should support notFound (javascript disabled)',0.0,0,0,0
14769,14769,'should support notFound in generateMetadata',0.0,0,0,0
14770,14770,'should support notFound',0.0,0,0,0
14771,14771,'should support opengraph tags',0.0,0,0,0
14772,14772,'should support opengraph with article type',0.0,0,0,0
14773,14773,'should support other basic tags (edge)',0.0,0,0,0
14774,14774,'should support other basic tags',0.0,0,0,0
14775,14775,'should support parallel route tab bars',0.0,0,0,0
14776,14776,'should support parallel routes with no page component',0.0,0,0,0
14777,14777,'should support params as argument in dynamic routes',0.0,0,0,0
14778,14778,'should support partial hydration with inlined server data',0.0,0,0,0
14779,14779,'should support prerendered catchall route',0.0,0,0,0
14780,14780,'should support prerendered catchall-explicit route (nested)',0.0,0,0,0
14781,14781,'should support prerendered catchall-explicit route (single)',0.0,0,0,0
14782,14782,'should support redirect in generateMetadata',0.0,0,0,0
14783,14783,'should support rewrites on client-side navigation from pages to app with existing pages path',0.0,0,0,0
14784,14784,'should support rewrites on client-side navigation',0.0,0,0,0
14785,14785,'should support rewrites on initial load',0.0,0,0,0
14786,14786,'should support robots tags',0.0,0,0,0
14787,14787,'should support root dir robots.txt',0.0,0,0,0
14788,14788,'should support root level of favicon.ico',0.0,0,0,0
14789,14789,'should support router.back and router.forward',0.0,0,0,0
14790,14790,'should support sass/scss modules inside client layouts',0.0,0,0,0
14791,14791,'should support sass/scss modules inside client pages',0.0,0,0,0
14792,14792,'should support sass/scss modules inside server layouts',0.0,0,0,0
14793,14793,'should support sass/scss modules inside server pages',0.0,0,0,0
14794,14794,'should support setting cookies in route handlers with the correct overrides',0.0,0,0,0
14795,14795,'should support sitemap.xml under every routes',0.0,0,0,0
14796,14796,'should support stashed title in one layer of page and layout',0.0,0,0,0
14797,14797,'should support stashed title in two layers of page and layout',0.0,0,0,0
14798,14798,'should support static manifest.webmanifest',0.0,0,0,0
14799,14799,'should support streaming for flight response',0.0,0,0,0
14800,14800,'should support title and description',0.0,0,0,0
14801,14801,'should support title template',0.0,0,0,0
14802,14802,'should support updating the action',0.0,0,0,0
14803,14803,'should support uploading files',0.0,0,0,0
14804,14804,'should support verification tags',0.0,0,0,0
14805,14805,'should suspend on CSS imports if its slow on client navigation',0.0,0,0,0
14806,14806,'should suspense next/image in server components',0.0,0,0,0
14807,14807,'should suspense next/legacy/image in server components',0.0,0,0,0
14808,14808,'should sync spawned actor state when { sync: true }',0.0,0,0,0
14809,14809,'should take care of element either passed as a CSS selector or DOM element',0.0,0,0,0
14810,14810,'should terminate on a resolved final state',0.0,0,0,0
14811,14811,'should test nested states',0.0,0,0,0
14812,14812,'should test states by ID',0.0,0,0,0
14813,14813,'should test states by key',0.0,0,0,0
14814,14814,'should test states',0.0,0,0,0
14815,14815,'should test wildcard state for non-matching states',0.0,0,0,0
14816,14816,'should throw a 404 when no matching parallel route is found',0.0,0,0,0
14817,14817,'should throw an Error if it is not initialized',0.0,0,0,0
14818,14818,'should throw an error after a timeout',0.0,0,0,0
14819,14819,'should throw an error for transitions from invalid states',0.0,0,0,0
14820,14820,'should throw an error for transitions from invalid substates',0.0,0,0,0
14821,14821,'should throw an error for transitions to invalid states',0.0,0,0,0
14822,14822,'should throw an error for undefined next state config',0.0,0,0,0
14823,14823,'should throw an error for undefined states',0.0,0,0,0
14824,14824,'should throw an error if an event is sent to an uninitialized interpreter if { deferEvents: false }',0.0,0,0,0
14825,14825,'should throw an error if initial state sent to interpreter is invalid',0.0,0,0,0
14826,14826,'should throw an error if not given an event',0.0,0,0,0
14827,14827,'should throw an error on protected method',0.0,0,0,0
14828,14828,'should throw an error on undefined method',0.0,0,0,0
14829,14829,'should throw an error the element is not visible',0.0,0,0,0
14830,14830,'should throw an error when reaching a final state that does not match the predicate',0.0,0,0,0
14831,14831,"'should throw error if method ""constructor"" is being called'",0.0,0,0,0
14832,14832,'should throw error if unhandled (sync)',0.0,0,0,0
14833,14833,'should throw error on protected method',0.0,0,0,0
14834,14834,'should throw error on undefined method',0.0,0,0,0
14835,14835,'should throw error when returning a response object in pages/api in node runtime',0.0,0,0,0
14836,14836,'should throw error with <a> child',0.0,0,0,0
14837,14837,'should throw for guards with missing predicates',0.0,0,0,0
14838,14838,'should throw for invalid pathname',0.0,0,0,0
14839,14839,'should throw for removed options',0.0,0,0,0
14840,14840,'should throw for unacceptable events',0.0,0,0,0
14841,14841,'should throw for unknown options with suggestion',0.0,0,0,0
14842,14842,'should throw for unknown options',0.0,0,0,0
14843,14843,'should throw if assetsDir does not exist',0.0,0,0,0
14844,14844,'should throw if config has errors',0.0,0,0,0
14845,14845,'should throw if defaultExample does not exist',0.0,0,0,0
14846,14846,'should throw if getInitialProps is defined as an instance method',0.0,0,0,0
14847,14847,'should throw if module is not in the map',0.0,0,0,0
14848,14848,'should throw if required field is undefined',0.0,0,0,0
14849,14849,'should throw if string transition is not defined',0.0,0,0,0
14850,14850,'should throw when directory does not exist',0.0,0,0,0
14851,14851,'should throw when field is not a boolean',0.0,0,0,0
14852,14852,'should throw when field is not a function',0.0,0,0,0
14853,14853,'should throw when field is not a number',0.0,0,0,0
14854,14854,'should throw when field is not a string',0.0,0,0,0
14855,14855,'should throw when field is not an array',0.0,0,0,0
14856,14856,'should throw when field is not an object',0.0,0,0,0
14857,14857,'should throw when file does not exist',0.0,0,0,0
14858,14858,'should throw when hostname is missing',0.0,0,0,0
14859,14859,'should throw when old template as a string option passed',0.0,0,0,0
14860,14860,'should throw when parsing the full url with diff origin',0.0,0,0,0
14861,14861,'should throw when parsing the special prefix',0.0,0,0,0
14862,14862,'should throw when passed config file not found',0.0,0,0,0
14863,14863,'should throw when type in schema is incorrect',0.0,0,0,0
14864,14864,'should throw when using NextRequest with a relative URL',0.0,0,0,0
14865,14865,'should throw when using NextResponse.rewrite with a relative URL',0.0,0,0,0
14866,14866,'should throw when using Request with a relative URL',0.0,0,0,0
14867,14867,'should throw when using URL with a relative URL',0.0,0,0,0
14868,14868,'should throw with correct type name',0.0,0,0,0
14869,14869,'should throw with custom message returned by required function',0.0,0,0,0
14870,14870,'should toggle a centered dropdown',0.0,0,0,0
14871,14871,'should toggle a dropdown and add/remove event listener on mobile',0.0,0,0,0
14872,14872,'should toggle a dropdown at the right',0.0,0,0,0
14873,14873,'should toggle a dropdown with a dom node reference',0.0,0,0,0
14874,14874,'should toggle a dropdown with a jquery object reference',0.0,0,0,0
14875,14875,'should toggle a dropdown with a valid virtual element reference',0.0,0,0,0
14876,14876,'should toggle a dropdown with parent reference',0.0,0,0,0
14877,14877,'should toggle a dropdown',0.0,0,0,0
14878,14878,'should toggle a dropend',0.0,0,0,0
14879,14879,'should toggle a dropstart',0.0,0,0,0
14880,14880,'should toggle a dropup at the right',0.0,0,0,0
14881,14881,'should toggle a dropup centered',0.0,0,0,0
14882,14882,'should toggle a dropup',0.0,0,0,0
14883,14883,'should toggle active class on click',0.0,0,0,0
14884,14884,'should toggle aria-pressed',0.0,0,0,0
14885,14885,'should toggle enabled',0.0,0,0,0
14886,14886,'should toggle modal',0.0,0,0,0
14887,14887,'should transform Array-destructured hook return values use object destructuring',0.0,0,0,0
14888,14888,'should transform JSX to use a local identifier in CommonJS mode',0.0,0,0,0
14889,14889,'should transform JSX to use a local identifier in modern mode',0.0,0,0,0
14890,14890,'should transition after delay',0.0,0,0,0
14891,14891,'should transition correctly if callback function invoked from start and sends an event',0.0,0,0,0
14892,14892,'should transition correctly if callback function sends an event',0.0,0,0,0
14893,14893,'should transition correctly if child invocation causes it to directly go to final state',0.0,0,0,0
14894,14894,'should transition correctly if transient transition happens before current state invokes callback function and sends an event',0.0,0,0,0
14895,14895,'should transition correctly upon error (sync)',0.0,0,0,0
14896,14896,'should transition correctly',0.0,0,0,0
14897,14897,'should transition from deep initial nested states',0.0,0,0,0
14898,14898,'should transition from initial nested states',0.0,0,0,0
14899,14899,'should transition if condition based on event is met',0.0,0,0,0
14900,14900,'should transition if state node ID matches current state value',0.0,0,0,0
14901,14901,'should transition if string state path matches current state value',0.0,0,0,0
14902,14902,'should transition in correct order when there is a condition',0.0,0,0,0
14903,14903,'should transition in correct order',0.0,0,0,0
14904,14904,'should transition internally to the most recently visited state',0.0,0,0,0
14905,14905,'should transition only if condition is met',0.0,0,0,0
14906,14906,'should transition to nested states as target',0.0,0,0,0
14907,14907,'should transition to the deepest initial state',0.0,0,0,0
14908,14908,'should transpile specific external packages with the `transpilePackages` option',0.0,0,0,0
14909,14909,'should trap focus if scroll is allowed OR backdrop is enabled',0.0,0,0,0
14910,14910,'should trap focus',0.0,0,0,0
14911,14911,'should treat a callback source as an event stream',0.0,0,0,0
14912,14912,'should treat an interpreter as an actor',0.0,0,0,0
14913,14913,'should trigger error component when an error happens during rendering',0.0,0,0,0
14914,14914,'should trigger error component when an error happens during server components rendering',0.0,0,0,0
14915,14915,'should trigger middleware for data requests',0.0,0,0,0
14916,14916,'should trigger not-found client-side',0.0,0,0,0
14917,14917,'should trigger not-found in a client component',0.0,0,0,0
14918,14918,'should trigger not-found in a server component',0.0,0,0,0
14919,14919,'should trigger not-found while streaming',0.0,0,0,0
14920,14920,'should trigger transitionend event',0.0,0,0,0
14921,14921,"'should trigger transitionend if the carousel have carousel-item-next or carousel-item-prev class, cause is sliding'",0.0,0,0,0
14922,14922,'should try to parse element',0.0,0,0,0
14923,14923,'should typecheck `createMachine` for model without creators',0.0,0,0,0
14924,14924,'should unmount Wrapper component',0.0,0,0,0
14925,14925,'should update NODE_ENV',0.0,0,0,0
14926,14926,'should update code via props',0.0,0,0,0
14927,14927,'should update code with debounce',0.0,0,0,0
14928,14928,'should update dynamic params after mount correctly',0.0,0,0,0
14929,14929,'should update indicators if present',0.0,0,0,0
14930,14930,'should update removed experimental config into new config - complex key',0.0,0,0,0
14931,14931,'should update removed experimental config into new config',0.0,0,0,0
14932,14932,'should update snapshot value when actor changes',0.0,0,0,0
14933,14933,'should update state on setState',0.0,0,0,0
14934,14934,'should update the active element to the next item before sliding',0.0,0,0,0
14935,14935,'should update the context without modifying previous contexts',0.0,0,0,0
14936,14936,'should update the returned props object after enhancing from the updateDocs config option',0.0,0,0,0
14937,14937,'should update webpack config',0.0,0,0,0
14938,14938,'should use a fallback font in dev',0.0,0,0,0
14939,14939,'should use a proxy agent when proxy environment variable is set',0.0,0,0,0
14940,14940,'should use a wildcard when no guarded transition matches',0.0,0,0,0
14941,14941,'should use a wildcard when no transition matches',0.0,0,0,0
14942,14942,'should use an event generated based on schema.services for a dynamic internal event over the generated fallback',0.0,0,0,0
14943,14943,'should use canary react for app',0.0,0,0,0
14944,14944,'should use components option as the first sections if there’s no sections option',0.0,0,0,0
14945,14945,'should use correct caching headers for a no-revalidate page',0.0,0,0,0
14946,14946,'should use correct caching headers for a revalidate page',0.0,0,0,0
14947,14947,'should use default components option both components and sections options weren’t specified',0.0,0,0,0
14948,14948,'should use default error boundary for prod and overlay for dev when no error component specified',0.0,0,0,0
14949,14949,'should use editorConfig theme over highlightTheme',0.0,0,0,0
14950,14950,'should use embedded default example template if defaultExample=true',0.0,0,0,0
14951,14951,'should use initial rand when draft mode be disabled',0.0,0,0,0
14952,14952,'should use initial rand when draft mode is disabled on /index',0.0,0,0,0
14953,14953,'should use initial rand when draft mode is disabled on /with-cookies',0.0,0,0,0
14954,14954,'should use jQuery event system',0.0,0,0,0
14955,14955,'should use localhost for local prod and fallback to deployment url when metadataBase is falsy',0.0,0,0,0
14956,14956,'should use new root layout when provided',0.0,0,0,0
14957,14957,"'should use original title, if not ""data-bs-title"" is given'",0.0,0,0,0
14958,14958,'should use parent layout title when no title is defined in page',0.0,0,0,0
14959,14959,'should use stable react for pages',0.0,0,0,0
14960,14960,'should use text/x-component for flight with edge runtime',0.0,0,0,0
14961,14961,'should use text/x-component for flight',0.0,0,0,0
14962,14962,'should use the directory name if the file name is index.js',0.0,0,0,0
14963,14963,'should use the key as the ID if no ID is provided (state node)',0.0,0,0,0
14964,14964,'should use the key as the ID if no ID is provided',0.0,0,0,0
14965,14965,'should use the machine.initialState when an undefined state is given (unhandled event)',0.0,0,0,0
14966,14966,'should use the machine.initialState when an undefined state is given',0.0,0,0,0
14967,14967,'should use the not-found page for non-matching routes',0.0,0,0,0
14968,14968,'should use the same export type for packages in both ssr and client',0.0,0,0,0
14969,14969,'should use the same react in client app',0.0,0,0,0
14970,14970,'should use the same react in edge server app',0.0,0,0,0
14971,14971,'should use the same react in pages',0.0,0,0,0
14972,14972,'should use the same react in server app',0.0,0,0,0
14973,14973,'should use the service overwritten by withConfig',0.0,0,0,0
14974,14974,'should use theme variables',0.0,0,0,0
14975,14975,'should use urls with basepath in router events for cancelled routes',0.0,0,0,0
14976,14976,'should use urls with basepath in router events for failed route change',0.0,0,0,0
14977,14977,'should use urls with basepath in router events for hash changes',0.0,0,0,0
14978,14978,'should use urls with basepath in router events',0.0,0,0,0
14979,14979,'should verify the default locale works',0.0,0,0,0
14980,14980,'should wait before performing to if a slide is sliding',0.0,0,0,0
14981,14981,'should wait for a condition to be true and return the emitted value',0.0,0,0,0
14982,14982,'should warn for deprecated options',0.0,0,0,0
14983,14983,'should warn if a file cannot be parsed',0.0,0,0,0
14984,14984,'should warn if no componets are exported',0.0,0,0,0
14985,14985,'should warn on first usage and return props in correct order',0.0,0,0,0
14986,14986,'should warn the legacy object config export',0.0,0,0,0
14987,14987,'should warn when using NextResponse.redirect with a relative URL',0.0,0,0,0
14988,14988,'should warn when using Response.redirect with a relative URL',0.0,0,0,0
14989,14989,'should warn with empty eslint config in package.json',0.0,0,0,0
14990,14990,'should warn with empty eslintrc',0.0,0,0,0
14991,14991,'should work ',0.0,0,0,0
14992,14992,'should work correctly with output standalone',0.0,0,0,0
14993,14993,'should work for catch-all edge page',0.0,0,0,0
14994,14994,'should work for nested dynamic params client navigating',0.0,0,0,0
14995,14995,'should work for nested dynamic params',0.0,0,0,0
14996,14996,'should work for single dynamic param client navigating',0.0,0,0,0
14997,14997,'should work for single dynamic param',0.0,0,0,0
14998,14998,'should work if conflict with metadata routes convention',0.0,0,0,0
14999,14999,'should work in app route in node runtime',0.0,0,0,0
15000,15000,'should work in app route',0.0,0,0,0
15001,15001,'should work in initial html with mdx import',0.0,0,0,0
15002,15002,'should work in initial html',0.0,0,0,0
15003,15003,'should work in pages/api',0.0,0,0,0
15004,15004,'should work on invalid markup',0.0,0,0,0
15005,15005,'should work on parent with targetless transitions (in conditional array)',0.0,0,0,0
15006,15006,'should work to forbid events',0.0,0,0,0
15007,15007,'should work using browser with mdx import',0.0,0,0,0
15008,15008,'should work using browser',0.0,0,0,0
15009,15009,'should work using cheerio',0.0,0,0,0
15010,15010,'should work when navigating',0.0,0,0,0
15011,15011,'should work when requesting route handler after page',0.0,0,0,0
15012,15012,'should work when requesting the page directly',0.0,0,0,0
15013,15013,'should work with ID + relative path',0.0,0,0,0
15014,15014,'should work with JSDoc annnotated components',0.0,0,0,0
15015,15015,'should work with a StateSchema defined',0.0,0,0,0
15016,15016,'should work with a behavior',0.0,0,0,0
15017,15017,'should work with a component ',0.0,0,0,0
15018,15018,'should work with a component with rehydrated state config',0.0,0,0,0
15019,15019,'should work with a component with rehydrated state',0.0,0,0,0
15020,15020,'should work with a component',0.0,0,0,0
15021,15021,'should work with a custom comparison function',0.0,0,0,0
15022,15022,'should work with a finite observable',0.0,0,0,0
15023,15023,'should work with a hash-only `router.push(...)`',0.0,0,0,0
15024,15024,'should work with a hash-only href',0.0,0,0,0
15025,15025,'should work with a parallel StateSchema defined',0.0,0,0,0
15026,15026,'should work with a promise behavior (fulfill)',0.0,0,0,0
15027,15027,'should work with a promise behavior (reject)',0.0,0,0,0
15028,15028,'should work with a query-only href',0.0,0,0,0
15029,15029,'should work with a reducer behavior',0.0,0,0,0
15030,15030,'should work with a reducer',0.0,0,0,0
15031,15031,'should work with a service that uses TransitionConfigs for both targets',0.0,0,0,0
15032,15032,'should work with a service that uses a string for one target and a TransitionConfig for another',0.0,0,0,0
15033,15033,'should work with a service that uses strings for both targets',0.0,0,0,0
15034,15034,'should work with an array',0.0,0,0,0
15035,15035,'should work with an infinite observable',0.0,0,0,0
15036,15036,'should work with anonymous functions (with warning)',0.0,0,0,0
15037,15037,'should work with async functions',0.0,0,0,0
15038,15038,'should work with basic routes',0.0,0,0,0
15039,15039,'should work with both relative hashes and queries',0.0,0,0,0
15040,15040,'should work with brackets in API routes',0.0,0,0,0
15041,15041,'should work with brackets',0.0,0,0,0
15042,15042,'should work with built files',0.0,0,0,0
15043,15043,'should work with catch-all page',0.0,0,0,0
15044,15044,'should work with content existing in dest',0.0,0,0,0
15045,15045,'should work with custom document',0.0,0,0,0
15046,15046,'should work with defined string transitions (condition not met)',0.0,0,0,0
15047,15047,'should work with defined string transitions',0.0,0,0,0
15048,15048,'should work with dynamic catchall routes',0.0,0,0,0
15049,15049,'should work with dynamic path no generateStaticParams',0.0,0,0,0
15050,15050,'should work with dynamic routes',0.0,0,0,0
15051,15051,'should work with early request ending',0.0,0,0,0
15052,15052,'should work with fetch',0.0,0,0,0
15053,15053,'should work with forced dynamic path',0.0,0,0,0
15054,15054,'should work with function actions',0.0,0,0,0
15055,15055,'should work with generic context',0.0,0,0,0
15056,15056,'should work with guard objects',0.0,0,0,0
15057,15057,'should work with guards',0.0,0,0,0
15058,15058,'should work with hash links',0.0,0,0,0
15059,15059,'should work with html',0.0,0,0,0
15060,15060,'should work with invocations defined in orthogonal state nodes',0.0,0,0,0
15061,15061,'should work with nested folder with same name as basePath',0.0,0,0,0
15062,15062,'should work with nested index.js',0.0,0,0,0
15063,15063,'should work with normal dynamic page',0.0,0,0,0
15064,15064,'should work with notFound: true correctly',0.0,0,0,0
15065,15065,'should work with parallel routes',0.0,0,0,0
15066,15066,'should work with parameter itself in API routes',0.0,0,0,0
15067,15067,'should work with parameter itself',0.0,0,0,0
15068,15068,'should work with promised props',0.0,0,0,0
15069,15069,'should work with regions without states',0.0,0,0,0
15070,15070,'should work with route groups',0.0,0,0,0
15071,15071,'should work with static routes',0.0,0,0,0
15072,15072,'should work with substate nodes that have the same key',0.0,0,0,0
15073,15073,'should work with sync functions',0.0,0,0,0
15074,15074,'should work with tab id being an int',0.0,0,0,0
15075,15075,'should work with targetless transitions (in conditional array)',0.0,0,0,0
15076,15076,'should work with targetless transitions (in object)',0.0,0,0,0
15077,15077,'should work with transient transition on root (with `always`)',0.0,0,0,0
15078,15078,'should work with transient transition on root',0.0,0,0,0
15079,15079,'should work',0.0,0,0,0
15080,15080,'should wrap a component and pass classes',0.0,0,0,0
15081,15081,'should wrap around from end to start when wrap option is true',0.0,0,0,0
15082,15082,'should wrap code in Fragment when it starts with <',0.0,0,0,0
15083,15083,'should wrap focus around backwards on shift-tab',0.0,0,0,0
15084,15084,'should wrap focus around forward on tab',0.0,0,0,0
15085,15085,'show and shown events should reference correct relatedTarget',0.0,0,0,0
15086,15086,'show.bs.collapse',0.0,0,0,0
15087,15087,'show.bs.dropdown',0.0,0,0,0
15088,15088,'show.bs.modal',0.0,0,0,0
15089,15089,'show.bs.offcanvas',0.0,0,0,0
15090,15090,'show.bs.tab',0.0,0,0,0
15091,15091,'show.bs.toast',0.0,0,0,0
15092,15092,'show.bs.tooltip',0.0,0,0,0
15093,15093,'showFunction',0.0,0,0,0
15094,15094,'showcode option in example settings should overwrite style guide config option',0.0,0,0,0
15095,15095,'shown event should not be triggered if show is prevented',0.0,0,0,0
15096,15096,'shown event triggered',0.0,0,0,0
15097,15097,'shown.bs.modal',0.0,0,0,0
15098,15098,'shown.bs.offcanvas',0.0,0,0,0
15099,15099,'shown.bs.popover',0.0,0,0,0
15100,15100,'shown.bs.toast',0.0,0,0,0
15101,15101,'shownFunction',0.0,0,0,0
15102,15102,'shows code on click',0.0,0,0,0
15103,15103,'shows the table on button click',0.0,0,0,0
15104,15104,'shu',0.0,0,0,0
15105,15105,'sibling_descendant',0.0,0,0,0
15106,15106,'simple paths context',0.0,0,0,0
15107,15107,'simple paths equal transitions',0.0,0,0,0
15108,15108,'simple paths for reducers',0.0,0,0,0
15109,15109,'simple paths parallel',0.0,0,0,0
15110,15110,'simple',0.0,0,0,0
15111,15111,'since',0.0,0,0,0
15112,15112,'single expression',0.0,0,0,0
15113,15113,'single item array',0.0,0,0,0
15114,15114,'singleClickActivity',0.0,0,0,0
15115,15115,'sip:me@example.com',0.0,0,0,0
15116,15116,'siteId',0.0,0,0,0
15117,15117,'size = 1048576',0.0,0,0,0
15118,15118,'size',0.0,0,0,0
15119,15119,"'size: PropTypes.oneOf([""small"", ""normal"", ""large""])'",0.0,0,0,0
15120,15120,'skip test for dev mode',0.0,0,0,0
15121,15121,'slug page',0.0,0,0,0
15122,15122,'slug',0.0,0,0,0
15123,15123,'slug-1',0.0,0,0,0
15124,15124,'slug-2',0.0,0,0,0
15125,15125,'slug: [abc]',0.0,0,0,0
15126,15126,'slug: [slug]',0.0,0,0,0
15127,15127,'smooth',0.0,0,0,0
15128,15128,'sms:+123456789',0.0,0,0,0
15129,15129,'solarized',0.0,0,0,0
15130,15130,'some data',0.0,0,0,0
15131,15131,'some',0.0,0,0,0
15132,15132,'some-id.idle',0.0,0,0,0
15133,15133,'someAction',0.0,0,0,0
15134,15134,'someCallback',0.0,0,0,0
15135,15135,'someDelay',0.0,0,0,0
15136,15136,'someObjectAction',0.0,0,0,0
15137,15137,'somePromise',0.0,0,0,0
15138,15138,'someService',0.0,0,0,0
15139,15139,'someSource',0.0,0,0,0
15140,15140,'someState',0.0,0,0,0
15141,15141,'something else',0.0,0,0,0
15142,15142,'spawned actor ref should be compatible with the result of ActorRefFrom',0.0,0,0,0
15143,15143,'spy',0.0,0,0,0
15144,15144,'spy2',0.0,0,0,0
15145,15145,'src/__fixtures__/NewsFeed.ts',0.0,0,0,0
15146,15146,'src/__fixtures__/Profile.ts',0.0,0,0,0
15147,15147,'src/components',0.0,0,0,0
15148,15148,'src/components/Button.md',0.0,0,0,0
15149,15149,'src/fetcher.js',0.0,0,0,0
15150,15150,'srcSet',0.0,0,0,0
15151,15151,'ss-target',0.0,0,0,0
15152,15152,'ssg-draft-mode.html',0.0,0,0,0
15153,15153,'ssg-draft-mode.rsc',0.0,0,0,0
15154,15154,'ssg-draft-mode/[[...route]]/page.js',0.0,0,0,0
15155,15155,'ssg-draft-mode/test-2.html',0.0,0,0,0
15156,15156,'ssg-draft-mode/test-2.rsc',0.0,0,0,0
15157,15157,'ssg-draft-mode/test.html',0.0,0,0,0
15158,15158,'ssg-draft-mode/test.rsc',0.0,0,0,0
15159,15159,'ssr-auto/cache-no-store/page.js',0.0,0,0,0
15160,15160,'ssr-auto/fetch-revalidate-zero/page.js',0.0,0,0,0
15161,15161,'ssr-forced/page.js',0.0,0,0,0
15162,15162,'standalone',0.0,0,0,0
15163,15163,'start 2',0.0,0,0,0
15164,15164,'state a',0.0,0,0,0
15165,15165,'state changed property should be false if a subsequent send call did not actually change the state',0.0,0,0,0
15166,15166,'state changed property should be false if no intermediate state is changed',0.0,0,0,0
15167,15167,'state changed property should be true if a subsequent send call changes the state',0.0,0,0,0
15168,15168,'state changed property should be true if any intermediate state is changed',0.0,0,0,0
15169,15169,'state node config should reference original machine config',0.0,0,0,0
15170,15170,'state node should have its description',0.0,0,0,0
15171,15171,'state',0.0,0,0,0
15172,15172,'state.children should reference invoked child actors (machine)',0.0,0,0,0
15173,15173,'state.children should reference invoked child actors (observable)',0.0,0,0,0
15174,15174,'state.children should reference invoked child actors (promise)',0.0,0,0,0
15175,15175,'state.children should reference spawned actors',0.0,0,0,0
15176,15176,'state_a',0.0,0,0,0
15177,15177,'state_b',0.0,0,0,0
15178,15178,'state_b1',0.0,0,0,0
15179,15179,'state_b2',0.0,0,0,0
15180,15180,'states from external transitions with entry actions should be changed',0.0,0,0,0
15181,15181,'states from internal transitions with actions should be changed',0.0,0,0,0
15182,15182,'states from internal transitions with no actions should be unchanged',0.0,0,0,0
15183,15183,'states should aggregate meta data (deep)',0.0,0,0,0
15184,15184,'states should aggregate meta data',0.0,0,0,0
15185,15185,'static slug1',0.0,0,0,0
15186,15186,'static slug2',0.0,0,0,0
15187,15187,'static++',0.0,0,0,0
15188,15188,'static-page',0.0,0,0,0
15189,15189,'static-slug1',0.0,0,0,0
15190,15190,'static-to-dynamic-error-forced/[id]/page.js',0.0,0,0,0
15191,15191,'static-to-dynamic-error/[id]/page.js',0.0,0,0,0
15192,15192,'static/chunks/',0.0,0,0,0
15193,15193,'statically generates correctly with no dynamic usage',0.0,0,0,0
15194,15194,'stderr',0.0,0,0,0
15195,15195,'stdout',0.0,0,0,0
15196,15196,'step1 back',0.0,0,0,0
15197,15197,'step1',0.0,0,0,0
15198,15198,'step2 back',0.0,0,0,0
15199,15199,'step2 forward',0.0,0,0,0
15200,15200,'step2',0.0,0,0,0
15201,15201,'step3 back',0.0,0,0,0
15202,15202,'step3 forward',0.0,0,0,0
15203,15203,'step3',0.0,0,0,0
15204,15204,'step4 back',0.0,0,0,0
15205,15205,'step4 forward',0.0,0,0,0
15206,15206,'step4',0.0,0,0,0
15207,15207,'step5 back',0.0,0,0,0
15208,15208,'step5',0.0,0,0,0
15209,15209,'step6',0.0,0,0,0
15210,15210,'stop 1',0.0,0,0,0
15211,15211,'stopActivity',0.0,0,0,0
15212,15212,'stopCrosswalk1',0.0,0,0,0
15213,15213,'stopCrosswalk2',0.0,0,0,0
15214,15214,'stopPropagation',0.0,0,0,0
15215,15215,'stopped spawned actors should be cleaned up in parent',0.0,0,0,0
15216,15216,'stopped',0.0,0,0,0
15217,15217,'stopping a not-started interpreter should not crash',0.0,0,0,0
15218,15218,'stopping an interpreter that receives events from its children exit handlers should not throw',0.0,0,0,0
15219,15219,'stops server',0.0,0,0,0
15220,15220,'strawberries',0.0,0,0,0
15221,15221,'strict',0.0,0,0,0
15222,15222,'stringActionType',0.0,0,0,0
15223,15223,'stringService',0.0,0,0,0
15224,15224,'stringifies to an array',0.0,0,0,0
15225,15225,"'strips search, headers, and domain from request'",0.0,0,0,0
15226,15226,'strong',0.0,0,0,0
15227,15227,'styfle',0.0,0,0,0
15228,15228,"'style-src ""nonce-cmFuZG9tCg==""'",0.0,0,0,0
15229,15229,'styleguide.config.js',0.0,0,0,0
15230,15230,'subdir',0.0,0,0,0
15231,15231,'subdir/cosmos-export',0.0,0,0,0
15232,15232,'subdir/cosmos.config.js',0.0,0,0,0
15233,15233,'subdir/static',0.0,0,0,0
15234,15234,'submitting',0.0,0,0,0
15235,15235,'succeeded',0.0,0,0,0
15236,15236,'summary',0.0,0,0,0
15237,15237,'summary_large_image',0.0,0,0,0
15238,15238,'supports tagging states',0.0,0,0,0
15239,15239,'supports tags in compound states',0.0,0,0,0
15240,15240,'supports tags in parallel states',0.0,0,0,0
15241,15241,'supports the NextResponse.json() helper',0.0,0,0,0
15242,15242,'supports the NextResponse.redirect() helper',0.0,0,0,0
15243,15243,'sv',0.0,0,0,0
15244,15244,'swr-state',0.0,0,0,0
15245,15245,'symlink',0.0,0,0,0
15246,15246,'t',0.0,0,0,0
15247,15247,'tab',0.0,0,0,0
15248,15248,'tabBody',0.0,0,0,0
15249,15249,'tabButtons',0.0,0,0,0
15250,15250,'tabindex',0.0,0,0,0
15251,15251,'tabindex2',0.0,0,0,0
15252,15252,'table',0.0,0,0,0
15253,15253,'tablist',0.0,0,0,0
15254,15254,'tabs',0.0,0,0,0
15255,15255,'tags can be single (not array)',0.0,0,0,0
15256,15256,'tel:+123456789',0.0,0,0,0
15257,15257,'tel:123-123-1234',0.0,0,0,0
15258,15258,"'telephone=no, address=no, email=no'",0.0,0,0,0
15259,15259,'ten',0.0,0,0,0
15260,15260,'test-util',0.0,0,0,0
15261,15261,'test.second',0.0,0,0,0
15262,15262,'test/apps/basic',0.0,0,0,0
15263,15263,'test/apps/cra',0.0,0,0,0
15264,15264,'test/apps/no-webpack',0.0,0,0,0
15265,15265,'test1=value1; Path=/; Secure',0.0,0,0,0
15266,15266,'test2=value2; Path=/handler; HttpOnly',0.0,0,0,0
15267,15267,'test=1',0.0,0,0,0
15268,15268,'testAction',0.0,0,0,0
15269,15269,'testKey',0.0,0,0,0
15270,15270,'testService',0.0,0,0,0
15271,15271,'testing',0.0,0,0,0
15272,15272,'tests any behavior',0.0,0,0,0
15273,15273,'tests states for any behavior',0.0,0,0,0
15274,15274,'tests transitions',0.0,0,0,0
15275,15275,'text-file',0.0,0,0,0
15276,15276,'text/plain',0.0,0,0,0
15277,15277,'text/x-component',0.0,0,0,0
15278,15278,'textarea still focused',0.0,0,0,0
15279,15279,"'thankyounext,/route-handler/revalidate-360-isr/route'",0.0,0,0,0
15280,15280,'the ._event prop should be the SCXML event (SCXML metadata) that caused the transition',0.0,0,0,0
15281,15281,'the ._event prop should be the SCXML event (object) that caused the transition',0.0,0,0,0
15282,15282,'the ._event prop should be the SCXML event (string) that caused the transition',0.0,0,0,0
15283,15283,'the ._event prop should be the initial SCXML event for the initial state',0.0,0,0,0
15284,15284,'the ._event prop should be the initial event for the initial state',0.0,0,0,0
15285,15285,'the .event prop should be the event (object) that caused the transition',0.0,0,0,0
15286,15286,'the .event prop should be the event (string) that caused the transition',0.0,0,0,0
15287,15287,'the initial state should have a zero-length path',0.0,0,0,0
15288,15288,'the tooltip',0.0,0,0,0
15289,15289,'theme',0.0,0,0,0
15290,15290,"'theme=light; Path=/,my_company=ACME; Path=/'",0.0,0,0,0
15291,15291,'thing',0.0,0,0,0
15292,15292,'thirteen',0.0,0,0,0
15293,15293,'this is a test',0.0,0,0,0
15294,15294,'this is the layout description',0.0,0,0,0
15295,15295,'this is the page title',0.0,0,0,0
15296,15296,'this should be overwritten',0.0,0,0,0
15297,15297,'this',0.0,0,0,0
15298,15298,'this-is-another-document-body',0.0,0,0,0
15299,15299,'this-is-another-document-html',0.0,0,0,0
15300,15300,'this-is-the-document-body',0.0,0,0,0
15301,15301,'this-is-the-document-html',0.0,0,0,0
15302,15302,'this_is_sensitive_info',0.0,0,0,0
15303,15303,'three item array',0.0,0,0,0
15304,15304,'throw new',0.0,0,0,0
15305,15305,'throws on invalid --config file extension',0.0,0,0,0
15306,15306,'throws on invalid --config path',0.0,0,0,0
15307,15307,'throws on invalid --root-dir path',0.0,0,0,0
15308,15308,'throws when escape characters are included in nonce',0.0,0,0,0
15309,15309,'tim',0.0,0,0,0
15310,15310,'timm',0.0,0,0,0
15311,15311,'title template layout default',0.0,0,0,0
15312,15312,"'title=""js title""'",0.0,0,0,0
15313,15313,"'title=""rss""'",0.0,0,0,0
15314,15314,'to another page',0.0,0,0,0
15315,15315,'to slug',0.0,0,0,0
15316,15316,'to-A',0.0,0,0,0
15317,15317,'to-B',0.0,0,0,0
15318,15318,'to-D2',0.0,0,0,0
15319,15319,'to-dynamic-first',0.0,0,0,0
15320,15320,'to-next-url',0.0,0,0,0
15321,15321,'to:',0.0,0,0,0
15322,15322,'tooltip',0.0,0,0,0
15323,15323,'tooltipTitle',0.0,0,0,0
15324,15324,'touch',0.0,0,0,0
15325,15325,'transition coverage should consider guarded transitions',0.0,0,0,0
15326,15326,'transition coverage should consider multiple transitions with the same target',0.0,0,0,0
15327,15327,'transitionend',0.0,0,0,0
15328,15328,'transparent',0.0,0,0,0
15329,15329,'transpilePackages:5',0.0,0,0,0
15330,15330,'tree',0.0,0,0,0
15331,15331,'trigger',0.0,0,0,0
15332,15332,'ts',0.0,0,0,0
15333,15333,'tsx',0.0,0,0,0
15334,15334,'turbo',0.0,0,0,0
15335,15335,'twelve',0.0,0,0,0
15336,15336,'twitter:app:id:googleplay',0.0,0,0,0
15337,15337,'twitter:app:id:ipad',0.0,0,0,0
15338,15338,'twitter:app:id:iphone',0.0,0,0,0
15339,15339,'twitter:app:url:googleplay',0.0,0,0,0
15340,15340,'twitter:app:url:ipad',0.0,0,0,0
15341,15341,'twitter:app:url:iphone',0.0,0,0,0
15342,15342,'twitter:card',0.0,0,0,0
15343,15343,'twitter:creator',0.0,0,0,0
15344,15344,'twitter:creator:id',0.0,0,0,0
15345,15345,'twitter:description',0.0,0,0,0
15346,15346,'twitter:image',0.0,0,0,0
15347,15347,'twitter:image:alt',0.0,0,0,0
15348,15348,'twitter:image:height',0.0,0,0,0
15349,15349,'twitter:image:secure_url',0.0,0,0,0
15350,15350,'twitter:image:width',0.0,0,0,0
15351,15351,'twitter:player',0.0,0,0,0
15352,15352,'twitter:player:height',0.0,0,0,0
15353,15353,'twitter:player:stream',0.0,0,0,0
15354,15354,'twitter:player:width',0.0,0,0,0
15355,15355,'twitter:site:id',0.0,0,0,0
15356,15356,'twitter:title',0.0,0,0,0
15357,15357,'twitter_app://googleplay',0.0,0,0,0
15358,15358,'twitter_app://ipad',0.0,0,0,0
15359,15359,'twitter_app://iphone',0.0,0,0,0
15360,15360,'two item array',0.0,0,0,0
15361,15361,'two-link',0.0,0,0,0
15362,15362,'two.deep',0.0,0,0,0
15363,15363,'two.deep.foo',0.0,0,0,0
15364,15364,'two:deep',0.0,0,0,0
15365,15365,'two:deep:foo',0.0,0,0,0
15366,15366,'typeof B.Buffer',0.0,0,0,0
15367,15367,'typeof B2.Buffer',0.0,0,0,0
15368,15368,'typeof Buffer',0.0,0,0,0
15369,15369,'typeof window;',0.0,0,0,0
15370,15370,'typescript-config',0.0,0,0,0
15371,15371,'u',0.0,0,0,0
15372,15372,'ui',0.0,0,0,0
15373,15373,'ul',0.0,0,0,0
15374,15374,'undefined transitions should forbid events',0.0,0,0,0
15375,15375,'undefinedMethod',0.0,0,0,0
15376,15376,'unhandledRejection',0.0,0,0,0
15377,15377,"'union: PropTypes.oneOfType([PropTypes.string, PropTypes.number])'",0.0,0,0,0
15378,15378,'unknown',0.0,0,0,0
15379,15379,'unknown-scheme:abc',0.0,0,0,0
15380,15380,'unsafe',0.0,0,0,0
15381,15381,'unserializable',0.0,0,0,0
15382,15382,'unstable_cache_tag1',0.0,0,0,0
15383,15383,'updates fixtures in renderer state',0.0,0,0,0
15384,15384,'updates selected fixture ID',0.0,0,0,0
15385,15385,'upgrade',0.0,0,0,0
15386,15386,'useMe',0.0,0,0,0
15387,15387,'uses --exportImports CLI arg',0.0,0,0,0
15388,15388,'uses --lazy CLI arg',0.0,0,0,0
15389,15389,'uses the ID specified in the options',0.0,0,0,0
15390,15390,'uses the machine ID if not specified',0.0,0,0,0
15391,15391,'uses the wasm file',0.0,0,0,0
15392,15392,'utf-8',0.0,0,0,0
15393,15393,'valid anchor element',0.0,0,0,0
15394,15394,'valid download link element',0.0,0,0,0
15395,15395,'valid external link element',0.0,0,0,0
15396,15396,'valid link element with multiple directories',0.0,0,0,0
15397,15397,'valid link element',0.0,0,0,0
15398,15398,'valid public file link element',0.0,0,0,0
15399,15399,"'valid target=""_blank"" link element'",0.0,0,0,0
15400,15400,'valid',0.0,0,0,0
15401,15401,'value change caused transition',0.0,0,0,0
15402,15402,'value2',0.0,0,0,0
15403,15403,'var a = 1',0.0,0,0,0
15404,15404,'variable-config-revalidate/revalidate-3.html',0.0,0,0,0
15405,15405,'variable-config-revalidate/revalidate-3.rsc',0.0,0,0,0
15406,15406,'variable-config-revalidate/revalidate-3/page.js',0.0,0,0,0
15407,15407,'variable-revalidate-edge/body/page.js',0.0,0,0,0
15408,15408,'variable-revalidate-edge/encoding/page.js',0.0,0,0,0
15409,15409,'variable-revalidate-edge/no-store/page.js',0.0,0,0,0
15410,15410,'variable-revalidate-edge/post-method-request/page.js',0.0,0,0,0
15411,15411,'variable-revalidate-edge/post-method/page.js',0.0,0,0,0
15412,15412,'variable-revalidate-edge/revalidate-3/page.js',0.0,0,0,0
15413,15413,'variable-revalidate/authorization.html',0.0,0,0,0
15414,15414,'variable-revalidate/authorization.rsc',0.0,0,0,0
15415,15415,'variable-revalidate/authorization/page.js',0.0,0,0,0
15416,15416,'variable-revalidate/cookie.html',0.0,0,0,0
15417,15417,'variable-revalidate/cookie.rsc',0.0,0,0,0
15418,15418,'variable-revalidate/cookie/page.js',0.0,0,0,0
15419,15419,'variable-revalidate/encoding.html',0.0,0,0,0
15420,15420,'variable-revalidate/encoding.rsc',0.0,0,0,0
15421,15421,'variable-revalidate/encoding/page.js',0.0,0,0,0
15422,15422,'variable-revalidate/headers-instance.html',0.0,0,0,0
15423,15423,'variable-revalidate/headers-instance.rsc',0.0,0,0,0
15424,15424,'variable-revalidate/headers-instance/page.js',0.0,0,0,0
15425,15425,'variable-revalidate/no-store/page.js',0.0,0,0,0
15426,15426,'variable-revalidate/post-method-request/page.js',0.0,0,0,0
15427,15427,'variable-revalidate/post-method.html',0.0,0,0,0
15428,15428,'variable-revalidate/post-method.rsc',0.0,0,0,0
15429,15429,'variable-revalidate/post-method/page.js',0.0,0,0,0
15430,15430,'variable-revalidate/revalidate-3.html',0.0,0,0,0
15431,15431,'variable-revalidate/revalidate-3.rsc',0.0,0,0,0
15432,15432,'variable-revalidate/revalidate-3/page.js',0.0,0,0,0
15433,15433,'variable-revalidate/revalidate-360-isr.html',0.0,0,0,0
15434,15434,'variable-revalidate/revalidate-360-isr.rsc',0.0,0,0,0
15435,15435,'variable-revalidate/revalidate-360-isr/page.js',0.0,0,0,0
15436,15436,'variable-revalidate/revalidate-360/page.js',0.0,0,0,0
15437,15437,'variable-revalidate/status-code/page.js',0.0,0,0,0
15438,15438,'vary',0.0,0,0,0
15439,15439,'vercel',0.0,0,0,0
15440,15440,'version',0.0,0,0,0
15441,15441,'viteServerPlugin.js',0.0,0,0,0
15442,15442,'wait_one',0.0,0,0,0
15443,15443,'wait_two',0.0,0,0,0
15444,15444,'waitingForCode',0.0,0,0,0
15445,15445,'wak1sonA',0.0,0,0,0
15446,15446,'wak1sonB',0.0,0,0,0
15447,15447,'wak2sonA',0.0,0,0,0
15448,15448,'wak2sonB',0.0,0,0,0
15449,15449,'walk data',0.0,0,0,0
15450,15450,"'warn Minimum recommended TypeScript version is v4.5.2, older versions can potentially be incompatible with Next.js. Detected: 4.0.6'",0.0,0,0,0
15451,15451,'warn',0.0,0,0,0
15452,15452,'warns about API route using experimental-edge runtime',0.0,0,0,0
15453,15453,'warns about page using edge runtime',0.0,0,0,0
15454,15454,'was removed',0.0,0,0,0
15455,15455,'wasm_58ccff8b2b94b5dac6ef8957082ecd8f6d34186d',0.0,0,0,0
15456,15456,'webpack-hot-middleware/client',0.0,0,0,0
15457,15457,'webpackServerPlugin.js',0.0,0,0,0
15458,15458,'website',0.0,0,0,0
15459,15459,'whatever',0.0,0,0,0
15460,15460,"'when awaiting `fetch` using an unknown domain, stack traces are preserved'",0.0,0,0,0
15461,15461,"'when returning `fetch` using an unknown domain, stack traces are preserved'",0.0,0,0,0
15462,15462,'widget',0.0,0,0,0
15463,15463,"'width=device-width, initial-scale=1'",0.0,0,0,0
15464,15464,"'width=device-width, initial-scale=1, maximum-scale=1, interactive-widget=resizes-visual'",0.0,0,0,0
15465,15465,'win',0.0,0,0,0
15466,15466,'window.__DEV_MIDDLEWARE_MATCHERS',0.0,0,0,0
15467,15467,'window.__MIDDLEWARE_MATCHERS',0.0,0,0,0
15468,15468,'window.__NEXT_DATA__',0.0,0,0,0
15469,15469,'window.__SAME_PAGE = true',0.0,0,0,0
15470,15470,'window.__SAME_PAGE',0.0,0,0,0
15471,15471,'window._clearEventLog()',0.0,0,0,0
15472,15472,'window._didNotNavigate = true',0.0,0,0,0
15473,15473,'window._didNotNavigate',0.0,0,0,0
15474,15474,'window._getEventLog()',0.0,0,0,0
15475,15475,'window._test = 42',0.0,0,0,0
15476,15476,'window.beforeAnother = true',0.0,0,0,0
15477,15477,'window.beforeAnother',0.0,0,0,0
15478,15478,"'window.beforeClick = ""abc""'",0.0,0,0,0
15479,15479,'window.beforeClick',0.0,0,0,0
15480,15480,"'window.beforeNav = ""hi""'",0.0,0,0,0
15481,15481,'window.beforeNav = 1',0.0,0,0,0
15482,15482,'window.beforeNav = true',0.0,0,0,0
15483,15483,"'window.beforeNavigate = ""hi""'",0.0,0,0,0
15484,15484,'window.beforeNavigate = true',0.0,0,0,0
15485,15485,'window.beforeNavigate',0.0,0,0,0
15486,15486,'window.didNotReloadPage = true',0.0,0,0,0
15487,15487,'window.didNotReloadPage',0.0,0,0,0
15488,15488,'window.didTransition = 1',0.0,0,0,0
15489,15489,"'window.didrefresh = ""hello""'",0.0,0,0,0
15490,15490,'window.history.forward()',0.0,0,0,0
15491,15491,"'window.location.href = ""/abc""'",0.0,0,0,0
15492,15492,"'window.location.href = ""/dynamic-client/first/second""'",0.0,0,0,0
15493,15493,"'window.location.origin === ""https://example.vercel.sh""'",0.0,0,0,0
15494,15494,'window.location.pathname + window.location.search',0.0,0,0,0
15495,15495,'window.location.toString()',0.0,0,0,0
15496,15496,"'window.nd.router.prefetch(""/dashboard/123"")'",0.0,0,0,0
15497,15497,"'window.nd.router.prefetch(""/static-page"", {kind: ""auto""})'",0.0,0,0,0
15498,15498,"'window.nd.router.push(""/dashboard/123"")'",0.0,0,0,0
15499,15499,'window.next.router.back()',0.0,0,0,0
15500,15500,"'window.next.router.isReady ? ""ready"" : ""no""'",0.0,0,0,0
15501,15501,"'window.next.router.prefetch(""/gssp"")'",0.0,0,0,0
15502,15502,"'window.next.router.push(""/blog/first"")'",0.0,0,0,0
15503,15503,"'window.next.router.push(""/blog/second"")'",0.0,0,0,0
15504,15504,"'window.next.router.push(""/catchall/first"")'",0.0,0,0,0
15505,15505,"'window.next.router.push(""/catchall/second"")'",0.0,0,0,0
15506,15506,"'window.next.router.push(""/docs/another"")'",0.0,0,0,0
15507,15507,"'window.next.router.push(""/rewrite-1"")'",0.0,0,0,0
15508,15508,"'window.next.router.push(""/rewrite-3"")'",0.0,0,0,0
15509,15509,"'window.next.router.push(""/rewrite-to-app"")'",0.0,0,0,0
15510,15510,"'window.next.router.push(""/rewrite-to-config-rewrite"")'",0.0,0,0,0
15511,15511,"'window.next.router.push(""/rewrite-to-dynamic"")'",0.0,0,0,0
15512,15512,"'window.next.router.push(""/ssg/not-found-1"")'",0.0,0,0,0
15513,15513,"'window.next.router.push(""/to-new"")'",0.0,0,0,0
15514,15514,'window.next.router.query',0.0,0,0,0
15515,15515,"'window.scrollTo(0, 1000)'",0.0,0,0,0
15516,15516,"'window.scrollTo(0, 500)'",0.0,0,0,0
15517,15517,'window.thisShouldStay = true',0.0,0,0,0
15518,15518,'window.thisShouldStay',0.0,0,0,0
15519,15519,"'with ""LINE SEPARATOR"" and ""PARAGRAPH SEPARATOR"" should escape'",0.0,0,0,0
15520,15520,"'with ""LINE SEPARATOR"" and ""PARAGRAPH SEPARATOR"" should parse back'",0.0,0,0,0
15521,15521,'with a relative transition',0.0,0,0,0
15522,15522,'with ampersands should escape',0.0,0,0,0
15523,15523,'with ampersands should parse back',0.0,0,0,0
15524,15524,'with an absolute transition',0.0,0,0,0
15525,15525,'with angle brackets should escape',0.0,0,0,0
15526,15526,'with angle brackets should parse back',0.0,0,0,0
15527,15527,'with-async-edge-page should run the instrumentation hook',0.0,0,0,0
15528,15528,'with-async-edge-page',0.0,0,0,0
15529,15529,'with-async-node-page should run the instrumentation hook',0.0,0,0,0
15530,15530,'with-async-node-page',0.0,0,0,0
15531,15531,'with-edge-api should run the instrumentation hook',0.0,0,0,0
15532,15532,'with-edge-api',0.0,0,0,0
15533,15533,'with-edge-page should run the instrumentation hook',0.0,0,0,0
15534,15534,'with-edge-page',0.0,0,0,0
15535,15535,'with-font-declarations-file/components',0.0,0,0,0
15536,15536,'with-font-declarations-file/fonts.js',0.0,0,0,0
15537,15537,'with-font-declarations-file/my-font.woff2',0.0,0,0,0
15538,15538,'with-font-declarations-file/pages',0.0,0,0,0
15539,15539,'with-middleware should run the instrumentation hook',0.0,0,0,0
15540,15540,'with-middleware',0.0,0,0,0
15541,15541,'with-node-api should run the instrumentation hook',0.0,0,0,0
15542,15542,'with-node-api',0.0,0,0,0
15543,15543,'with-node-page should run the instrumentation hook',0.0,0,0,0
15544,15544,'with-node-page',0.0,0,0,0
15545,15545,'with-params',0.0,0,0,0
15546,15546,'with-proxy',0.0,0,0,0
15547,15547,'withAfter',0.0,0,0,0
15548,15548,'withSelector',0.0,0,0,0
15549,15549,'without fonts',0.0,0,0,0
15550,15550,'without preload',0.0,0,0,0
15551,15551,'without-pages-dir',0.0,0,0,0
15552,15552,'without-params',0.0,0,0,0
15553,15553,'without-preloaded-fonts/pages/_app.js',0.0,0,0,0
15554,15554,'without-preloaded-fonts/pages/no-preload.js',0.0,0,0,0
15555,15555,'without-preloaded-fonts/pages/without-fonts.js',0.0,0,0,0
15556,15556,'withoutSelector',0.0,0,0,0
15557,15557,'works with built-in actions',0.0,0,0,0
15558,15558,'works with postcss.config.cjs files',0.0,0,0,0
15559,15559,'worstGuard',0.0,0,0,0
15560,15560,'ws://192.168.100.65:5050',0.0,0,0,0
15561,15561,'x-edge-runtime',0.0,0,0,0
15562,15562,'x-hello',0.0,0,0,0
15563,15563,'x-imported',0.0,0,0,0
15564,15564,'x-kind',0.0,0,0,0
15565,15565,'x-middleware',0.0,0,0,0
15566,15566,'x-my-header',0.0,0,0,0
15567,15567,'x-next-test-client',0.0,0,0,0
15568,15568,'x-prerender-revalidate',0.0,0,0,0
15569,15569,'x-redirect-header',0.0,0,0,0
15570,15570,'x-req-type',0.0,0,0,0
15571,15571,'x-resolved',0.0,0,0,0
15572,15572,'x-serialized',0.0,0,0,0
15573,15573,'x-vercel-cache',0.0,0,0,0
15574,15574,'x;x',0.0,0,0,0
15575,15575,'xstate.stop',0.0,0,0,0
15576,15576,'xstate123',0.0,0,0,0
15577,15577,'xxx',0.0,0,0,0
15578,15578,'yahoo',0.0,0,0,0
15579,15579,'yamlEditor',0.0,0,0,0
15580,15580,'yandex',0.0,0,0,0
15581,15581,'yandex-verification',0.0,0,0,0
15582,15582,'yarn build',0.0,0,0,0
15583,15583,'yarn dev',0.0,0,0,0
15584,15584,'yarn setup && next build',0.0,0,0,0
15585,15585,'yarn setup && next dev',0.0,0,0,0
15586,15586,'yarn start',0.0,0,0,0
15587,15587,'yarn',0.0,0,0,0
15588,15588,'yellow data',0.0,0,0,0
15589,15589,'your-component',0.0,0,0,0
15590,15590,'yourComponent.js',0.0,0,0,0
15591,15591,'zeit',0.0,0,0,0
15592,15592,"'{""category"":""books""}'",0.0,0,0,0
15593,15593,"'{""evil"":""\\u0026""}'",0.0,0,0,0
15594,15594,"'{""evil"":""\\u003cscript\\u003e\\u003c/script\\u003e""}'",0.0,0,0,0
15595,15595,"'{""evil"":""\\u2028\\u2029""}'",0.0,0,0,0
15596,15596,"'{""hello"":""world""}'",0.0,0,0,0
15597,15597,"'{""isEnabled"":false}'",0.0,0,0,0
15598,15598,'{/* <div',0.0,0,0,0
15599,15599,'{}',0.0,0,0,0
15600,15600,'~/components/Annotation/Annotation.js',0.0,0,0,0
15601,15601,'~/components/Button/Button.js',0.0,0,0,0
15602,15602,'~/components/Placeholder/Placeholder.js',0.0,0,0,0
15603,15603,'~/components/Price/Price.js',0.0,0,0,0
15604,15604,'~/components/RandomButton/RandomButton.js',0.0,0,0,0
15605,15605,'~/one.js',0.0,0,0,0
15606,15606,'~/two.js',0.0,0,0,0
15607,15607,'␣pizza␣',0.0,0,0,0
15608,15608,'マルチバイト',0.0,0,0,0
15609,15609,'名',0.0,0,0,0
15610,15610,'超鬼畜！激辛ボム兵スピンジャンプ　Bomb Spin Jump',0.0,0,0,0
15611,15611,"/""slug"":""hello""/",0.0,0,0,0
15612,15612,"/""slug"":""second""/",0.0,0,0,0
15613,15613,"/""slug"":""slug-2""/",0.0,0,0,0
15614,15614,/'link': 'link'/,0.0,0,0,0
15615,15615,/'see': '\{@link link\}'/,0.0,0,0,0
15616,15616,/(([a-z0-9_]+)(\[[^\]]*?\]|\.[a-z0-9_]+)*?)\.Fragment/i,0.0,0,0,0
15617,15617,/(?: *[\n\r])+ */g,0.0,0,0,0
15618,15618,/(MISS)/,0.0,0,0,0
15619,15619,/(\S+)\s+(\d+\s\w+)\s+(\d+\.\d+\s\w+)/g,0.0,0,0,0
15620,15620,/(__prerender_bypass|__next_preview_data)/,0.0,0,0,0
15621,15621,/.*/,0.0,0,0,0
15622,15622,/.*\.(js|html|rsc)$/,0.0,0,0,0
15623,15623,"/0:\["".*?"",/",0.0,0,0,0
15624,15624,"/0:\[""development"",/",0.0,0,0,0
15625,15625,/6/,0.0,0,0,0
15626,15626,"/<link rel=""stylesheet"" href=""(.+)\.css(\?v=\d+)?""\/><h2>Loading...<\/h2>/",0.0,0,0,0
15627,15627,"/<link rel=""stylesheet"" href=""[^.]+\.css(\?v=\d+)?""/g",0.0,0,0,0
15628,15628,"/<script src=""\/_next\/static\/chunks\/polyfills(-\w+)?\.js"" noModule="""">/",0.0,0,0,0
15629,15629,/<style[^<>]*>(\s)*.+{padding:2px;(\s)*color:orange;}/,0.0,0,0,0
15630,15630,/About Page/,0.0,0,0,0
15631,15631,/About:.*?en/,0.0,0,0,0
15632,15632,/Additional keys were returned/,0.0,0,0,0
15633,15633,/App React Version: ([^<]+)</,0.0,0,0,0
15634,15634,/Catch all: \[\]/,0.0,0,0,0
15635,15635,/Catch all: \[value\]/,0.0,0,0,0
15636,15636,/Comment:.*?comment-1/,0.0,0,0,0
15637,15637,/Configuring Next.js via .+ is not supported. Please replace the file with 'next.config.js'/,0.0,0,0,0
15638,15638,"/Conflicting app and page files? (were|was) found, please remove the conflicting files to continue:/",0.0,0,0,0
15639,15639,/Conflicting app and page files? (were|was) found/,0.0,0,0,0
15640,15640,/Content for page 1/,0.0,0,0,0
15641,15641,/Detected default export in '.+\/route\.ts'\. Export a named export for each HTTP method instead\./,0.0,0,0,0
15642,15642,/Digest: \w+/,0.0,0,0,0
15643,15643,/Edge!/,0.0,0,0,0
15644,15644,/Error serializing `.time` returned from `getServerSideProps`/,0.0,0,0,0
15645,15645,/Error: Client error/,0.0,0,0,0
15646,15646,/Example Domain/,0.0,0,0,0
15647,15647,/Experimental features are not covered by semver/g,0.0,0,0,0
15648,15648,/External React Version: ([^<]+)</,0.0,0,0,0
15649,15649,/Failed to load static props/,0.0,0,0,0
15650,15650,/Failed to update prerender files for/,0.0,0,0,0
15651,15651,/FooComponent/,0.0,0,0,0
15652,15652,/FooComponent/g,0.0,0,0,0
15653,15653,/Hello World/,0.0,0,0,0
15654,15654,/Hello from .+\/api\/hello/,0.0,0,0,0
15655,15655,/Hello from edge page again/,0.0,0,0,0
15656,15656,/Hello from edge page/,0.0,0,0,0
15657,15657,/Hello from server page again/,0.0,0,0,0
15658,15658,/Hello from server page/,0.0,0,0,0
15659,15659,/Hi \[first\] \[second\]/,0.0,0,0,0
15660,15660,/Hi \[first\]!/,0.0,0,0,0
15661,15661,/Hi \[second\]!/,0.0,0,0,0
15662,15662,/Hi \[third\] \[fourth\]/,0.0,0,0,0
15663,15663,/Hi.*?another value/,0.0,0,0,0
15664,15664,/Hi.*?delayby3s nested/,0.0,0,0,0
15665,15665,/Hi.*?delayby3s/,0.0,0,0,0
15666,15666,/Hi.*?first/,0.0,0,0,0
15667,15667,/Hi.*?second/,0.0,0,0,0
15668,15668,/Invalid href/,0.0,0,0,0
15669,15669,/Listening on/,0.0,0,0,0
15670,15670,/MISS/,0.0,0,0,0
15671,15671,/No HTTP methods exported in '.+\/route\.ts'\. Export a named export for each HTTP method\./,0.0,0,0,0
15672,15672,"/Page changed from static to dynamic at runtime \/static-to-dynamic-error-forced\/static-bailout-1, reason: cookies/",0.0,0,0,0
15673,15673,"/Page with dynamic = ""error"" encountered dynamic data method on \/dynamic-error\/static-bailout-1/",0.0,0,0,0
15674,15674,/Paths cannot be joined/,0.0,0,0,0
15675,15675,/Post/,0.0,0,0,0
15676,15676,/Post:.*?404-on-manual-revalidate/,0.0,0,0,0
15677,15677,/Post:.*?blocked-create/,0.0,0,0,0
15678,15678,/Post:.*?post-1/,0.0,0,0,0
15679,15679,/Post:.*?test-if-generated-2/,0.0,0,0,0
15680,15680,/Post:.*?test-manual-1/,0.0,0,0,0
15681,15681,/Success/,0.0,0,0,0
15682,15682,"/The ""target"" property is no longer supported/",0.0,0,0,0
15683,15683,/The instrumentation file has been removed/,0.0,0,0,0
15684,15684,/The instrumentation file was added/,0.0,0,0,0
15685,15685,/The prop `url` is a reserved prop in Next.js for legacy reasons and will be overridden on page \/url-prop/,0.0,0,0,0
15686,15686,/Toggle/,0.0,0,0,0
15687,15687,/Value: .*?12345/,0.0,0,0,0
15688,15688,/Value: .*?hello world/,0.0,0,0,0
15689,15689,/Value: .*?new value/,0.0,0,0,0
15690,15690,"/Warning: data for page ""\/blocking-fallback\/\[slug\]"" \(path ""\/blocking-fallback\/lots-of-data""\) is 256 kB which exceeds the threshold of 128 kB, this amount of data can reduce performance/",0.0,0,0,0
15691,15691,"/Warning: data for page ""\/large-page-data"" is 256 kB which exceeds the threshold of 128 kB, this amount of data can reduce performance/",0.0,0,0,0
15692,15692,/Welcome Page B/,0.0,0,0,0
15693,15693,/Welcome to/,0.0,0,0,0
15694,15694,/You have enabled experimental feature/g,0.0,0,0,0
15695,15695,/\.css/,0.0,0,0,0
15696,15696,/\.js/,0.0,0,0,0
15697,15697,/\/\(group\)\/twitter-image-\w{6}\/route/,0.0,0,0,0
15698,15698,/\/\/ bad-prop/,0.0,0,0,0
15699,15699,/\/_next\/data\/[^/]+/,0.0,0,0,0
15700,15700,"/\/dashboard\/another.*? [^0]{1,} [\w]{1,}B/",0.0,0,0,0
15701,15701,/\/data\.sqlite/,0.0,0,0,0
15702,15702,/\/gsp-[^./]+\.js/,0.0,0,0,0
15703,15703,/\/gssp-[^./]+\.js/,0.0,0,0,0
15704,15704,/\/icons\/static\/dynamic-routes\/123\/icon\.png\?b76e8f0282c93c8e/,0.0,0,0,0
15705,15705,/\/icons\/static\/icon2\.png\?b76e8f0282c93c8e/,0.0,0,0,0
15706,15706,/\/icons\/static\/icon\.png\?b76e8f0282c93c8e/,0.0,0,0,0
15707,15707,/\/icons\/static\/nested\/apple-icon\.png\?b76e8f0282c93c8e/,0.0,0,0,0
15708,15708,/\/icons\/static\/nested\/icon1\.png\?399de3b94b888afc/,0.0,0,0,0
15709,15709,/\/metadata-base\/unset\/opengraph-image2\/10\d/,0.0,0,0,0
15710,15710,/\/metadata-base\/unset\/twitter-image\.png/,0.0,0,0,0
15711,15711,/\/other-page-[^./]+\.js/,0.0,0,0,0
15712,15712,/\/server\.js/,0.0,0,0,0
15713,15713,/\/to-ssg/,0.0,0,0,0
15714,15714,"/^'__Inter_.{6}', '__Inter_Fallback_.{6}'$/",0.0,0,0,0
15715,15715,"/^'__Nabla_.{6}', '__Nabla_Fallback_.{6}'$/",0.0,0,0,0
15716,15716,"/^'__Roboto_.{6}', '__Roboto_Fallback_.{6}'$/",0.0,0,0,0
15717,15717,/^'__font1_.{6}'$/,0.0,0,0,0
15718,15718,/^'__font2_.{6}'$/,0.0,0,0,0
15719,15719,/^'__font3_.{6}'$/,0.0,0,0,0
15720,15720,/^'__font4_.{6}'$/,0.0,0,0,0
15721,15721,/^'__font5_.{6}'$/,0.0,0,0,0
15722,15722,/^'__font6_.{6}'$/,0.0,0,0,0
15723,15723,"/^'__myFont1_.{6}', '__myFont1_Fallback_.{6}', system-ui$/",0.0,0,0,0
15724,15724,"/^'__myFont2_.{6}', '__myFont2_Fallback_.{6}'$/",0.0,0,0,0
15725,15725,/^<!DOCTYPE html><html/,0.0,0,0,0
15726,15726,/^[\\/]nav[\\/]about\.js/,0.0,0,0,0
15727,15727,/^[\\/]nested[\\/]index\.js/,0.0,0,0,0
15728,15728,/^[\\/]prefered\.js/,0.0,0,0,0
15729,15729,/^\//,0.0,0,0,0
15730,15730,/^\/_next\/data\/[^/]+/,0.0,0,0,0
15731,15731,"/^\[MobX\] 'Child@\d+\.action' is annotated with 'override', but no such annotated member was found on prototype\./",0.0,0,0,0
15732,15732,"/^\[MobX\] 'Child\.prototype\.action' is decorated with 'override', but no such decorated member was found on prototype\./",0.0,0,0,0
15733,15733,"/^__Fira_Code_.{6}, __Fira_Code_Fallback_.{6}$/",0.0,0,0,0
15734,15734,"/^__Inter_.{6}, __Inter_Fallback_.{6}$/",0.0,0,0,0
15735,15735,"/^__Roboto_.{6}, __Roboto_Fallback_.{6}$/",0.0,0,0,0
15736,15736,/^__font1_.{6}$/,0.0,0,0,0
15737,15737,/^__font2_.{6}$/,0.0,0,0,0
15738,15738,/^__font3_.{6}$/,0.0,0,0,0
15739,15739,/^__font4_.{6}$/,0.0,0,0,0
15740,15740,/^__font5_.{6}$/,0.0,0,0,0
15741,15741,/^__font6_.{6}$/,0.0,0,0,0
15742,15742,"/^__myFont_.{6}, __myFont_Fallback_.{6}$/",0.0,0,0,0
15743,15743,/^body {/,0.0,0,0,0
15744,15744,/^cache/,0.0,0,0,0
15745,15745,/^data-foo/,0.0,0,0,0
15746,15746,/^react-scripts\//,0.0,0,0,0
15747,15747,/^rsg--\w+-\d+$/,0.0,0,0,0
15748,15748,/^rsg--child-\d+ rsg--root-\d+$/,0.0,0,0,0
15749,15749,/^rsg--foo-\d+$/,0.0,0,0,0
15750,15750,/^rsg--root-\d+$/,0.0,0,0,0
15751,15751,/^server\/edge-chunks\/asset_text-file/,0.0,0,0,0
15752,15752,/^server\/edge-chunks\/asset_vercel/,0.0,0,0,0
15753,15753,/^server\/edge-chunks\/asset_world/,0.0,0,0,0
15754,15754,/^text-file\.[0-9a-f]{16}\.txt$/,0.0,0,0,0
15755,15755,/^vercel\.[0-9a-f]{16}\.png$/,0.0,0,0,0
15756,15756,/^world\.[0-9a-f]{16}\.json/,0.0,0,0,0
15757,15757,/__COMPONENT__/,0.0,0,0,0
15758,15758,/`fallback` key must be returned from/,0.0,0,0,0
15759,15759,/a normal page/,0.0,0,0,0
15760,15760,/another.*?value/,0.0,0,0,0
15761,15761,/app-dir/,0.0,0,0,0
15762,15762,/at.+\/pages\/api\/unknown-domain-no-await.js/,0.0,0,0,0
15763,15763,/at.+\/pages\/api\/unknown-domain.js/,0.0,0,0,0
15764,15764,"/background = rgb\(255, 255, 0\)/",0.0,0,0,0
15765,15765,/bread/,0.0,0,0,0
15766,15766,/client loaded/,0.0,0,0,0
15767,15767,/client_component/g,0.0,0,0,0
15768,15768,/color:.*?cyan/,0.0,0,0,0
15769,15769,/color:.*?red/,0.0,0,0,0
15770,15770,/css-duplicate-2\/layout\.css\?v=/g,0.0,0,0,0
15771,15771,/custom 404 page/,0.0,0,0,0
15772,15772,/custom server error/,0.0,0,0,0
15773,15773,/did not have a root layout/,0.0,0,0,0
15774,15774,/differ only by non-word/,0.0,0,0,0
15775,15775,/different slug names/,0.0,0,0,0
15776,15776,/edge-hmr/,0.0,0,0,0
15777,15777,/getStaticPaths is required for dynamic SSG pages and is missing for/,0.0,0,0,0
15778,15778,/hello /,0.0,0,0,0
15779,15779,/hello from another/,0.0,0,0,0
15780,15780,/hello from/,0.0,0,0,0
15781,15781,/hello.*?promise/,0.0,0,0,0
15782,15782,/hello.*?res/,0.0,0,0,0
15783,15783,/http:\/\/localhost:\d+\/opengraph-image\?/,0.0,0,0,0
15784,15784,/http:\/\/localhost:\d+\/opengraph\/static\/opengraph-image.png\?b76e8f0282c93c8e/,0.0,0,0,0
15785,15785,/http:\/\/localhost:\d+\/opengraph\/static\/twitter-image.png\?b76e8f0282c93c8e/,0.0,0,0,0
15786,15786,/http:\/\/localhost:\d+\/twitter-image\?/,0.0,0,0,0
15787,15787,/https:\/\/[\w-]+.vercel.app\/opengraph-image\?/,0.0,0,0,0
15788,15788,/https:\/\/[\w-]+.vercel.app\/twitter-image\?/,0.0,0,0,0
15789,15789,/https:\/\/mydomain.com\/opengraph-image\?/,0.0,0,0,0
15790,15790,/https:\/\/mydomain.com\/twitter-image\?/,0.0,0,0,0
15791,15791,/id:.*?static-bailout-1/,0.0,0,0,0
15792,15792,/impossible/g,0.0,0,0,0
15793,15793,/index/,0.0,0,0,0
15794,15794,/instrumentation hook on nodejs/,0.0,0,0,0
15795,15795,/instrumentation hook on the edge/,0.0,0,0,0
15796,15796,/instrumentation hook/,0.0,0,0,0
15797,15797,/makeObservable second arg must be nullish when using decorators/,0.0,0,0,0
15798,15798,/missing-id rewrite/,0.0,0,0,0
15799,15799,"/modules: \["".*?""/",0.0,0,0,0
15800,15800,/next\/dist\/client\/router\.js/,0.0,0,0,0
15801,15801,/next\/router\.js/,0.0,0,0,0
15802,15802,/no observable property 'b' found on the observable object/,0.0,0,0,0
15803,15803,/node_modules\/sqlite3\/.*?\.js/,0.0,0,0,0
15804,15804,/node_modules\/sqlite3\/.*?\.node/,0.0,0,0,0
15805,15805,/node_modules\/sqlite\/.*?\.js/,0.0,0,0,0
15806,15806,/oops from getStaticProps/,0.0,0,0,0
15807,15807,/opengraph-image-\w{6}\?/,0.0,0,0,0
15808,15808,/page could not be found/,0.0,0,0,0
15809,15809,/params - blog query - xxx/,0.0,0,0,0
15810,15810,"/partial-gen-params fetch ([\d]{1,})/",0.0,0,0,0
15811,15811,"/partial-gen-params-no-additional-([\w]{1,})\/([\w]{1,})\/([\d]{1,})/",0.0,0,0,0
15812,15812,"/partial-gen-params-no-additional-lang\/en\/([\d]{1,})/",0.0,0,0,0
15813,15813,"/partial-gen-params-no-additional-slug\/en\/([\d]{1,})/",0.0,0,0,0
15814,15814,/parts: hello\/world/,0.0,0,0,0
15815,15815,/please/,0.0,0,0,0
15816,15816,/post.*?post-1/,0.0,0,0,0
15817,15817,/props[\s\S]*?name': 'symbol'[\s\S]*?name': 'value'[\s\S]*?name': 'emphasize'[\s\S]*?name': 'unit'/m,0.0,0,0,0
15818,15818,/props[\s\S]*?name': 'unit'[\s\S]*?name': 'emphasize'[\s\S]*?name': 'value'[\s\S]*?name': 'symbol'/m,0.0,0,0,0
15819,15819,/props[\s\S]*?name': 'value'[\s\S]*?name': 'unit'[\s\S]*?name': 'emphasize'[\s\S]*?name': 'symbol'/m,0.0,0,0,0
15820,15820,/react-refresh-utils[\\/]dist[\\/]loader\.js/,0.0,0,0,0
15821,15821,/require\('!!.*?\/loaders\/examples-loader\.js!\.\/examples.md'\)/,0.0,0,0,0
15822,15822,/require\('!!.*?\/loaders\/examples-loader\.js!test\/components\/Button\/Readme.md'\)/,0.0,0,0,0
15823,15823,/select|option/i,0.0,0,0,0
15824,15824,/shared:client:(\d+)/g,0.0,0,0,0
15825,15825,/shared:server:(\d+)/g,0.0,0,0,0
15826,15826,/slug-1/,0.0,0,0,0
15827,15827,/slug: first/,0.0,0,0,0
15828,15828,/slug: hello-dynamic/,0.0,0,0,0
15829,15829,/success/,0.0,0,0,0
15830,15830,/swapped from/,0.0,0,0,0
15831,15831,/test-cookie/,0.0,0,0,0
15832,15832,/test.+jpg/,0.0,0,0,0
15833,15833,/test\/components\/$/,0.0,0,0,0
15834,15834,/the entry 'b' does not exist in the observable map/,0.0,0,0,0
15835,15835,/the same slug name/,0.0,0,0,0
15836,15836,/this is a test/,0.0,0,0,0
15837,15837,/throwing error for \/blocking-fallback\/test-errors-1/,0.0,0,0,0
15838,15838,/throwing error for \/blocking-fallback\/test-errors-2/,0.0,0,0,0
15839,15839,/to \/edge\/\[id\]/,0.0,0,0,0
15840,15840,/to \/edge\/foo/,0.0,0,0,0
15841,15841,/toast/,0.0,0,0,0
15842,15842,/twitter-image-\w{6}\?/,0.0,0,0,0
15843,15843,/url:.*?something/,0.0,0,0,0
15844,15844,/webpack.config.js$/,0.0,0,0,0
15845,15845,/wildcard type/,0.0,0,0,0
15846,15846,/{color:(\s*)blue;?}/,0.0,0,0,0
15847,15847,/{color:(\s*)hotpink;?}/,0.0,0,0,0
15848,15848,/{color:(\s*)purple;?}/,0.0,0,0,0
15849,15849,1.15,0.0,0,0,0
15850,15850,102,0.0,0,0,0
15851,15851,103,0.0,0,0,0
15852,15852,10_000,0.0,0,0,0
15853,15853,114,0.0,0,0,0
15854,15854,123,0.0,0,0,0
15855,15855,1234,0.0,0,0,0
15856,15856,17,0.0,0,0,0
15857,15857,1st cell,0.0,0,0,0
15858,15858,1st header,0.0,0,0,0
15859,15859,204,0.0,0,0,0
15860,15860,20_000,0.0,0,0,0
15861,15861,2250,0.0,0,0,0
15862,15862,2270,0.0,0,0,0
15863,15863,2500,0.0,0,0,0
15864,15864,28,0.0,0,0,0
15865,15865,2nd cell,0.0,0,0,0
15866,15866,2nd header,0.0,0,0,0
15867,15867,308,0.0,0,0,0
15868,15868,31,0.0,0,0,0
15869,15869,315,0.0,0,0,0
15870,15870,4.2,0.0,0,0,0
15871,15871,405,0.0,0,0,0
15872,15872,41,0.0,0,0,0
15873,15873,413,0.0,0,0,0
15874,15874,4210,0.0,0,0,0
15875,15875,4230,0.0,0,0,0
15876,15876,512,0.0,0,0,0
15877,15877,5120,0.0,0,0,0
15878,15878,63,0.0,0,0,0
15879,15879,630,0.0,0,0,0
15880,15880,700,0.0,0,0,0
15881,15881,7010,0.0,0,0,0
15882,15882,7030,0.0,0,0,0
15883,15883,710,0.0,0,0,0
15884,15884,730,0.0,0,0,0
15885,15885,75,0.0,0,0,0
15886,15886,777,0.0,0,0,0
15887,15887,84,0.0,0,0,0
15888,15888,87,0.0,0,0,0
15889,15889,90,0.0,0,0,0
15890,15890,900,0.0,0,0,0
15891,15891,9000,0.0,0,0,0
15892,15892,9385,0.0,0,0,0
15893,15893,94,0.0,0,0,0
15894,15894,99,0.0,0,0,0
15895,15895,9999,0.0,0,0,0
15896,15896,A1,0.0,0,0,0
15897,15897,A2,0.0,0,0,0
15898,15898,A2_child,0.0,0,0,0
15899,15899,A2a,0.0,0,0,0
15900,15900,A3,0.0,0,0,0
15901,15901,A4,0.0,0,0,0
15902,15902,ACTION,0.0,0,0,0
15903,15903,ACTIVATE,0.0,0,0,0
15904,15904,ADD,0.0,0,0,0
15905,15905,ANOTHER_MIDDLEWARE_TEST,0.0,0,0,0
15906,15906,AUTH,0.0,0,0,0
15907,15907,About,0.0,0,0,0
15908,15908,ActorContext,0.0,0,0,0
15909,15909,ActorRef,0.0,0,0,0
15910,15910,AnyEventObject,0.0,0,0,0
15911,15911,AnyInterpreter,0.0,0,0,0
15912,15912,AnyState,0.0,0,0,0
15913,15913,AnyStateMachine,0.0,0,0,0
15914,15914,App,0.0,0,0,0
15915,15915,ArgumentRenderer,0.0,0,0,0
15916,15916,ArgumentsRenderer,0.0,0,0,0
15917,15917,B1,0.0,0,0,0
15918,15918,B2,0.0,0,0,0
15919,15919,B3,0.0,0,0,0
15920,15920,B4,0.0,0,0,0
15921,15921,BAZ,0.0,0,0,0
15922,15922,BB,0.0,0,0,0
15923,15923,BBB_A,0.0,0,0,0
15924,15924,BBB_B,0.0,0,0,0
15925,15925,BEGIN,0.0,0,0,0
15926,15926,BIN_PATH,0.0,0,0,0
15927,15927,BROWSER_NAME,0.0,0,0,0
15928,15928,B_ACTIVITY,0.0,0,0,0
15929,15929,Backdrop,0.0,0,0,0
15930,15930,BaseComponent,0.0,0,0,0
15931,15931,Behavior,0.0,0,0,0
15932,15932,BrowserInterface,0.0,0,0,0
15933,15933,BuildErrorMessage,0.0,0,0,0
15934,15934,Button2,0.0,0,0,0
15935,15935,C1,0.0,0,0,0
15936,15936,C2,0.0,0,0,0
15937,15937,C3,0.0,0,0,0
15938,15938,C4,0.0,0,0,0
15939,15939,CALLBACK,0.0,0,0,0
15940,15940,CANCEL,0.0,0,0,0
15941,15941,CHECK,0.0,0,0,0
15942,15942,CHILD_DONE,0.0,0,0,0
15943,15943,CHILD_UPDATED,0.0,0,0,0
15944,15944,CLASS_BACKDROP,0.0,0,0,0
15945,15945,CLASS_NAME_FADE,0.0,0,0,0
15946,15946,CLASS_NAME_SHOW,0.0,0,0,0
15947,15947,CLICK_BAD,0.0,0,0,0
15948,15948,CLICK_GOOD,0.0,0,0,0
15949,15949,CODE,0.0,0,0,0
15950,15950,CONFIG_ERROR,0.0,0,0,0
15951,15951,COUNT,0.0,0,0,0
15952,15952,CSS,0.0,0,0,0
15953,15953,Checkbox,0.0,0,0,0
15954,15954,Child One Title,0.0,0,0,0
15955,15955,Child Two Title,0.0,0,0,0
15956,15956,Class,0.0,0,0,0
15957,15957,ClipboardStatus,0.0,0,0,0
15958,15958,Closed,0.0,0,0,0
15959,15959,Cmpnt,0.0,0,0,0
15960,15960,Components,0.0,0,0,0
15961,15961,ComponentsList,0.0,0,0,0
15962,15962,ComponentsListRenderer,0.0,0,0,0
15963,15963,Content,0.0,0,0,0
15964,15964,ContextFrom,0.0,0,0,0
15965,15965,D,0.0,0,0,0
15966,15966,DATA_KEY,0.0,0,0,0
15967,15967,DBCAPQRS,0.0,0,0,0
15968,15968,DEACTIVATE,0.0,0,0,0
15969,15969,DEC,0.0,0,0,0
15970,15970,DESTROY,0.0,0,0,0
15971,15971,DOMParser,0.0,0,0,0
15972,15972,DONE,0.0,0,0,0
15973,15973,Deeper Title,0.0,0,0,0
15974,15974,Default,0.0,0,0,0
15975,15975,DefaultType,0.0,0,0,0
15976,15976,DefinePlugin,0.0,0,0,0
15977,15977,DevServerPluginArgs,0.0,0,0,0
15978,15978,DisplayModes,0.0,0,0,0
15979,15979,EMPTY,0.0,0,0,0
15980,15980,END,0.0,0,0,0
15981,15981,ENTER_PARALLEL,0.0,0,0,0
15982,15982,EVENT_1,0.0,0,0,0
15983,15983,EVENT_2,0.0,0,0,0
15984,15984,EVENT_KEY,0.0,0,0,0
15985,15985,EVENT_WITH_FLAG,0.0,0,0,0
15986,15986,EXAMPLE_TAB_CODE_EDITOR,0.0,0,0,0
15987,15987,EXIT,0.0,0,0,0
15988,15988,EXTERNAL_EVENT,0.0,0,0,0
15989,15989,Editor,0.0,0,0,0
15990,15990,EditorLoaderRenderer,0.0,0,0,0
15991,15991,EmittedFrom,0.0,0,0,0
15992,15992,ErrorRenderer,0.0,0,0,0
15993,15993,EventFrom,0.0,0,0,0
15994,15994,EventObject,0.0,0,0,0
15995,15995,ExamplePlaceholderRenderer,0.0,0,0,0
15996,15996,Examples,0.0,0,0,0
15997,15997,Extract,0.0,0,0,0
15998,15998,FAILURE,0.0,0,0,0
15999,15999,FETCH,0.0,0,0,0
16000,16000,FINISH_CHILD,0.0,0,0,0
16001,16001,FIRE,0.0,0,0,0
16002,16002,FIRED,0.0,0,0,0
16003,16003,FIRE_DELAY,0.0,0,0,0
16004,16004,Failed,0.0,0,0,0
16005,16005,FakeToolbar,0.0,0,0,0
16006,16006,Fancy title,0.0,0,0,0
16007,16007,FileSystemCache,0.0,0,0,0
16008,16008,First,0.0,0,0,0
16009,16009,FixtureList,0.0,0,0,0
16010,16010,FixtureStateValues,0.0,0,0,0
16011,16011,FocusTrap,0.0,0,0,0
16012,16012,FormData,0.0,0,0,0
16013,16013,GENERIC_RSC_ERROR,0.0,0,0,0
16014,16014,GIVE_ANSWER,0.0,0,0,0
16015,16015,GO_TO_B,0.0,0,0,0
16016,16016,GO_TO_C,0.0,0,0,0
16017,16017,GetServerSidePropsContext,0.0,0,0,0
16018,16018,GetStaticPropsContext,0.0,0,0,0
16019,16019,Head,0.0,0,0,0
16020,16020,Hello,0.0,0,0,0
16021,16021,HistoryState,0.0,0,0,0
16022,16022,Hr,0.0,0,0,0
16023,16023,HtmlWebpackPlugin,0.0,0,0,0
16024,16024,INC,0.0,0,0,0
16025,16025,INC_TWICE,0.0,0,0,0
16026,16026,INITIALIZE_SYNC_SEQUENCE,0.0,0,0,0
16027,16027,INNER1,0.0,0,0,0
16028,16028,INNER2,0.0,0,0,0
16029,16029,IObjectDidChange,0.0,0,0,0
16030,16030,Idle,0.0,0,0,0
16031,16031,InferGetServerSidePropsType,0.0,0,0,0
16032,16032,InferGetStaticPropsType,0.0,0,0,0
16033,16033,Interpreter,0.0,0,0,0
16034,16034,InterpreterStatus,0.0,0,0,0
16035,16035,JsDoc,0.0,0,0,0
16036,16036,K,0.0,0,0,0
16037,16037,LOG,0.0,0,0,0
16038,16038,Link,0.0,0,0,0
16039,16039,M,0.0,0,0,0
16040,16040,MACRO,0.0,0,0,0
16041,16041,MICRO,0.0,0,0,0
16042,16042,MIDDLEWARE_TEST,0.0,0,0,0
16043,16043,MY_PLUGIN,0.0,0,0,0
16044,16044,MY_PLUGIN2,0.0,0,0,0
16045,16045,MY_RULE,0.0,0,0,0
16046,16046,MachineOptionsFrom,0.0,0,0,0
16047,16047,Main Title,0.0,0,0,0
16048,16048,Markdown,0.0,0,0,0
16049,16049,MethodsRenderer,0.0,0,0,0
16050,16050,MiniHtmlWebpackPlugin,0.0,0,0,0
16051,16051,MyPlugin,0.0,0,0,0
16052,16052,NAME,0.0,0,0,0
16053,16053,NEXT_A,0.0,0,0,0
16054,16054,NEXT_B,0.0,0,0,0
16055,16055,NEXT_B_TO_X,0.0,0,0,0
16056,16056,NEXT_FONT_GOOGLE_MOCKED_RESPONSES,0.0,0,0,0
16057,16057,NEXT_RUNTIME,0.0,0,0,0
16058,16058,NEXT_X_TO_Y,0.0,0,0,0
16059,16059,NODE_OPTIONS,0.0,0,0,0
16060,16060,Nested Title,0.0,0,0,0
16061,16061,NextInstance,0.0,0,0,0
16062,16062,ONE,0.0,0,0,0
16063,16063,OTHER,0.0,0,0,0
16064,16064,OUTER1,0.0,0,0,0
16065,16065,OUTER2,0.0,0,0,0
16066,16066,ObservableMap,0.0,0,0,0
16067,16067,ObservableSet,0.0,0,0,0
16068,16068,Opened,0.0,0,0,0
16069,16069,OtherComponent,0.0,0,0,0
16070,16070,P,0.0,0,0,0
16071,16071,PHASE_EXPORT,0.0,0,0,0
16072,16072,PHASE_PRODUCTION_BUILD,0.0,0,0,0
16073,16073,PHASE_PRODUCTION_SERVER,0.0,0,0,0
16074,16074,PING,0.0,0,0,0
16075,16075,PING_CHILD,0.0,0,0,0
16076,16076,PONG,0.0,0,0,0
16077,16077,PORT,0.0,0,0,0
16078,16078,PREV,0.0,0,0,0
16079,16079,PageNotFoundError,0.0,0,0,0
16080,16080,Pizza,0.0,0,0,0
16081,16081,Playground,0.0,0,0,0
16082,16082,PlaygroundErrorRenderer,0.0,0,0,0
16083,16083,PlaygroundRenderer,0.0,0,0,0
16084,16084,PropsRenderer,0.0,0,0,0
16085,16085,RAISED,0.0,0,0,0
16086,16086,REENTER,0.0,0,0,0
16087,16087,RENDERER_FILENAME,0.0,0,0,0
16088,16088,REQUEST_SECRET,0.0,0,0,0
16089,16089,REQUIRE_ANYTHING_REGEX,0.0,0,0,0
16090,16090,RESET,0.0,0,0,0
16091,16091,RESTART,0.0,0,0,0
16092,16092,RETRY,0.0,0,0,0
16093,16093,REVALIDATE,0.0,0,0,0
16094,16094,RandomName,0.0,0,0,0
16095,16095,React Styleguidist,0.0,0,0,0
16096,16096,ReactComponentRenderer,0.0,0,0,0
16097,16097,ReactServer,0.0,0,0,0
16098,16098,ReadOnly,0.0,0,0,0
16099,16099,Readable,0.0,0,0,0
16100,16100,RendererReadyResponse,0.0,0,0,0
16101,16101,RendererResponse,0.0,0,0,0
16102,16102,Request,0.0,0,0,0
16103,16103,Ribbon,0.0,0,0,0
16104,16104,RibbonRenderer,0.0,0,0,0
16105,16105,Running,0.0,0,0,0
16106,16106,SAVE,0.0,0,0,0
16107,16107,SIMPLE_STRING_REGEX,0.0,0,0,0
16108,16108,SOME_EVENT,0.0,0,0,0
16109,16109,SPAWN,0.0,0,0,0
16110,16110,STARTED,0.0,0,0,0
16111,16111,STATE_INNER1,0.0,0,0,0
16112,16112,STATE_INNER2,0.0,0,0,0
16113,16113,STATE_NTJ0,0.0,0,0,0
16114,16114,STATE_NTJ1,0.0,0,0,0
16115,16115,STATE_ON,0.0,0,0,0
16116,16116,STATE_ON_COMPLEX,0.0,0,0,0
16117,16117,STOP,0.0,0,0,0
16118,16118,STOP_CHILD,0.0,0,0,0
16119,16119,STOP_ONE,0.0,0,0,0
16120,16120,STRING_ENV_VAR,0.0,0,0,0
16121,16121,SUBMIT,0.0,0,0,0
16122,16122,SUCCESS,0.0,0,0,0
16123,16123,Scheduler,0.0,0,0,0
16124,16124,Script,0.0,0,0,0
16125,16125,Second,0.0,0,0,0
16126,16126,Second Test,0.0,0,0,0
16127,16127,SectionRenderer,0.0,0,0,0
16128,16128,Sections,0.0,0,0,0
16129,16129,SelectFixtureRequest,0.0,0,0,0
16130,16130,SelectionStatus,0.0,0,0,0
16131,16131,SelectorEngine,0.0,0,0,0
16132,16132,Server,0.0,0,0,0
16133,16133,ServerMessage,0.0,0,0,0
16134,16134,Slot,0.0,0,0,0
16135,16135,SocketMessage,0.0,0,0,0
16136,16136,SpecialTargets,0.0,0,0,0
16137,16137,StateFrom,0.0,0,0,0
16138,16138,StateMachine,0.0,0,0,0
16139,16139,StateNode,0.0,0,0,0
16140,16140,StateValue,0.0,0,0,0
16141,16141,StateValueFrom,0.0,0,0,0
16142,16142,Stopped,0.0,0,0,0
16143,16143,StructureEdit,0.0,0,0,0
16144,16144,StyleGuide,0.0,0,0,0
16145,16145,Styled,0.0,0,0,0
16146,16146,StyleguidistOptionsPlugin,0.0,0,0,0
16147,16147,Succeeded,0.0,0,0,0
16148,16148,SyntaxError,0.0,0,0,0
16149,16149,TARGET_INVALID,0.0,0,0,0
16150,16150,TEST,0.0,0,0,0
16151,16151,TEST_DATA,0.0,0,0,0
16152,16152,TICK,0.0,0,0,0
16153,16153,TOKEN,0.0,0,0,0
16154,16154,TO_B,0.0,0,0,0
16155,16155,TO_E,0.0,0,0,0
16156,16156,TO_FOO,0.0,0,0,0
16157,16157,TO_Y,0.0,0,0,0
16158,16158,TRIGGER,0.0,0,0,0
16159,16159,TURN_OFF,0.0,0,0,0
16160,16160,TWO,0.0,0,0,0
16161,16161,TableOfContents,0.0,0,0,0
16162,16162,TableOfContentsRenderer,0.0,0,0,0
16163,16163,TableRenderer,0.0,0,0,0
16164,16164,TagsFrom,0.0,0,0,0
16165,16165,Test Title with itemProp,0.0,0,0,0
16166,16166,TestModel,0.0,0,0,0
16167,16167,The markdown heading,0.0,0,0,0
16168,16168,This is pre-formatted text.,0.0,0,0,0
16169,16169,Title with Itemprop,0.0,0,0,0
16170,16170,Title you will never see,0.0,0,0,0
16171,16171,Title: ,0.0,0,0,0
16172,16172,"To be, or not to be: that is the question",0.0,0,0,0
16173,16173,TransitionEvent,0.0,0,0,0
16174,16174,TypegenMeta,0.0,0,0,0
16175,16175,UA_STRING,0.0,0,0,0
16176,16176,UNEXPECTED_EVENT,0.0,0,0,0
16177,16177,URLSearchParams,0.0,0,0,0
16178,16178,Usage,0.0,0,0,0
16179,16179,UsageTabButton,0.0,0,0,0
16180,16180,UseActor,0.0,0,0,0
16181,16181,UseActorComponentProp,0.0,0,0,0
16182,16182,UseActorCreateSimple,0.0,0,0,0
16183,16183,UseActorSimple,0.0,0,0,0
16184,16184,UseFSM,0.0,0,0,0
16185,16185,UseFsm,0.0,0,0,0
16186,16186,UseInterpret,0.0,0,0,0
16187,16187,UseMachine,0.0,0,0,0
16188,16188,UseMachineNoExtraOptions,0.0,0,0,0
16189,16189,UseMachineNonPersistentSubcription,0.0,0,0,0
16190,16190,UseSelector,0.0,0,0,0
16191,16191,UseSelectorCustomFn,0.0,0,0,0
16192,16192,V,0.0,0,0,0
16193,16193,VERCEL_ANALYTICS_ID,0.0,0,0,0
16194,16194,VERSION,0.0,0,0,0
16195,16195,WHATEVER,0.0,0,0,0
16196,16196,WelcomeRenderer,0.0,0,0,0
16197,16197,Y,0.0,0,0,0
16198,16198,Z,0.0,0,0,0
16199,16199,__,0.0,0,0,0
16200,16200,__N,0.0,0,0,0
16201,16201,__next_preview_data,0.0,0,0,0
16202,16202,__prerender_bypass,0.0,0,0,0
16203,16203,__test__ext,0.0,0,0,0
16204,16204,__tip,0.0,0,0,0
16205,16205,_activate,0.0,0,0,0
16206,16206,_activeElement,0.0,0,0,0
16207,16207,_activeTarget,0.0,0,0,0
16208,16208,_addEventListeners,0.0,0,0,0
16209,16209,_addTouchEventListeners,0.0,0,0,0
16210,16210,_appDir,0.0,0,0,0
16211,16211,_clearTimeout,0.0,0,0,0
16212,16212,_ctx,0.0,0,0,0
16213,16213,_deltaX,0.0,0,0,0
16214,16214,_deps,0.0,0,0,0
16215,16215,_e,0.0,0,0,0
16216,16216,_error,0.0,0,0,0
16217,16217,_ev,0.0,0,0,0
16218,16218,_getElement,0.0,0,0,0
16219,16219,_getOffset,0.0,0,0,0
16220,16220,_getPopperConfig,0.0,0,0,0
16221,16221,_getTitle,0.0,0,0,0
16222,16222,_index,0.0,0,0,0
16223,16223,_initEvents,0.0,0,0,0
16224,16224,_interval,0.0,0,0,0
16225,16225,_isAnimated,0.0,0,0,0
16226,16226,_isShown,0.0,0,0,0
16227,16227,_isSliding,0.0,0,0,0
16228,16228,_isWithContent,0.0,0,0,0
16229,16229,_key,0.0,0,0,0
16230,16230,_machine,0.0,0,0,0
16231,16231,_mergeConfigObj,0.0,0,0,0
16232,16232,_next,0.0,0,0,0
16233,16233,_observableSections,0.0,0,0,0
16234,16234,_observer,0.0,0,0,0
16235,16235,_options,0.0,0,0,0
16236,16236,_requestHeaders,0.0,0,0,0
16237,16237,_rootElement,0.0,0,0,0
16238,16238,_send,0.0,0,0,0
16239,16239,_sendBack,0.0,0,0,0
16240,16240,_setInitialAttributes,0.0,0,0,0
16241,16241,_state,0.0,0,0,0
16242,16242,_stopServer,0.0,0,0,0
16243,16243,_supportPointerEvents,0.0,0,0,0
16244,16244,_tag,0.0,0,0,0
16245,16245,_targetLinks,0.0,0,0,0
16246,16246,_timeout,0.0,0,0,0
16247,16247,_typeCheckConfig,0.0,0,0,0
16248,16248,_userModelEventSubset,0.0,0,0,0
16249,16249,_value,0.0,0,0,0
16250,16250,_xs,0.0,0,0,0
16251,16251,"`
				foo: PropTypes.shape({
					bar: PropTypes.number.isRequired,
					baz: PropTypes.any,
				})
			`",0.0,0,0,0
16252,16252,"`
				foo: somethingThatDoesntExist
			`",0.0,0,0,0
16253,16253,"`
				foo: {
					bar: 123, baz() {
						return 'foo';
					},
					bing() {
						return 'badaboom';
					},
					trotskij: () => 1935,
					qwarc: { si: 'señor', },
				}
			`",0.0,0,0,0
16254,16254,"`
                                                                        ""import { action, makeObservable } from \\""mobx\\"";

                                                                        class Box {
                                                                            constructor() {
                                                                                makeObservable(this, {
                                                                                    x: action
                                                                                });
                                                                            }

                                                                            x(arg: number): boolean {
                                                                                console.log('hi')
                                                                                return true
                                                                            }
                                                                        }""
                                                `",0.0,0,0,0
16255,16255,"`
                                                                        ""import { action, makeObservable } from \\""mobx\\"";

                                                                        class Box {
                                                                            constructor() {
                                                                                makeObservable(this, {
                                                                                    x: action(\\""test\\"")
                                                                                });
                                                                            }

                                                                            x(arg: number): boolean {
                                                                                console.log('hi')
                                                                                return true
                                                                            }
                                                                        }""
                                                `",0.0,0,0,0
16256,16256,"`
                                                                        ""import { action, makeObservable } from \\""mobx\\"";

                                                                        class Box {
                                                                            constructor() {
                                                                                makeObservable(this, {
                                                                                    x: action.bound
                                                                                });
                                                                            }

                                                                            x(arg: number): boolean {
                                                                                console.log('hi')
                                                                                return true
                                                                            }
                                                                        }""
                                                `",0.0,0,0,0
16257,16257,"`
                                                                        ""import { action, makeObservable } from \\""mobx\\"";

                                                                        class Box {
                                                                            constructor() {
                                                                                makeObservable(this, {
                                                                                    x: action.bound(\\""test\\"")
                                                                                });
                                                                            }

                                                                            *x(arg: number): boolean {
                                                                                console.log('hi')
                                                                                return true
                                                                            }
                                                                        }""
                                                `",0.0,0,0,0
16258,16258,"`
                                                                        ""import { action, makeObservable } from \\""mobx\\"";

                                                                        class Box {
                                                                            constructor() {
                                                                                makeObservable(this, {
                                                                                    x: action.bound(\\""test\\"")
                                                                                });
                                                                            }

                                                                            async x(arg: number): boolean {
                                                                                console.log('hi')
                                                                                return true
                                                                            }
                                                                        }""
                                                `",0.0,0,0,0
16259,16259,"`
                                                                        ""import { action, makeObservable } from \\""mobx\\"";

                                                                        class Box {
                                                                            x = (arg: number) => {
                                                                                console.log('hi')
                                                                            };

                                                                            constructor() {
                                                                                makeObservable(this, {
                                                                                    x: action.bound(\\""test\\"")
                                                                                });
                                                                            }
                                                                        }""
                                                `",0.0,0,0,0
16260,16260,"`
                                                                        ""import { action, makeObservable } from \\""mobx\\"";

                                                                        class Box {
                                                                            x = (arg: number): boolean => {
                                                                                console.log('hi')
                                                                                return true
                                                                            };

                                                                            constructor() {
                                                                                makeObservable(this, {
                                                                                    x: action
                                                                                });
                                                                            }
                                                                        }""
                                                `",0.0,0,0,0
16261,16261,"`
                                                                        ""import { action, makeObservable } from \\""mobx\\"";

                                                                        class Box {
                                                                            x = async (arg: number): boolean => {
                                                                                console.log('hi')
                                                                                return true
                                                                            };

                                                                            constructor() {
                                                                                makeObservable(this, {
                                                                                    x: action(\\""test\\"")
                                                                                });
                                                                            }
                                                                        }""
                                                `",0.0,0,0,0
16262,16262,"`
                                                                        ""import { computed, makeObservable } from \\""mobx\\"";

                                                                        class Box {
                                                                            constructor() {
                                                                                makeObservable(this, {
                                                                                    x: computed
                                                                                });
                                                                            }

                                                                            get x() {
                                                                                return 1;
                                                                            }
                                                                            set x(v) {
                                                                                console.log(v)
                                                                            }
                                                                        }""
                                                `",0.0,0,0,0
16263,16263,"`
                                                                        ""import { computed, makeObservable } from \\""mobx\\"";

                                                                        class Box {
                                                                            constructor() {
                                                                                makeObservable(this, {
                                                                                    x: computed
                                                                                });
                                                                            }

                                                                            get x() {
                                                                                return 1;
                                                                            }
                                                                        }""
                                                `",0.0,0,0,0
16264,16264,"`
                                                                        ""import { computed, makeObservable } from \\""mobx\\"";

                                                                        class Box {
                                                                            constructor() {
                                                                                makeObservable(this, {
                                                                                    x: computed({ name: \\""test\\"" })
                                                                                });
                                                                            }

                                                                            get x() {
                                                                                return 1;
                                                                            }
                                                                            set y(z) {
                                                                                console.log(\\""wrong\\"");
                                                                            }
                                                                            set x(v) {
                                                                                console.log(v)
                                                                            }
                                                                        }""
                                                `",0.0,0,0,0
16265,16265,"`
                                                                        ""import { computed, makeObservable } from \\""mobx\\"";

                                                                        class Box {
                                                                            constructor() {
                                                                                makeObservable(this, {
                                                                                    x: computed.struct
                                                                                });
                                                                            }

                                                                            get x() {
                                                                                return 1;
                                                                            }
                                                                            set x(v) {
                                                                                console.log(v)
                                                                            }
                                                                        }""
                                                `",0.0,0,0,0
16266,16266,"`
                                                                        ""import { observable, makeObservable } from \\""mobx\\"";

                                                                        class Box {
                                                                            x = 1;

                                                                            constructor() {
                                                                                makeObservable(this, {
                                                                                    x: observable
                                                                                });
                                                                            }
                                                                        }""
                                                `",0.0,0,0,0
16267,16267,"`
                                                                        ""import { observable, makeObservable } from \\""mobx\\"";

                                                                        class ExtendsHasConstructor {
                                                                            x = 1;

                                                                            constructor() {
                                                                                makeObservable(this, {
                                                                                    x: observable
                                                                                });

                                                                                console.log(\\""hi\\"")
                                                                            }
                                                                        }""
                                                `",0.0,0,0,0
16268,16268,"`
                                                                        ""import { observable, makeObservable } from \\""mobx\\"";

                                                                        class ExtendsHasConstructorSuper extends Box {
                                                                            x = 1;

                                                                            constructor() {
                                                                                super()

                                                                                makeObservable(this, {
                                                                                    x: observable
                                                                                });

                                                                                console.log(\\""hi\\"")
                                                                            }
                                                                        }""
                                                `",0.0,0,0,0
16269,16269,"`
                                                            ""import { observable, makeObservable } from \\""mobx\\"";

                                                            class Box {
                                                                /*0*/
                                                                /*1*/
                                                                field /*2 */ = /*3*/ 1; /*4*/

                                                                constructor() {
                                                                    makeObservable(this, {
                                                                        field: observable
                                                                    });
                                                                }
                                                            }""
                                        `",0.0,0,0,0
16270,16270,"`
                                                ""import { action, makeObservable } from \\""mobx\\"";

                                                class Box {
                                                    constructor() {
                                                        makeObservable(this, {
                                                            ['x' + 'y']: action
                                                        });
                                                    }

                                                    ['x' + 'y'](arg: number): boolean {
                                                        console.log('hi')
                                                        return true
                                                    }
                                                }""
                                `",0.0,0,0,0
16271,16271,"`
                        ""import { observable, computed, action, makeObservable } from \\""mobx\\""

                        makeObservable({}, {
                            width: observable,
                            height: observable.shallow,
                        })""
                `",0.0,0,0,0
16272,16272,"`
                    body {
                        background-color: green;
                    }
                `",0.0,0,0,0
16273,16273,"`
                    p {
                        font-size: 12px;
                    }
                `",0.0,0,0,0
16274,16274,"`
                  {
                    ""@context"": ""http://schema.org"",
                    ""@type"": ""NewsArticle"",
                    ""url"": ""http://localhost/helmet""
                  }
                `",0.0,0,0,0
16275,16275,"`
                import { observable, decorate, computed, action } from ""mobx""
    
    class TryToGetThis {
        @observable
        private privateField1: number = 1
        @observable
        protected privateField2 = 1
        @observable
        public publicField: string = ""test""
      }
                `",0.0,0,0,0
16276,16276,"`
              ""test error
              Path:
              	State: {\\""value\\"":\\""first\\""}
              	Event: {\\""type\\"":\\""NEXT\\""}

              	State: {\\""value\\"":\\""second\\""} via {\\""type\\"":\\""NEXT\\""}
              	Event: {\\""type\\"":\\""NEXT\\""}

              	State: {\\""value\\"":\\""third\\""} via {\\""type\\"":\\""NEXT\\""}""
            `",0.0,0,0,0
16277,16277,"`
              import { observable } from ""mobx""

              class Box {
                @observable.shallow ['x'] = 1
            }
            `",0.0,0,0,0
16278,16278,"`
            ""class Box {
                /*0*/
                /*1*/
                field /*2 */ = /*3*/ 1; /*4*/

                constructor() {
                    makeObservable(this, {
                        field: observable
                    });
                }
            }""
        `",0.0,0,0,0
16279,16279,"`
            ""class Box {
                /*0*/
                @observable
                /*1*/
                field /*2 */ = /*3*/ 1 /*4*/

                constructor() {
                    makeObservable(this);
                }
            }""
        `",0.0,0,0,0
16280,16280,"`
            ""export const metadata = {
              title: 'Next.js',
              description: 'Generated by Next.js',
            }
             
            export default function RootLayout({ children }) {
             return (
                <html lang=\\""en\\"">
                  <body>{children}</body>
                </html>
              )
            }
            ""
          `",0.0,0,0,0
16281,16281,"`
            ""import type { IReactionDisposer } from 'mobx';
            import { reaction, observable, makeObservable } from 'mobx';

            export default class Store {
                counter = 0;

                removeReaction: IReactionDisposer;

                constructor() {
                    makeObservable(this, {
                        counter: observable
                    });

                    this.removeReaction = reaction(() => this.counter, () => {
                        console.log('it changed');
                    });
                }

                cleanup() {
                    this.removeReaction();
                }
            }""
        `",0.0,0,0,0
16282,16282,"`
            ""import { observable, computed, action, makeObservable } from \\""mobx\\""

            class Box {
                constructor() {
                    makeObservable(this, {
                        // stuff
                        width: observable,
                        height: observable.shallow,
                    });
                }
            }""
        `",0.0,0,0,0
16283,16283,"`
            ""import { observable, computed, action, makeObservable } from \\""mobx\\""

            class Box {
                width = 3
                height = 2

                constructor() {
                    makeObservable(this, {
                        width: observable,
                        height: observable.shallow,
                        size: computed,
                        double: action
                    });
                }

                // gets the size of the thing
                get size() {
                    return this.width * this.height
                }

                // make it twice as large
                double() {
                    this.width *= 2;
                }
            }""
        `",0.0,0,0,0
16284,16284,"`
            ""import { observable, computed, action, makeObservable } from \\""mobx\\""

            class TryToGetThis {
                        @observable
                        private privateField1: number = 1
                        @observable
                        protected privateField2 = 1
                        @observable
                        public publicField: string = \\""test\\""

                        constructor() {
                                    makeObservable(this);
                        }
            }""
        `",0.0,0,0,0
16285,16285,"`
            ""import { observable, computed, action, makeObservable } from \\""mobx\\""

            class TryToGetThis {
                        private privateField1: number = 1;
                        protected privateField2 = 1;
                        public publicField: string = \\""test\\"";

                        constructor() {
                                    makeObservable<TryToGetThis, \\""privateField1\\"" | \\""privateField2\\"">(this, {
                                                privateField1: observable,
                                                privateField2: observable,
                                                publicField: observable
                                    });
                        }
            }""
        `",0.0,0,0,0
16286,16286,"`
            ""import { observable, computed, action, makeObservable } from \\""mobx\\""

            const box = {

            }

            makeObservable(box, {
                width: observable,
                height: observable.shallow,
            })""
        `",0.0,0,0,0
16287,16287,"`
            ""import { observable, computed, action, makeObservable } from \\""mobx\\""

            test(\\""a\\"", () => {
                class Box {
                    width = 3

                    constructor() {
                        makeObservable(this, {
                            width: observable,
                        });
                    }
                }
            })

            test(\\""b\\"", () => {
                class Box {
                    constructor() {
                        makeObservable(this, {
                            method: action
                        });
                    }

                    method() {}
                }
            })""
        `",0.0,0,0,0
16288,16288,"`
            ""import { observable, makeObservable } from \\""mobx\\"";

              class Box {
                ['x'] = 1;

                constructor() {
                  makeObservable(this, {
                    [\\""x\\""]: observable.shallow
                  });
                }
              }""
        `",0.0,0,0,0
16289,16289,"`
            ""import { observable, makeObservable } from \\""mobx\\"";

              class Box {
                x = 1;

                constructor() {
                  makeObservable(this, {
                    x: observable.shallow
                  });
                }
              }""
        `",0.0,0,0,0
16290,16290,"`
            ""import { observable, makeObservable } from \\""mobx\\"";

            class ExtendsHasMethod extends Box {
                x = 1;

                constructor() {
                    // TODO: [mobx-undecorate] verify the constructor arguments and the arguments of this automatically generated super call
                    super();

                    makeObservable(this, {
                        x: observable
                    });
                }

                // test
                method() {
                    console.log(\\""hi\\"")
                }
            }""
        `",0.0,0,0,0
16291,16291,"`
            ""import {observer, inject} from 'mobx-react'


            /* 1 */
            export const X = inject(\\""test\\"")(class /* 2 */ /* 3 */ X extends React.Component {

            });""
        `",0.0,0,0,0
16292,16292,"`
            ""import {observer, inject} from 'mobx-react'


            /* 1 */
            export const X = inject(\\""test\\"")(observer(class /* 2 */ /* 3 */ X extends React.Component {

            }));""
        `",0.0,0,0,0
16293,16293,"`
            ""import {observer, inject} from 'mobx-react'
            import { observable, makeObservable } from \\""mobx\\"";
            import {Component} from \\""react\\""

            const X = observer(class X extends React.Component {
                field = 1;

                constructor(props) {
                    super(props);

                    makeObservable(this, {
                        field: observable
                    });
                }
            });""
        `",0.0,0,0,0
16294,16294,"`
            ""import {observer, inject} from 'mobx-react'
            import { observable, makeObservable } from \\""mobx\\"";
            import {PureComponent} from \\""react\\""

            @observer class X extends PureComponent<{x: boolean}> {
                @observable field =  1

                constructor(props: {x: boolean}) {
                    super(props);
                    makeObservable(this);
                }
            }""
        `",0.0,0,0,0
16295,16295,"`
            ""import {observer, inject} from 'mobx-react'
            import { observable, makeObservable } from \\""mobx\\"";
            import {PureComponent} from \\""react\\""

            const X = observer(class X extends PureComponent<{x: boolean}> {
                field = 1;

                constructor(props: {x: boolean}) {
                    super(props);

                    makeObservable(this, {
                        field: observable
                    });
                }
            });""
        `",0.0,0,0,0
16296,16296,"`
            ""import {observer} from 'mobx-react'

            /* 1 */
            const X = observer(class /* 2 */ X extends React.Component {
                render() {
                    return <div>hi</div>
                }
            });""
        `",0.0,0,0,0
16297,16297,"`
            ""import {observer} from 'mobx-react-lite'


            /* 1 */
            export const X = observer(class /* 2 */ /* 3 */ X extends React.Component {

            });""
        `",0.0,0,0,0
16298,16298,"`
            export default () => (<p>hello world</p>);
            export const runtime = 'edge';
          `",0.0,0,0,0
16299,16299,"`
            export default () => (<p>hello world</p>);
            export const runtime = 'experimental-edge';
          `",0.0,0,0,0
16300,16300,"`
            export default () => new Response('ok');
            export const config = { runtime: 'experimental-edge' };
          `",0.0,0,0,0
16301,16301,"`
            export default function Page() {
              return <p>Hello from server page again</p>
            }
            `",0.0,0,0,0
16302,16302,"`
            export function generateStaticParams() {
              return [{slug: { invalid: true }}]
            }
          `",0.0,0,0,0
16303,16303,"`
            import { action } from ""mobx""

            class Box {
                @action
                ['x' + 'y'](arg: number): boolean {
                    console.log('hi')
                    return true
                }
            }
            `",0.0,0,0,0
16304,16304,"`
            import { action } from ""mobx""

            class Box {
                @action
                x (arg: number): boolean {
                    console.log('hi')
                    return true
                }
            }
            `",0.0,0,0,0
16305,16305,"`
            import { action } from ""mobx""

            class Box {
                @action
                x = (arg: number): boolean => {
                    console.log('hi')
                    return true
                }
            }
            `",0.0,0,0,0
16306,16306,"`
            import { action } from ""mobx""

            class Box {
                @action(""test"")
                x (arg: number): boolean {
                    console.log('hi')
                    return true
                }
            }
            `",0.0,0,0,0
16307,16307,"`
            import { action } from ""mobx""

            class Box {
                @action(""test"")
                x = async (arg: number): boolean => {
                    console.log('hi')
                    return true
                }
            }
            `",0.0,0,0,0
16308,16308,"`
            import { action } from ""mobx""

            class Box {
                @action.bound
                x (arg: number): boolean {
                    console.log('hi')
                    return true
                }
            }
            `",0.0,0,0,0
16309,16309,"`
            import { action } from ""mobx""

            class Box {
                @action.bound(""test"")
                * x(arg: number): boolean {
                    console.log('hi')
                    return true
                }
            }
            `",0.0,0,0,0
16310,16310,"`
            import { action } from ""mobx""

            class Box {
                @action.bound(""test"")
                async x(arg: number): boolean {
                    console.log('hi')
                    return true
                }
            }
            `",0.0,0,0,0
16311,16311,"`
            import { action } from ""mobx""

            class Box {
                @action.bound(""test"")
                x = (arg: number) => {
                    console.log('hi')
                }
            }
            `",0.0,0,0,0
16312,16312,"`
            import { observable, decorate, computed, action } from ""mobx""

            class Box {

            }

            decorate(Box, {
                // stuff
                width: observable,
                height: observable.shallow,
            })
        `",0.0,0,0,0
16313,16313,"`
            import { observable, decorate, computed, action } from ""mobx""

            class Box {
                width = 3
                height = 2

                // gets the size of the thing
                get size() {
                    return this.width * this.height
                }

                // make it twice as large
                double() {
                    this.width *= 2;
                }
            }

            decorate(Box, {
                width: observable,
                height: observable.shallow,
                size: computed,
                double: action
            })
        `",0.0,0,0,0
16314,16314,"`
            import { observable, decorate, computed, action } from ""mobx""

            const box = {

            }

            decorate(box, {
                width: observable,
                height: observable.shallow,
            })
        `",0.0,0,0,0
16315,16315,"`
            import { observable, decorate, computed, action } from ""mobx""

            decorate({}, {
                width: observable,
                height: observable.shallow,
            })
        `",0.0,0,0,0
16316,16316,"`
            import { observable, decorate, computed, action } from ""mobx""

            test(""a"", () => {
                class Box {
                    width = 3
                }

                decorate(Box, {
                    width: observable,
                })
            })

            test(""b"", () => {
                class Box {
                    method() {}
                }

                decorate(Box, {
                    method: action
                })
            })
        `",0.0,0,0,0
16317,16317,"`
          ""<?xml version=\\""1.0\\"" encoding=\\""UTF-8\\""?>
          <urlset xmlns=\\""http://www.sitemaps.org/schemas/sitemap/0.9\\"">
          <url>
          <loc>https://example.com</loc>
          <lastmod>2021-01-01</lastmod>
          </url>
          <url>
          <loc>https://example.com/about</loc>
          <lastmod>2021-01-01</lastmod>
          </url>
          </urlset>
          ""
        `",0.0,0,0,0
16318,16318,"`
          ""Please make sure to include the following tags in your root layout: <html>, <body>.

          Missing required root layout tags: html, body""
        `",0.0,0,0,0
16319,16319,"`
          ""User-Agent: Googlebot
          Allow: /

          User-Agent: Applebot
          User-Agent: Bingbot
          Disallow: /
          Crawl-delay: 2

          Host: https://example.com
          Sitemap: https://example.com/sitemap.xml
          ""
        `",0.0,0,0,0
16320,16320,"`
          ""export const metadata = {
            title: 'Next.js',
            description: 'Generated by Next.js',
          }

          export default function RootLayout({
            children,
          }: {
            children: React.ReactNode
          }) {
            return (
              <html lang=\\""en\\"">
                <body>{children}</body>
              </html>
            )
          }
          ""
        `",0.0,0,0,0
16321,16321,"`
          Array [
            Object {
              ""attributes"": Object {
                ""http.method"": ""GET"",
                ""http.route"": ""/api/pages/[param]/basic"",
                ""http.status_code"": 200,
                ""http.target"": ""/api/pages/param/basic"",
                ""next.route"": ""/api/pages/[param]/basic"",
                ""next.span_name"": ""GET /api/pages/[param]/basic"",
                ""next.span_type"": ""BaseServer.handleRequest"",
              },
              ""kind"": 1,
              ""name"": ""GET /api/pages/[param]/basic"",
              ""parentId"": undefined,
              ""status"": Object {
                ""code"": 0,
              },
            },
            Object {
              ""attributes"": Object {
                ""next.span_name"": ""executing api route (pages) /api/pages/[param]/basic"",
                ""next.span_type"": ""Node.runHandler"",
              },
              ""kind"": 0,
              ""name"": ""executing api route (pages) /api/pages/[param]/basic"",
              ""parentId"": ""[parent-id]"",
              ""status"": Object {
                ""code"": 0,
              },
            },
          ]
        `",0.0,0,0,0
16322,16322,"`
          Array [
            Object {
              ""attributes"": Object {
                ""http.method"": ""GET"",
                ""http.route"": ""/pages/[param]/getServerSideProps"",
                ""http.status_code"": 200,
                ""http.target"": ""/pages/param/getServerSideProps"",
                ""next.route"": ""/pages/[param]/getServerSideProps"",
                ""next.span_name"": ""GET /pages/[param]/getServerSideProps"",
                ""next.span_type"": ""BaseServer.handleRequest"",
              },
              ""kind"": 1,
              ""name"": ""GET /pages/[param]/getServerSideProps"",
              ""parentId"": undefined,
              ""status"": Object {
                ""code"": 0,
              },
            },
            Object {
              ""attributes"": Object {
                ""next.route"": ""/pages/[param]/getServerSideProps"",
                ""next.span_name"": ""getServerSideProps /pages/[param]/getServerSideProps"",
                ""next.span_type"": ""Render.getServerSideProps"",
              },
              ""kind"": 0,
              ""name"": ""getServerSideProps /pages/[param]/getServerSideProps"",
              ""parentId"": ""[parent-id]"",
              ""status"": Object {
                ""code"": 0,
              },
            },
            Object {
              ""attributes"": Object {
                ""next.route"": ""/pages/[param]/getServerSideProps"",
                ""next.span_name"": ""render route (pages) /pages/[param]/getServerSideProps"",
                ""next.span_type"": ""Render.renderDocument"",
              },
              ""kind"": 0,
              ""name"": ""render route (pages) /pages/[param]/getServerSideProps"",
              ""parentId"": ""[parent-id]"",
              ""status"": Object {
                ""code"": 0,
              },
            },
          ]
        `",0.0,0,0,0
16323,16323,"`
          Array [
            Object {
              ""attributes"": Object {
                ""http.method"": ""GET"",
                ""http.route"": ""/pages/[param]/getStaticProps"",
                ""http.status_code"": 200,
                ""http.target"": ""/pages/param/getStaticProps"",
                ""next.route"": ""/pages/[param]/getStaticProps"",
                ""next.span_name"": ""GET /pages/[param]/getStaticProps"",
                ""next.span_type"": ""BaseServer.handleRequest"",
              },
              ""kind"": 1,
              ""name"": ""GET /pages/[param]/getStaticProps"",
              ""parentId"": undefined,
              ""status"": Object {
                ""code"": 0,
              },
            },
            Object {
              ""attributes"": Object {
                ""next.route"": ""/pages/[param]/getStaticProps"",
                ""next.span_name"": ""getStaticProps /pages/[param]/getStaticProps"",
                ""next.span_type"": ""Render.getStaticProps"",
              },
              ""kind"": 0,
              ""name"": ""getStaticProps /pages/[param]/getStaticProps"",
              ""parentId"": ""[parent-id]"",
              ""status"": Object {
                ""code"": 0,
              },
            },
            Object {
              ""attributes"": Object {
                ""next.route"": ""/pages/[param]/getStaticProps"",
                ""next.span_name"": ""render route (pages) /pages/[param]/getStaticProps"",
                ""next.span_type"": ""Render.renderDocument"",
              },
              ""kind"": 0,
              ""name"": ""render route (pages) /pages/[param]/getStaticProps"",
              ""parentId"": ""[parent-id]"",
              ""status"": Object {
                ""code"": 0,
              },
            },
          ]
        `",0.0,0,0,0
16324,16324,"`
          Array [
            Object {
              ""attributes"": Object {
                ""http.method"": ""GET"",
                ""http.url"": ""https://vercel.com/"",
                ""net.peer.name"": ""vercel.com"",
                ""next.span_name"": ""fetch GET https://vercel.com/"",
                ""next.span_type"": ""AppRender.fetch"",
              },
              ""kind"": 2,
              ""name"": ""fetch GET https://vercel.com/"",
              ""parentId"": ""[parent-id]"",
              ""status"": Object {
                ""code"": 0,
              },
            },
            Object {
              ""attributes"": Object {
                ""next.route"": ""/app/[param]/rsc-fetch"",
                ""next.span_name"": ""render route (app) /app/[param]/rsc-fetch"",
                ""next.span_type"": ""AppRender.getBodyResult"",
              },
              ""kind"": 0,
              ""name"": ""render route (app) /app/[param]/rsc-fetch"",
              ""parentId"": ""[parent-id]"",
              ""status"": Object {
                ""code"": 0,
              },
            },
            Object {
              ""attributes"": Object {
                ""http.method"": ""GET"",
                ""http.route"": ""/app/[param]/rsc-fetch"",
                ""http.status_code"": 200,
                ""http.target"": ""/app/param/rsc-fetch"",
                ""next.route"": ""/app/[param]/rsc-fetch"",
                ""next.span_name"": ""GET /app/[param]/rsc-fetch"",
                ""next.span_type"": ""BaseServer.handleRequest"",
              },
              ""kind"": 1,
              ""name"": ""GET /app/[param]/rsc-fetch"",
              ""parentId"": undefined,
              ""status"": Object {
                ""code"": 0,
              },
            },
            Object {
              ""attributes"": Object {
                ""next.page"": ""/app/[param]/layout"",
                ""next.span_name"": ""generateMetadata /app/[param]/layout"",
                ""next.span_type"": ""ResolveMetadata.generateMetadata"",
              },
              ""kind"": 0,
              ""name"": ""generateMetadata /app/[param]/layout"",
              ""parentId"": ""[parent-id]"",
              ""status"": Object {
                ""code"": 0,
              },
            },
            Object {
              ""attributes"": Object {
                ""next.page"": ""/app/[param]/rsc-fetch/page"",
                ""next.span_name"": ""generateMetadata /app/[param]/rsc-fetch/page"",
                ""next.span_type"": ""ResolveMetadata.generateMetadata"",
              },
              ""kind"": 0,
              ""name"": ""generateMetadata /app/[param]/rsc-fetch/page"",
              ""parentId"": ""[parent-id]"",
              ""status"": Object {
                ""code"": 0,
              },
            },
          ]
        `",0.0,0,0,0
16325,16325,"`
          Array [
            Object {
              ""attributes"": Object {
                ""next.route"": ""/api/app/[param]/data/route"",
                ""next.span_name"": ""executing api route (app) /api/app/[param]/data/route"",
                ""next.span_type"": ""AppRouteRouteHandlers.runHandler"",
              },
              ""kind"": 0,
              ""name"": ""executing api route (app) /api/app/[param]/data/route"",
              ""parentId"": ""[parent-id]"",
              ""status"": Object {
                ""code"": 0,
              },
            },
            Object {
              ""attributes"": Object {
                ""http.method"": ""GET"",
                ""http.status_code"": 200,
                ""http.target"": ""/api/app/param/data"",
                ""next.span_name"": ""GET /api/app/param/data"",
                ""next.span_type"": ""BaseServer.handleRequest"",
              },
              ""kind"": 1,
              ""name"": ""GET /api/app/param/data"",
              ""parentId"": undefined,
              ""status"": Object {
                ""code"": 0,
              },
            },
          ]
        `",0.0,0,0,0
16326,16326,"`
          Object {
            ""/api/page-route"": Object {
              ""maxDuration"": 1,
            },
            ""/app-route"": Object {
              ""maxDuration"": 1,
            },
            ""/app-route-edge"": Object {
              ""maxDuration"": 2,
            },
            ""/app-ssr"": Object {
              ""maxDuration"": 3,
            },
            ""/app-ssr-edge"": Object {
              ""maxDuration"": 4,
            },
            ""/page"": Object {
              ""maxDuration"": 2,
            },
            ""/page-ssr"": Object {
              ""maxDuration"": 3,
            },
          }
        `",0.0,0,0,0
16327,16327,"`
          export async function getStaticPaths() {
            return {
              paths: []
            }
          }
          export async function getStaticProps() {
            return {
              props: {
                hello: 'world'
              }
            }
          }
          export default () => 'oops'
        `",0.0,0,0,0
16328,16328,"`
          export async function getStaticProps() {
            return {
              props: {
                hello: 'world'
              }
            }
          }
          export default () => 'oops'
        `",0.0,0,0,0
16329,16329,"`
          export const config = {
            runtime: 'edge',
          }

          export default () => new Response('edge response again')
          `",0.0,0,0,0
16330,16330,"`
          export const config = {
            runtime: 'edge',
          }

          export default () => new Response('edge response')
          `",0.0,0,0,0
16331,16331,"`
          export default () => (<p>hello world</p>);
          export const runtime = 'edge';
        `",0.0,0,0,0
16332,16332,"`
          export default () => (<p>hello world</p>);
          export const runtime = 'experimental-edge';
        `",0.0,0,0,0
16333,16333,"`
          export default function (req, res) {
            res.send('server response again')
          }
          `",0.0,0,0,0
16334,16334,"`
          export default function Page() {
            return <p>Hello from server page</p>
          }
          `",0.0,0,0,0
16335,16335,"`
          export default function Page() { 
            return <p>hello world</p>
          } 
        `",0.0,0,0,0
16336,16336,"`
          export function getServerSideProps() {}
          export function getStaticPaths() {}
        `",0.0,0,0,0
16337,16337,"`
          export function getServerSideProps() {}
          export function getStaticProps() {}
        `",0.0,0,0,0
16338,16338,"`
          export function getStaticPaths() {}
          export function getServerSideProps() {}
        `",0.0,0,0,0
16339,16339,"`
          export function getStaticProps() {}
          export function getServerSideProps() {}
        `",0.0,0,0,0
16340,16340,"`
          import React from ""react"";
          import queryGraphql from ""../graphql/schema"";

          const gql = String.raw;

          export default function Home({ greeting }) {
            return <h1>{greeting}</h1>;
          }

          export async function getStaticProps() {
            const greeting = await getGreeting();

            return {
              props: {
                greeting,
              },
            };
          }

          async function getGreeting() {
            const result = await queryGraphql(
              gql\`
                {
                  query {
                    greeting
                  }
                }
              \`
            );

            return result.data.greeting;
          }
        `",0.0,0,0,0
16341,16341,"`
          import { observable } from ""mobx""

          class Box {
            @observable.shallow x = 1
        }
        `",0.0,0,0,0
16342,16342,"`
          import { observable } from ""mobx""

          class ExtendsHasConstructor {
              @observable x = 1

              constructor() {
                  console.log(""hi"")
              }
          }`",0.0,0,0,0
16343,16343,"`
          import { observable } from ""mobx""

          class ExtendsHasConstructorSuper extends Box {
              @observable x = 1

              constructor() {
                  super()
                  console.log(""hi"")
              }
          }
        `",0.0,0,0,0
16344,16344,"`
          import { observable } from ""mobx""

          class ExtendsHasMethod extends Box {
              @observable x = 1

              // test
              method() {
                  console.log(""hi"")
              }
          }
        `",0.0,0,0,0
16345,16345,"`
        ""function _array_like_to_array(arr, len) {
            if (len == null || len > arr.length) len = arr.length;
            for(var i = 0, arr2 = new Array(len); i < len; i++)arr2[i] = arr[i];
            return arr2;
        }
        function _array_with_holes(arr) {
            if (Array.isArray(arr)) return arr;
        }
        function _iterable_to_array(iter) {
            if (typeof Symbol !== \\""undefined\\"" && iter[Symbol.iterator] != null || iter[\\""@@iterator\\""] != null) return Array.from(iter);
        }
        function _non_iterable_rest() {
            throw new TypeError(\\""Invalid attempt to destructure non-iterable instance.\\\\\\\\nIn order to be iterable, non-array objects must have a [Symbol.iterator]() method.\\"");
        }
        function _to_array(arr) {
            return _array_with_holes(arr) || _iterable_to_array(arr) || _unsupported_iterable_to_array(arr) || _non_iterable_rest();
        }
        function _unsupported_iterable_to_array(o, minLen) {
            if (!o) return;
            if (typeof o === \\""string\\"") return _array_like_to_array(o, minLen);
            var n = Object.prototype.toString.call(o).slice(8, -1);
            if (n === \\""Object\\"" && o.constructor) n = o.constructor.name;
            if (n === \\""Map\\"" || n === \\""Set\\"") return Array.from(n);
            if (n === \\""Arguments\\"" || /^(?:Ui|I)nt(?:8|16|32)(?:Clamped)?Array$/.test(n)) return _array_like_to_array(o, minLen);
        }
        import { useState } from \\""react\\"";
        var _useState = _to_array(useState(0)), copy = _useState.slice(0);
        ""
      `",0.0,0,0,0
16346,16346,"`
        ""function _array_like_to_array(arr, len) {
            if (len == null || len > arr.length) len = arr.length;
            for(var i = 0, arr2 = new Array(len); i < len; i++)arr2[i] = arr[i];
            return arr2;
        }
        function _array_with_holes(arr) {
            if (Array.isArray(arr)) return arr;
        }
        function _iterable_to_array_limit(arr, i) {
            var _i = arr == null ? null : typeof Symbol !== \\""undefined\\"" && arr[Symbol.iterator] || arr[\\""@@iterator\\""];
            if (_i == null) return;
            var _arr = [];
            var _n = true;
            var _d = false;
            var _s, _e;
            try {
                for(_i = _i.call(arr); !(_n = (_s = _i.next()).done); _n = true){
                    _arr.push(_s.value);
                    if (i && _arr.length === i) break;
                }
            } catch (err) {
                _d = true;
                _e = err;
            } finally{
                try {
                    if (!_n && _i[\\""return\\""] != null) _i[\\""return\\""]();
                } finally{
                    if (_d) throw _e;
                }
            }
            return _arr;
        }
        function _non_iterable_rest() {
            throw new TypeError(\\""Invalid attempt to destructure non-iterable instance.\\\\\\\\nIn order to be iterable, non-array objects must have a [Symbol.iterator]() method.\\"");
        }
        function _sliced_to_array(arr, i) {
            return _array_with_holes(arr) || _iterable_to_array_limit(arr, i) || _unsupported_iterable_to_array(arr, i) || _non_iterable_rest();
        }
        function _unsupported_iterable_to_array(o, minLen) {
            if (!o) return;
            if (typeof o === \\""string\\"") return _array_like_to_array(o, minLen);
            var n = Object.prototype.toString.call(o).slice(8, -1);
            if (n === \\""Object\\"" && o.constructor) n = o.constructor.name;
            if (n === \\""Map\\"" || n === \\""Set\\"") return Array.from(n);
            if (n === \\""Arguments\\"" || /^(?:Ui|I)nt(?:8|16|32)(?:Clamped)?Array$/.test(n)) return _array_like_to_array(o, minLen);
        }
        import { useState } from \\""react\\"";
        var _useState = _sliced_to_array(useState(0), 2), count = _useState[0], setCount = _useState[1];
        ""
      `",0.0,0,0,0
16347,16347,"`
        ""import { observable, action, makeObservable } from 'mobx';
        class TestStore
        {
            testValue = 1;
            testFunc = () =>
            {
                this.testValue++;
            }

            constructor() {
                makeObservable(this, {
                    testValue: observable,
                    testFunc: action
                });
            }
        }""
    `",0.0,0,0,0
16348,16348,"`
        ""import { observable, makeObservable } from 'mobx';

        type NamedTuple = [first: string, other: number, ...rest: Boolean[]]

        class X {
            x = 3;

            constructor() {
                makeObservable(this, {
                    x: observable
                });
            }
        }

        class Y {
            async fn() { await tes() }

            *generatorFn() {
                yield 3
            }

            doesJSX() {
                return <hi {...there}>Stuff {/*with comments */}</hi>
            }
        }""
    `",0.0,0,0,0
16349,16349,"`
        ""import {observer, inject} from 'mobx-react'
        
        class X extends React.Component {}
        export default inject(\\""test\\"")(observer(X));""
    `",0.0,0,0,0
16350,16350,"`
        ""import {observer, inject} from 'mobx-react'
        import {withRouter} from 'react-router-dom'

        class X extends React.Component {}
        
        export default withRouter(inject(\\""test\\"")(observer(X)))""
    `",0.0,0,0,0
16351,16351,"`
        ""import {observer, inject} from 'mobx-react'
        import {withRouter} from 'react-router-dom'
        /* 1 */
        export const X = withRouter(
          inject(\\""test\\"")(observer(class /* 2 */ /* 3 */ X extends React.Component {}))
        );""
    `",0.0,0,0,0
16352,16352,"`
        ""import {observer} from 'mobx-react'
        import {withRouter} from 'react-router-dom'
        /* 1 */
        export const X = withRouter(observer(class /* 2 */ /* 3 */ X extends React.Component {}));""
    `",0.0,0,0,0
16353,16353,"`
        Array [
          ""a"",
          ""b"",
          ""b"",
        ]
      `",0.0,0,0,0
16354,16354,"`
        Array [
          ""green"",
          ""yellow"",
          Object {
            ""red"": ""flashing"",
          },
          Object {
            ""red"": ""flashing"",
          },
          Object {
            ""red"": ""flashing"",
          },
          Object {
            ""red"": ""flashing"",
          },
          Object {
            ""red"": ""flashing"",
          },
          Object {
            ""red"": ""walk"",
          },
          Object {
            ""red"": ""wait"",
          },
          Object {
            ""red"": ""stop"",
          },
        ]
      `",0.0,0,0,0
16355,16355,"`
        Array [
          ""start"",
          ""start"",
          ""start"",
          ""finish"",
        ]
      `",0.0,0,0,0
16356,16356,"`
        Array [
          Object {
            ""a"": ""a1"",
            ""b"": ""b1"",
          },
          Object {
            ""a"": ""a2"",
            ""b"": ""b2"",
          },
          Object {
            ""a"": ""a3"",
            ""b"": ""b3"",
          },
          Object {
            ""a"": ""a3"",
            ""b"": ""b3"",
          },
        ]
      `",0.0,0,0,0
16357,16357,"`
        [
          document.querySelector('#react').innerText,
          document.querySelector('#react-dom').innerText,
          document.querySelector('#react-dom-server').innerText,
          document.querySelector('#client-react').innerText,
          document.querySelector('#client-react-dom').innerText,
          document.querySelector('#client-react-dom-server').innerText,
        ]
      `",0.0,0,0,0
16358,16358,"`
        const React = require('react');
        module.exports = () => <div>test2</div>;
      `",0.0,0,0,0
16359,16359,"`
        const a = () => <React.Fragment><a href=""/"">home</a></React.Fragment>;
      `",0.0,0,0,0
16360,16360,"`
        const file = new File(['hello'], 'hello.txt', { type: 'text/plain' });
        const list = new DataTransfer();
        list.items.add(file);
        document.getElementById('file').files = list.files;
      `",0.0,0,0,0
16361,16361,"`
        const getStaticPaths = () => {
          return []
        }

        export { getStaticPaths }

        export default function Test() {
          return <div />
        }
      `",0.0,0,0,0
16362,16362,"`
        const getStaticPaths = () => {
          return []
        }, a = 2

        export { getStaticPaths }

        export default function Test() {
          return <div />
        }
      `",0.0,0,0,0
16363,16363,"`
        export async function getServerSideProps() {
          return {
            props: {
              url: 'something'
            }
          }
        }

        export default ({ url }) => <p>url: {url}</p>
      `",0.0,0,0,0
16364,16364,"`
        export async function getStaticPaths() {
          return []
        }

        export async function getStaticProps() {
          return { props: {} }
        }

        export default function Test() {
          return <div />
        }
      `",0.0,0,0,0
16365,16365,"`
        export async function getStaticProps() {
          return {
            props: {
              url: 'something'
            }
          }
        }

        export default ({ url }) => <p>url: {url}</p>
      `",0.0,0,0,0
16366,16366,"`
        export const getStaticPaths = () => {
          return []
        }

        export const getStaticProps = function() {
          return { props: {} }
        }

        export default function Test() {
          return <div />
        }
      `",0.0,0,0,0
16367,16367,"`
        export const getStaticPaths = () => {
          return []
        }, foo = 2

        export const getStaticProps = function() {
          return { props: {} }
        }

        export default function Test() {
          return <div />
        }
      `",0.0,0,0,0
16368,16368,"`
        export const getStaticPaths = async () => {
          return []
        }

        export const getStaticProps = async function() {
          return { props: {} }
        }

        export default function Test() {
          return <div />
        }
      `",0.0,0,0,0
16369,16369,"`
        export function getStaticPaths() {
          return []
        }

        export function getStaticProps() {
          return { props: {} }
        }

        export default function Test() {
          return <div />
        }
      `",0.0,0,0,0
16370,16370,"`
        export function getStaticProps() {
          return { props: {} }
        }

        class El extends React.Component {
          render() {
            return <div />
          }
        }

        const a = 5

        export { El as default, a }
      `",0.0,0,0,0
16371,16371,"`
        export function getStaticProps() {
          return { props: {} }
        }

        class Test extends React.Component {
          render() {
            return <div />
          }
        }

        export default Test;
      `",0.0,0,0,0
16372,16372,"`
        export function getStaticProps() {
          return { props: {} }
        }

        export default class Test extends React.Component {
          render() {
            return <div />
          }
        }
      `",0.0,0,0,0
16373,16373,"`
        export function getStaticProps() {
          return { props: {} }
        }

        export function Noop() {}

        export default function Test() {
          return <div />
        }
      `",0.0,0,0,0
16374,16374,"`
        export function getStaticProps() {
          return { props: {} }
        }

        function El() {
          return <div />
        }

        const a = 5

        export { El as default, a }
      `",0.0,0,0,0
16375,16375,"`
        export function getStaticProps() {
          return { props: {} }
        }

        function El() {
          return <div />
        }

        export { El as default }
      `",0.0,0,0,0
16376,16376,"`
        export { getStaticPaths } from '.'
        export { a as getStaticProps } from '.'

        export default function Test() {
          return <div />
        }
      `",0.0,0,0,0
16377,16377,"`
        export { getStaticPaths, a as getStaticProps } from '.'

        export default function Test() {
          return <div />
        }
      `",0.0,0,0,0
16378,16378,"`
        export { getStaticPaths, a as getStaticProps, foo, bar as baz } from '.'

        export default function Test() {
          return <div />
        }
      `",0.0,0,0,0
16379,16379,"`
        export { getStaticProps, default } from 'a'
      `",0.0,0,0,0
16380,16380,"`
        function Function1() {
          return {
            a: function bug(a) {
              return 2;
            }
          };
        }

        function Function2() {
          var bug = 1;
          return { bug };
        }

        export { getStaticProps } from 'a'
      `",0.0,0,0,0
16381,16381,"`
        function fn() {
          fn = function () {};
          return fn.apply(this, arguments);
        }
        export function getStaticProps() {
          fn;
        }
        export default function Home() { return <div />; }
      `",0.0,0,0,0
16382,16382,"`
        function getStaticPaths() {
          return []
        }

        export { getStaticPaths }

        export class MyClass {}

        export default function Test() {
          return <div />
        }
      `",0.0,0,0,0
16383,16383,"`
        function getStaticPaths() {
          return []
        }

        export { getStaticPaths }

        export default function Test() {
          return <div />
        }
      `",0.0,0,0,0
16384,16384,"`
        import dynamic from 'next/dynamic'
        
        const Comp = dynamic(() => import('comp'))
        
        export default function Page(props) {
          return <Comp />
        }
      `",0.0,0,0,0
16385,16385,"`
        import fs from 'fs';
        import other from 'other';

        const [a, b, ...rest]= fs.promises;
        const [foo, bar] = other;

        export async function getStaticProps() {
          a;
          b;
          rest;
          bar;
        }
        export default function Home() { return <div />; }
      `",0.0,0,0,0
16386,16386,"`
        import fs from 'fs';
        import other from 'other';

        const {readFile, readdir, access: foo} = fs.promises;
        const {a,b, cat: bar,...rem} = other;

        export async function getStaticProps() {
          readFile;
          readdir;
          foo;
          b;
          cat;
          rem;
        }
        export default function Home() { return <div />; }
      `",0.0,0,0,0
16387,16387,"`
        import type { IReactionDisposer } from 'mobx';
        import { reaction, observable } from 'mobx';

        export default class Store {
            @observable counter = 0;

            removeReaction: IReactionDisposer;

            constructor() {
                this.removeReaction = reaction(() => this.counter, () => {
                    console.log('it changed');
                });
            }

            cleanup() {
                this.removeReaction();
            }
        }
        `",0.0,0,0,0
16388,16388,"`
        import { Html, Head, Main, NextScript } from 'next/document'

        export default function Document() {
          return (
            <Html>
              <Head />
              <body>
                <Main />
                <NextScript />
              </body>
            </Html>
          )
        }
      `",0.0,0,0,0
16389,16389,"`
        import { ImageResponse } from 'next/server'
        export async function generateImageMetadata() {
          return [
            {
              contentType: 'image/png',
              size: { width: 48, height: 48 },
              // id: 100,
            },
            {
              contentType: 'image/png',
              size: { width: 48, height: 48 },
              id: 101,
            },
          ]
        }

        export default function icon() {
          return new ImageResponse(<div>icon</div>)
        }
        `",0.0,0,0,0
16390,16390,"`
        import { MetadataRoute } from 'next'

        export async function generateSitemaps() {
          return [
            { },
          ]
        }

        export default function sitemap({ id }): MetadataRoute.Sitemap {
          return [
            {
              url: 'https://example.com/',
              lastModified: '2021-01-01',
            },
          ]
        }`",0.0,0,0,0
16391,16391,"`
        import { decorate, observable, action } from 'mobx';
        class TestStore
        {
            testValue = 1;
            testFunc = () =>
            {
                this.testValue++;
            }
        }
        decorate(TestStore, {
            testValue: observable,
            testFunc: action
        });
        `",0.0,0,0,0
16392,16392,"`
        import { observable } from 'mobx';

        type NamedTuple = [first: string, other: number, ...rest: Boolean[]]

        class X {
            @observable x = 3;
        }

        class Y {
            async fn() { await tes() }

            *generatorFn() {
                yield 3
            }

            doesJSX() {
                return <hi {...there}>Stuff {/*with comments */}</hi>
            }
        }
        `",0.0,0,0,0
16393,16393,"`
        import { useState } from 'react';
        const [, setCount] = useState(0);
      `",0.0,0,0,0
16394,16394,"`
        import { useState } from 'react';
        const [...copy] = useState(0);
      `",0.0,0,0,0
16395,16395,"`
        import { useState } from 'react';
        const [count, setCount] = useState(0);
      `",0.0,0,0,0
16396,16396,"`
        import {observer, inject} from 'mobx-react'


        /* 1 */
        @inject(""test"") /* 2 */ export /* 3 */ class X extends React.Component {

        }

        `",0.0,0,0,0
16397,16397,"`
        import {observer, inject} from 'mobx-react'


        /* 1 */
        @inject(""test"") @observer /* 2 */ export /* 3 */ class X extends React.Component {

        }

        `",0.0,0,0,0
16398,16398,"`
        import {observer, inject} from 'mobx-react'
        
        @inject(""test"") @observer export default class X extends React.Component {}
    `",0.0,0,0,0
16399,16399,"`
        import {observer, inject} from 'mobx-react'
        import {observable} from ""mobx""
        import {Component} from ""react""

        @observer class X extends React.Component {
            @observable field =  1
        }

        `",0.0,0,0,0
16400,16400,"`
        import {observer, inject} from 'mobx-react'
        import {observable} from ""mobx""
        import {PureComponent} from ""react""

        @observer class X extends PureComponent<{x: boolean}> {
            @observable field =  1
        }

        `",0.0,0,0,0
16401,16401,"`
        import {observer, inject} from 'mobx-react'
        import {withRouter} from 'react-router-dom'

        @inject(""test"") @observer class X extends React.Component {}

        export default withRouter(X)

    `",0.0,0,0,0
16402,16402,"`
        import {observer} from 'mobx-react'

        /* 1 */
        @observer /* 2 */ class X extends React.Component {
            render() {
                return <div>hi</div>
            }
        }

        `",0.0,0,0,0
16403,16403,"`
        import {observer} from 'mobx-react-lite'


        /* 1 */
        @observer /* 2 */ export /* 3 */ class X extends React.Component {

        }

        `",0.0,0,0,0
16404,16404,"`
        import {observer} from 'mobx-react-lite'


        /* 1 */
        export /* 2 */ @observer /* 3 */ class X extends React.Component {

        }

        `",0.0,0,0,0
16405,16405,"`
        var _useState=useState(0),count=_useState[0],setCount=_useState[1];
      `",0.0,0,0,0
16406,16406,"`
        var _useState=useState(0),setCount=_useState[1];
      `",0.0,0,0,0
16407,16407,"`
        window.React.startTransition(() => {
          window.router.push('/10/10000/100/1000/page2')
          window.router.refresh()
        })
      `",0.0,0,0,0
16408,16408,"`
      ""Error serializing \`.arr[2]\` returned from \`test\` in \\""/\\"".
      Reason: Circular references cannot be expressed in JSON (references: \`.arr\`).""
    `",0.0,0,0,0
16409,16409,"`
      ""Error serializing \`.k.a[0]\` returned from \`test\` in \\""/\\"".
      Reason: \`function\` cannot be serialized as JSON. Please only return JSON serializable data types.""
    `",0.0,0,0,0
16410,16410,"`
      ""Error serializing \`.k.a[1].n\` returned from \`test\` in \\""/\\"".
      Reason: \`function\` cannot be serialized as JSON. Please only return JSON serializable data types.""
    `",0.0,0,0,0
16411,16411,"`
      ""Error serializing \`.k.a[1].n\` returned from \`test\` in \\""/\\"".
      Reason: \`object\` (\\""[object Date]\\"") cannot be serialized as JSON. Please only return JSON serializable data types.""
    `",0.0,0,0,0
16412,16412,"`
      ""Error serializing \`.k.a[1]\` returned from \`test\` in \\""/\\"".
      Reason: \`undefined\` cannot be serialized as JSON. Please use \`null\` or omit this value.""
    `",0.0,0,0,0
16413,16413,"`
      ""Error serializing \`.k.n\` returned from \`test\` in \\""/\\"".
      Reason: \`symbol\` cannot be serialized as JSON. Please only return JSON serializable data types.""
    `",0.0,0,0,0
16414,16414,"`
      ""Error serializing \`.k[0].arr[2]\` returned from \`test\` in \\""/\\"".
      Reason: Circular references cannot be expressed in JSON (references: \`.k[0].arr\`).""
    `",0.0,0,0,0
16415,16415,"`
      ""Error serializing \`.k[3][1].nested[2]\` returned from \`test\` in \\""/\\"".
      Reason: Circular references cannot be expressed in JSON (references: \`.k\`).""
    `",0.0,0,0,0
16416,16416,"`
      ""Error serializing \`.k[3][1][2]\` returned from \`test\` in \\""/\\"".
      Reason: Circular references cannot be expressed in JSON (references: \`.k\`).""
    `",0.0,0,0,0
16417,16417,"`
      ""Error serializing \`.toplevel\` returned from \`test\` in \\""/\\"".
      Reason: \`object\` (\\""[object Date]\\"") cannot be serialized as JSON. Please only return JSON serializable data types.""
    `",0.0,0,0,0
16418,16418,"`
      ""Error serializing \`.toplevel\` returned from \`test\` in \\""/\\"".
      Reason: \`symbol\` cannot be serialized as JSON. Please only return JSON serializable data types.""
    `",0.0,0,0,0
16419,16419,"`
      ""Error serializing \`.toplevel\` returned from \`test\` in \\""/\\"".
      Reason: \`undefined\` cannot be serialized as JSON. Please use \`null\` or omit this value.""
    `",0.0,0,0,0
16420,16420,"`
      ""Error serializing props returned from \`test\` in \\""/\\"".
      Reason: Props must be returned as a plain object from test: \`{ props: { ... } }\` (received: \`[object Array]\`).""
    `",0.0,0,0,0
16421,16421,"`
      ""Error serializing props returned from \`test\` in \\""/\\"".
      Reason: Props must be returned as a plain object from test: \`{ props: { ... } }\` (received: \`[object Null]\`).""
    `",0.0,0,0,0
16422,16422,"`
      ""Error serializing props returned from \`test\` in \\""/\\"".
      Reason: Props must be returned as a plain object from test: \`{ props: { ... } }\` (received: \`[object Undefined]\`).""
    `",0.0,0,0,0
16423,16423,"`
      .foo\\,2 {
        background: blue;
      }
    `",0.0,0,0,0
16424,16424,"`
      Array [
        ""/"",
        ""/apples/[ab]/[cd]/ef"",
        ""/blog/abc"",
        ""/blog/abc/post"",
        ""/blog/abc/[id]"",
        ""/blog/[id]"",
        ""/blog/[id]/comments/[cid]"",
        ""/foo/[d]/bar/baz/[f]"",
        ""/p/[...rest]"",
        ""/p1/[[...incl]]"",
        ""/p2/[id]"",
        ""/p2/[id]/abc"",
        ""/p2/[...rest]"",
        ""/p3/[id]"",
        ""/p3/[id]/abc"",
        ""/p3/[[...rest]]"",
        ""/posts"",
        ""/posts/[id]"",
        ""/[root-slug]"",
        ""/[...rest]"",
      ]
    `",0.0,0,0,0
16425,16425,"`
      Array [
        ""Given Mario is standing, when left, then walking"",
        ""Given Mario is standing, when right, then walking"",
        ""Given Mario is standing, when down, then crouching"",
        ""Given Mario is standing, when up, then jumping"",
        ""Given Mario is walking, when up, then jumping"",
        ""Given Mario is walking, when stop, then standing"",
        ""Given Mario is walking, when up, then jumping"",
        ""Given Mario is walking, when stop, then standing"",
        ""Given Mario is crouching, when release_down, then standing"",
        ""Given Mario is jumping, when land, then standing"",
        ""Given Mario is jumping, when land, then standing"",
        ""Given Mario is standing, when left, then walking"",
        ""Given Mario is standing, when right, then walking"",
        ""Given Mario is standing, when down, then crouching"",
        ""Given Mario is standing, when up, then jumping"",
        ""Given Mario is standing, when left, then walking"",
        ""Given Mario is standing, when right, then walking"",
        ""Given Mario is standing, when down, then crouching"",
        ""Given Mario is standing, when up, then jumping"",
        ""Given Mario is standing, when left, then walking"",
        ""Given Mario is standing, when right, then walking"",
        ""Given Mario is standing, when down, then crouching"",
        ""Given Mario is standing, when up, then jumping"",
      ]
    `",0.0,0,0,0
16426,16426,"`
      Array [
        ""NEXT"",
        ""TO_C"",
      ]
    `",0.0,0,0,0
16427,16427,"`
      Array [
        ""Reaches state \\""a\\"": NEXT → PREV"",
        ""Reaches state \\""a\\"": NEXT → RESTART"",
        ""Reaches state \\""b\\"": END"",
      ]
    `",0.0,0,0,0
16428,16428,"`
      Array [
        ""Reaches state \\""b\\"": NEXT ({\\""value\\"":0}) → NEXT ({\\""value\\"":0})"",
        ""Reaches state \\""b\\"": NEXT ({\\""value\\"":100})"",
        ""Reaches state \\""b\\"": NEXT ({\\""value\\"":1000})"",
      ]
    `",0.0,0,0,0
16429,16429,"`
      Array [
        ""TO_B"",
        ""NEXT_B_TO_X"",
        ""NEXT_X_TO_Y"",
      ]
    `",0.0,0,0,0
16430,16430,"`
      Array [
        ""a"",
        ""b"",
        ""b.b1"",
      ]
    `",0.0,0,0,0
16431,16431,"`
      Array [
        ""a"",
        Object {
          ""b"": ""b1"",
        },
        Object {
          ""b"": ""b1"",
        },
        Object {
          ""b"": ""b2"",
        },
        Object {
          ""b"": ""b2"",
        },
      ]
    `",0.0,0,0,0
16432,16432,"`
      Array [
        Object {
          ""actions"": Array [],
          ""cond"": undefined,
          ""event"": ""done.invoke.(machine).active:invocation[0]"",
          ""eventType"": ""done.invoke.(machine).active:invocation[0]"",
          ""internal"": false,
          ""source"": ""#(machine).active"",
          ""target"": Array [
            ""#(machine).foo"",
          ],
          ""toJSON"": [Function],
        },
        Object {
          ""actions"": Array [],
          ""cond"": undefined,
          ""event"": ""error.platform.(machine).active:invocation[0]"",
          ""eventType"": ""error.platform.(machine).active:invocation[0]"",
          ""internal"": false,
          ""source"": ""#(machine).active"",
          ""target"": Array [
            ""#(machine).bar"",
          ],
          ""toJSON"": [Function],
        },
        Object {
          ""actions"": Array [],
          ""cond"": undefined,
          ""event"": ""EVENT"",
          ""eventType"": ""EVENT"",
          ""internal"": false,
          ""source"": ""#(machine).active"",
          ""target"": Array [
            ""#(machine).foo"",
          ],
          ""toJSON"": [Function],
        },
      ]
    `",0.0,0,0,0
16433,16433,"`
      Array [
        Object {
          ""count"": 0,
        },
        Object {
          ""count"": 1,
        },
        Object {
          ""count"": 2,
        },
        Object {
          ""count"": 3,
        },
        Object {
          ""count"": 4,
        },
      ]
    `",0.0,0,0,0
16434,16434,"`
      Array [
        Object {
          ""description"": ""Going from inactive to active"",
        },
      ]
    `",0.0,0,0,0
16435,16435,"`
      Array [
        Object {
          ""event"": ""{\\""name\\"":\\""EV\\"",\\""data\\"":{\\""type\\"":\\""EV\\"",\\""value\\"":{\\""unsafe\\"":\\""[unsafe]\\""}},\\""$$type\\"":\\""scxml\\"",\\""type\\"":\\""external\\""}"",
          ""sessionId"": ""x:9"",
          ""type"": ""service.event"",
        },
        Object {
          ""sessionId"": ""x:9"",
          ""state"": ""{\\""actions\\"":[],\\""activities\\"":{},\\""meta\\"":{},\\""events\\"":[],\\""value\\"":{},\\""context\\"":{\\""value\\"":{\\""unsafe\\"":\\""[unsafe]\\""}},\\""_event\\"":{\\""name\\"":\\""EV\\"",\\""data\\"":{\\""type\\"":\\""EV\\"",\\""value\\"":{\\""unsafe\\"":\\""[unsafe]\\""}},\\""$$type\\"":\\""scxml\\"",\\""type\\"":\\""external\\""},\\""_sessionid\\"":\\""x:9\\"",\\""event\\"":{\\""type\\"":\\""EV\\"",\\""value\\"":{\\""unsafe\\"":\\""[unsafe]\\""}},\\""transitions\\"":[{\\""actions\\"":[{\\""type\\"":\\""xstate.assign\\"",\\""assignment\\"":{}}],\\""event\\"":\\""EV\\"",\\""source\\"":\\""#(machine)\\"",\\""internal\\"":true,\\""eventType\\"":\\""EV\\""}],\\""children\\"":{},\\""done\\"":false,\\""tags\\"":{},\\""changed\\"":true}"",
          ""type"": ""service.state"",
        },
      ]
    `",0.0,0,0,0
16436,16436,"`
      Array [
        Object {
          ""event"": ""{\\""name\\"":\\""UNKNOWN\\"",\\""data\\"":{\\""type\\"":\\""UNKNOWN\\""},\\""$$type\\"":\\""scxml\\"",\\""type\\"":\\""external\\""}"",
          ""sessionId"": ""x:9"",
          ""type"": ""service.event"",
        },
        Object {
          ""sessionId"": ""x:9"",
          ""state"": ""{\\""actions\\"":[],\\""activities\\"":{},\\""meta\\"":{},\\""events\\"":[],\\""value\\"":{},\\""context\\"":{\\""value\\"":{\\""unsafe\\"":\\""[unsafe]\\""}},\\""_event\\"":{\\""name\\"":\\""UNKNOWN\\"",\\""data\\"":{\\""type\\"":\\""UNKNOWN\\""},\\""$$type\\"":\\""scxml\\"",\\""type\\"":\\""external\\""},\\""_sessionid\\"":\\""x:9\\"",\\""event\\"":{\\""type\\"":\\""UNKNOWN\\""},\\""transitions\\"":[],\\""children\\"":{},\\""done\\"":false,\\""tags\\"":{},\\""changed\\"":false}"",
          ""type"": ""service.state"",
        },
      ]
    `",0.0,0,0,0
16437,16437,"`
      Array [
        Object {
          ""type"": ""EVENT"",
          ""value"": 1,
        },
        Object {
          ""type"": ""EVENT"",
          ""value"": 2,
        },
        Object {
          ""type"": ""EVENT"",
          ""value"": 3,
        },
      ]
    `",0.0,0,0,0
16438,16438,"`
      Object {
        ""count"": 3,
        ""transitions"": Object {
          """": Object {
            ""{\\""type\\"":\\""xstate.init\\""}"": Object {
              ""count"": 1,
              ""currentWeight"": 1,
              ""relativeWeight"": 1,
              ""state"": ""{\\""value\\"":\\""green\\""}"",
              ""weight"": 0.3333333333333333,
            },
          },
          ""{\\""value\\"":\\""green\\""}"": Object {
            ""{\\""type\\"":\\""TIMER\\""}"": Object {
              ""count"": 1,
              ""currentWeight"": 1,
              ""relativeWeight"": 1,
              ""state"": ""{\\""value\\"":\\""yellow\\""}"",
              ""weight"": 0.3333333333333333,
            },
          },
          ""{\\""value\\"":\\""yellow\\""}"": Object {
            ""{\\""type\\"":\\""TIMER\\""}"": Object {
              ""count"": 1,
              ""currentWeight"": 1,
              ""relativeWeight"": 1,
              ""state"": ""{\\""value\\"":{\\""red\\"":\\""walk\\""}}"",
              ""weight"": 0.3333333333333333,
            },
          },
        },
      }
    `",0.0,0,0,0
16439,16439,"`
      Object {
        ""expr"": ""some string"",
        ""label"": ""string label"",
        ""type"": ""xstate.log"",
        ""value"": ""some string"",
      }
    `",0.0,0,0,0
16440,16440,"`
      Object {
        ""expr"": [Function],
        ""label"": ""expr label"",
        ""type"": ""xstate.log"",
        ""value"": ""expr 42"",
      }
    `",0.0,0,0,0
16441,16441,"`
      export const config = { amp: 'hybrid' }

      function About(props) {
        return <h3>My AMP About Page!</h3>
      }
      
      export default About`",0.0,0,0,0
16442,16442,"`
      export const config = { amp: true }

      function About(props) {
        return <h3>My AMP About Page!</h3>
      }
      
      export default About`",0.0,0,0,0
16443,16443,"`
      export default function Page() {
        return <p>Hello from edge page again</p>
      }

      export const config = {
        runtime: 'experimental-edge',
      }
      `",0.0,0,0,0
16444,16444,"`
      import { computed } from ""mobx""

      class Box {
          @computed get x() {
              return 1;
          }
          set x(v) {
              console.log(v)
          }
      }
    `",0.0,0,0,0
16445,16445,"`
      import { computed } from ""mobx""

      class Box {
          @computed get x() {
              return 1;
          }
      }
    `",0.0,0,0,0
16446,16446,"`
      import { computed } from ""mobx""

      class Box {
          @computed({ name: ""test"" }) get x() {
              return 1;
          }
          set y(z) {
              console.log(""wrong"");
          }
          set x(v) {
              console.log(v)
          }
      }
    `",0.0,0,0,0
16447,16447,"`
      import { computed } from ""mobx""

      class Box {
          @computed.struct get x() {
              return 1;
          }
          set x(v) {
              console.log(v)
          }
      }
    `",0.0,0,0,0
16448,16448,"`
      import { observable } from ""mobx""

      class Box {
          @observable x = 1
      }
    `",0.0,0,0,0
16449,16449,"`
      module.exports = {
        experimental: {
          serverActions: true,
          serverActionsBodySizeLimit: '-3000mb',
        },
      }
      `",0.0,0,0,0
16450,16450,"`
      module.exports = {
        experimental: {
          serverActions: true,
          serverActionsBodySizeLimit: '1.5mb',
        },
      }
      `",0.0,0,0,0
16451,16451,"`
      module.exports = {
        experimental: {
          serverActions: true,
          serverActionsBodySizeLimit: 'testmb',
        },
      }
      `",0.0,0,0,0
16452,16452,"`
      module.exports = {
        experimental: {
          serverActions: true,
          serverActionsBodySizeLimit: -3000,
        },
      }
      `",0.0,0,0,0
16453,16453,"`
      module.exports = {
        experimental: {},
      }
      `",0.0,0,0,0
16454,16454,"`
      module.exports = {
        output: 'export',
        experimental: {
          serverActions: true,
        },
      }
      `",0.0,0,0,0
16455,16455,"`
      p {
        /* test */
        color: yellow;
      }
      .empty {
      }
    `",0.0,0,0,0
16456,16456,"`
      p {
        /* test */
        color: yellow;
      }
    `",0.0,0,0,0
16457,16457,"`
      p {
        /*! heading */
        color: yellow;
      }
    `",0.0,0,0,0
16458,16458,"`
      p {
        border: 1px solid var(--test);
        border-radius: var(--test);
        border-width: 0;
      }
    `",0.0,0,0,0
16459,16459,"`
      p {
        color: yellow;
      }
    `",0.0,0,0,0
16460,16460,"`
    import {observer, inject} from 'mobx-react'
    import {withRouter} from 'react-router-dom'
    /* 1 */
    @withRouter @inject(""test"") @observer /* 2 */ export /* 3 */ class X extends React.Component {}
    `",0.0,0,0,0
16461,16461,"`
    import {observer} from 'mobx-react'
    import {withRouter} from 'react-router-dom'
    /* 1 */
    @withRouter @observer /* 2 */ export /* 3 */ class X extends React.Component {}
    `",0.0,0,0,0
16462,16462,"`
    this is preformatted
    so is this
`",0.0,0,0,0
16463,16463,"`
  class Box {
      /*0*/
      @observable
      /*1*/
      field /*2 */ = /*3*/ 1 /*4*/
  }`",0.0,0,0,0
16464,16464,"`
""Event \\""SOME_EVENT\\"" was sent to uninitialized service \\""light\\"". Make sure .start() is called for this service, or set { deferEvents: true } in the service options.
Event: {\\""type\\"":\\""SOME_EVENT\\""}""
`",0.0,0,0,0
16465,16465,"`
# Header

Text with *some* **formatting** and a [link](/foo).

<div>And some HTML.</div>

![Image](/bar.png)

This code example should be rendered as a playground:

	<h1>Hello Markdown!</h1>

Text with some \`code\` (playground too).

\`\`\`
<h2>Hello Markdown!</h2>
\`\`\`

And some language and modifier (playground again):

\`\`\`jsx noeditor
<h3>Hello Markdown!</h3>
\`\`\`

This should be just highlighted:

\`\`\`jsx static
<h4>Hello Markdown!</h4>
\`\`\`

This should be highlighted too:

\`\`\`html
<h5>Hello Markdown!</h5>
\`\`\`
`",0.0,0,0,0
16466,16466,"`
# header

	const _ = require('lodash');
	<div/>

text

\`\`\`
<span/>
\`\`\`
`",0.0,0,0,0
16467,16467,"`
# one
## two
### three
#### four
##### five
###### six
`",0.0,0,0,0
16468,16468,"`
* [ ] to do 1
* [ ] to do 2
* [x] to do 3
`",0.0,0,0,0
16469,16469,"`
* list
* item
* three
`",0.0,0,0,0
16470,16470,"`
* list 1
* list 2
  1. Sub-list
  1. Sub-list
  1. Sub-list
* list 3
`",0.0,0,0,0
16471,16471,"`
1. list
1. item
1. three
`",0.0,0,0,0
16472,16472,"`
<div>
	<__COMPONENT__>
		<span>text</span>
		<span>Name of component: __COMPONENT__</span>
	</__COMPONENT__>
	<__COMPONENT__ />
</div>
`",0.0,0,0,0
16473,16473,"`
<p>Hello React</p>
`",0.0,0,0,0
16474,16474,"`
> This is a blockquote.
> And this is a second line.
`",0.0,0,0,0
16475,16475,"`
Component is described here.


`",0.0,0,0,0
16476,16476,"`
Component is described here.

@example ./extra.examples.md
@foo bar
`",0.0,0,0,0
16477,16477,"`
Foo:

	<h1>Hello Markdown!</h1>
`",0.0,0,0,0
16478,16478,"`
Pass props to CodeRenderer

\`\`\`js { ""showCode"": true }
<h1>Hello Markdown!</h1>
\`\`\`

\`\`\`js { ""frame"": {""width"": ""400px""} }
<h1>Example in frame and Without editor</h1>
\`\`\`
	
Pass props to PreviewRenderer

\`\`\`jsx { ""noEditor"": true }
<h2>Hello Markdown!</h2>
\`\`\`

\`\`\`jsx static
<h2>This is Highlighted!</h2>
\`\`\`
`",0.0,0,0,0
16479,16479,"`
The only \`true\` button.

\`\`\`
<p>Hello React</p>
\`\`\`
`",0.0,0,0,0
16480,16480,"`
The only true button.

    alert('Hello world');
`",0.0,0,0,0
16481,16481,"`
The only true button.

@example ../../../test/components/Placeholder/examples.md
`",0.0,0,0,0
16482,16482,"`
The only true button.

@example example.md
`",0.0,0,0,0
16483,16483,"`
The only true button.

@foo Foo
@bar Bar
`",0.0,0,0,0
16484,16484,"`
The only true button.

\`\`\`
alert('Hello world');
\`\`\`
`",0.0,0,0,0
16485,16485,"`
The only true button.

\`\`\`html
<p>Hello React</p>
\`\`\`
`",0.0,0,0,0
16486,16486,"`
\`\`\`html
<foo></foo>
\`\`\`
`",0.0,0,0,0
16487,16487,"`
\`\`\`jsx static
<h1>Hello world!</h2>
\`\`\`
`",0.0,0,0,0
16488,16488,"`
\`\`\`jsx {""file"": ""./src/button/example.jsx""}
\`\`\`
`",0.0,0,0,0
16489,16489,"`
a paragraph

another paragraph
		`",0.0,0,0,0
16490,16490,"`
initialState = {count:1};
<span>{state.count}</span>
	`",0.0,0,0,0
16491,16491,"`
initialState = {count:1};
setTimeout(() => state.count === 1 && setState({count:2}));
<button>{state.count}</button>
	`",0.0,0,0,0
16492,16492,"`
this text is **strong**

and this is _emphasized_
		`",0.0,0,0,0
16493,16493,"`
| heading 1 | heading 2 |
| --------- | --------- |
| foo		| bar		|
| more foo	| more bar	|
`",0.0,0,0,0
16494,16494,`    padding-right: ${,0.0,0,0,0
16495,16495,`   script-src   'nonce-${,0.0,0,0,0
16496,16496,"`  <a href=""${",0.0,0,0,0
16497,16497,` via ${,0.0,0,0,0
16498,16498,`!!window.next.router.isReady`,0.0,0,0,0
16499,16499,"`""""`",0.0,0,0,0
16500,16500,"`"".foo\\\\,2{background:blue}""`",0.0,0,0,0
16501,16501,"`""1, 2, 3, 4, and 5""`",0.0,0,0,0
16502,16502,"`""1, 2, 3, and 4""`",0.0,0,0,0
16503,16503,"`""<a href=\\""/my-path\\"">to another page</a>""`",0.0,0,0,0
16504,16504,"`""Attempted to forward event to undefined actor. This risks an infinite loop in the sender.""`",0.0,0,0,0
16505,16505,"`""Catch-all must be the last part of the URL.""`",0.0,0,0,0
16506,16506,"`""Error: Dynamic href \`/object/[slug]\` found in <Link> while using the \`/app\` router, this is not supported. Read more: https://nextjs.org/docs/messages/app-dir-dynamic-href""`",0.0,0,0,0
16507,16507,"`""Initial state 'create' not found on 'fetchMachine'""`",0.0,0,0,0
16508,16508,"`""Segment names may not start or end with extra brackets ('[...id]').""`",0.0,0,0,0
16509,16509,"`""Segment names may not start with erroneous periods ('..id').""`",0.0,0,0,0
16510,16510,"`""Segment names may not start with erroneous periods ('.id').""`",0.0,0,0,0
16511,16511,"`""Test""`",0.0,0,0,0
16512,16512,"`""Traversal limit exceeded""`",0.0,0,0,0
16513,16513,"`""You cannot use both an optional and required catch-all route at the same level (\\""[[...one]]\\"" and \\""[...one]\\"").""`",0.0,0,0,0
16514,16514,"`""You cannot use both an required and optional catch-all route at the same level (\\""[...one]\\"" and \\""[[...one]]\\"" ).""`",0.0,0,0,0
16515,16515,"`""[MobX] 'makeAutoObservable' can only be used for classes that don't have a superclass""`",0.0,0,0,0
16516,16516,"`""[MobX] makeAutoObservable can only be used on objects not already made observable""`",0.0,0,0,0
16517,16517,"`""[\\""different-segment\\""]""`",0.0,0,0,0
16518,16518,"`""[\\""different-value\\"",\\""value3/value4\\""]""`",0.0,0,0,0
16519,16519,"`""[\\""different/random/paths\\""]""`",0.0,0,0,0
16520,16520,"`""[\\""segment-name2\\"",\\""value2\\"",\\""value3/value4\\""]""`",0.0,0,0,0
16521,16521,"`""[\\""segment-name\\"",\\""param1\\"",\\""different-segment\\""]""`",0.0,0,0,0
16522,16522,"`""[\\""segment-name\\"",\\""param1\\"",\\""segment-name2\\"",\\""different-value\\"",\\""value3/value4\\""]""`",0.0,0,0,0
16523,16523,"`""[\\""segment-name\\"",\\""param1\\"",\\""segment-name2\\"",\\""value2\\"",\\""different/random/paths\\""]""`",0.0,0,0,0
16524,16524,"`""[\\""segment-name\\"",\\""value1\\"",\\""segment-name2\\"",\\""value2\\"",\\""value3/value4\\""]""`",0.0,0,0,0
16525,16525,"`""[\\""value2\\"",\\""value3/value4\\""]""`",0.0,0,0,0
16526,16526,"`""[\\""value3/value4\\""]""`",0.0,0,0,0
16527,16527,"`""[]""`",0.0,0,0,0
16528,16528,"`""\\""development\\"";""`",0.0,0,0,0
16529,16529,"`""\\""different-segment\\""""`",0.0,0,0,0
16530,16530,"`""\\""different-value\\""""`",0.0,0,0,0
16531,16531,"`""\\""different/random/paths\\""""`",0.0,0,0,0
16532,16532,"`""\\""object\\"";""`",0.0,0,0,0
16533,16533,"`""\\""production\\"";""`",0.0,0,0,0
16534,16534,"`""\\""segment-name2\\""""`",0.0,0,0,0
16535,16535,"`""\\""segment-name\\""""`",0.0,0,0,0
16536,16536,"`""\\""undefined\\"";""`",0.0,0,0,0
16537,16537,"`""\\""use strict\\"";var _interopRequireDefault=require(\\""@babel/runtime/helpers/interopRequireDefault\\"");var _react=_interopRequireDefault(require(\\""react\\""));var __jsx=_react[\\""default\\""].createElement;var a=function a(){return __jsx(\\""a\\"",{href:\\""/\\""},\\""home\\"");};""`",0.0,0,0,0
16538,16538,"`""\\""value2\\""""`",0.0,0,0,0
16539,16539,"`""\\""value3/value4\\""""`",0.0,0,0,0
16540,16540,"`""a=b&c=d""`",0.0,0,0,0
16541,16541,"`""apples and strawberries""`",0.0,0,0,0
16542,16542,"`""apples""`",0.0,0,0,0
16543,16543,"`""apples, strawberries, and blueberries""`",0.0,0,0,0
16544,16544,"`""class El extends React.Component{render(){return __jsx(\\""div\\"",null);}}const a=5;export var __N_SSG=true;export{El as default,a};""`",0.0,0,0,0
16545,16545,"`""class Test extends React.Component{render(){return __jsx(\\""div\\"",null);}}export var __N_SSG=true;export default Test;""`",0.0,0,0,0
16546,16546,"`""const a=2;export var __N_SSG=true;export default function Test(){return __jsx(\\""div\\"",null);}""`",0.0,0,0,0
16547,16547,"`""export var __N_SSG=true;export class MyClass{}export default function Test(){return __jsx(\\""div\\"",null);}""`",0.0,0,0,0
16548,16548,"`""export var __N_SSG=true;export const foo=2;export default function Test(){return __jsx(\\""div\\"",null);}""`",0.0,0,0,0
16549,16549,"`""export var __N_SSG=true;export default class Test extends React.Component{render(){return __jsx(\\""div\\"",null);}}""`",0.0,0,0,0
16550,16550,"`""export var __N_SSG=true;export default function Home(){return __jsx(\\""div\\"",null);}""`",0.0,0,0,0
16551,16551,"`""export var __N_SSG=true;export default function Test(){return __jsx(\\""div\\"",null);}""`",0.0,0,0,0
16552,16552,"`""export var __N_SSG=true;export function Noop(){}export default function Test(){return __jsx(\\""div\\"",null);}""`",0.0,0,0,0
16553,16553,"`""export var __N_SSG=true;export{default}from'a';""`",0.0,0,0,0
16554,16554,"`""export var __N_SSG=true;export{foo,bar as baz}from'.';export default function Test(){return __jsx(\\""div\\"",null);}""`",0.0,0,0,0
16555,16555,"`""false;""`",0.0,0,0,0
16556,16556,"`""fo'o""`",0.0,0,0,0
16557,16557,"`""fo\\""o""`",0.0,0,0,0
16558,16558,"`""foo"" + ""bar""`",0.0,0,0,0
16559,16559,"`""foo""`",0.0,0,0,0
16560,16560,"`""foo'`",0.0,0,0,0
16561,16561,"`""function El(){return __jsx(\\""div\\"",null);}const a=5;export var __N_SSG=true;export{El as default,a};""`",0.0,0,0,0
16562,16562,"`""function El(){return __jsx(\\""div\\"",null);}export var __N_SSG=true;export{El as default};""`",0.0,0,0,0
16563,16563,"`""function Function1(){return{a:function bug(a){return 2;}};}function Function2(){var bug=1;return{bug};}""`",0.0,0,0,0
16564,16564,"`""function a() {  console.log(\\""object\\"");}""`",0.0,0,0,0
16565,16565,"`""function a() {  console.log(false);}""`",0.0,0,0,0
16566,16566,"`""http://localhost:${",0.0,0,0,0
16567,16567,"`""if (false) {}""`",0.0,0,0,0
16568,16568,"`""if (true) {}""`",0.0,0,0,0
16569,16569,"`""import React from\\""react\\"";var __jsx=React.createElement;var a=function a(){return __jsx(React.Fragment,null,\\""hello\\"");};""`",0.0,0,0,0
16570,16570,"`""import React from\\""react\\"";var __jsx=React.createElement;var a=function a(){return __jsx(\\""a\\"",{href:\\""/\\""},\\""home\\"");};""`",0.0,0,0,0
16571,16571,"`""import \\""core-js\\"";import * as React from \\""react\\"";import { yeet } from \\""c\\"";import baz3 from \\""d\\"";import { c, d } from \\""e\\"";import { e as ee } from \\""f\\"";""`",0.0,0,0,0
16572,16572,"`""import \\""core-js\\"";import { bar } from \\""a\\"";import baz from \\""b\\"";import * as React from \\""react\\"";import { yeet } from \\""c\\"";import baz3, { cats } from \\""d\\"";import { c, d } from \\""e\\"";import { e as ee } from \\""f\\"";export var __N_SSG = true;export default function () {  return cats + bar();}""`",0.0,0,0,0
16573,16573,"`""import \\""core-js\\"";import { foo, bar } from \\""a\\"";import baz from \\""b\\"";import * as React from \\""react\\"";import baz2, { yeet } from \\""c\\"";import baz3, { cats } from \\""d\\"";import { c, d } from \\""e\\"";import { e as ee, f as ff } from \\""f\\"";""`",0.0,0,0,0
16574,16574,"`""import \\""core-js\\"";import { foo, bar } from \\""a\\"";import baz from \\""b\\"";import ooo from \\""ooo\\"";import * as React from \\""react\\"";import baz2, { yeet } from \\""c\\"";import baz3, { cats } from \\""d\\"";import { c, d } from \\""e\\"";import { e as ee, f as ff } from \\""f\\"";export function getStaticProps() {  foo();  baz2();  ff();  ooo();  return {    props: {}  };}export default function () {  return bar();}""`",0.0,0,0,0
16575,16575,"`""import other from'other';const[foo]=other;export var __N_SSG=true;export default function Home(){return __jsx(\\""div\\"",null);}""`",0.0,0,0,0
16576,16576,"`""import other from'other';const{a,cat:bar}=other;export var __N_SSG=true;export default function Home(){return __jsx(\\""div\\"",null);}""`",0.0,0,0,0
16577,16577,"`""import{jsx as _jsx}from\\""react/jsx-runtime\\"";var a=function a(){return/*#__PURE__*/_jsx(\\""a\\"",{href:\\""/\\"",children:\\""home\\""});};""`",0.0,0,0,0
16578,16578,"`""import{useState}from'react';var _useState=useState(0),count=_useState[0],setCount=_useState[1];""`",0.0,0,0,0
16579,16579,"`""import{useState}from'react';var _useState=useState(0),setCount=_useState[1];""`",0.0,0,0,0
16580,16580,"`""mobx-react-lite requires React with Hooks support""`",0.0,0,0,0
16581,16581,"`""mobx-react-lite@3 requires mobx at least version 6 to be available""`",0.0,0,0,0
16582,16582,"`""new entry""`",0.0,0,0,0
16583,16583,"`""null""`",0.0,0,0,0
16584,16584,"`""pluginConfigs"":[]`",0.0,0,0,0
16585,16585,"`""p{border-width:1px;border-radius:var(--test);border:0 solid var(--test)}""`",0.0,0,0,0
16586,16586,"`""p{color:yellow}""`",0.0,0,0,0
16587,16587,"`""p{color:yellow}.empty{}""`",0.0,0,0,0
16588,16588,"`""required field""`",0.0,0,0,0
16589,16589,"`""true;""`",0.0,0,0,0
16590,16590,"`""var React=require('react');var __jsx=React.createElement;module.exports=function(){return __jsx(\\""div\\"",null,\\""test2\\"");};""`",0.0,0,0,0
16591,16591,"`""var _jsxFileName = \\""index.js\\"";import React from \\""react\\"";var __jsx = React.createElement;import dynamic from 'next/dynamic';const Comp = dynamic(() => import('comp'), {  loadableGenerated: {    webpack: () => [require.resolveWeak('comp')]  }});export default function Page(props) {  return __jsx(Comp, {    __self: this,    __source: {      fileName: _jsxFileName,      lineNumber: 7,      columnNumber: 18    }  });}""`",0.0,0,0,0
16592,16592,`#${,0.0,0,0,0
16593,16593,`#all-${,0.0,0,0,0
16594,16594,`#link-to-${,0.0,0,0,0
16595,16595,"`#now:not(:text(""${",0.0,0,0,0
16596,16596,`#root-layout > div`,0.0,0,0,0
16597,16597,"`'.,:;!§$&/()=@^12345'`",0.0,0,0,0
16598,16598,`'filepath': 'components/Button/Button.js'`,0.0,0,0,0
16599,16599,`'filepath': 'components/Placeholder/Placeholder.js'`,0.0,0,0,0
16600,16600,`'filepath': 'components/RandomButton/RandomButton.js'`,0.0,0,0,0
16601,16601,`'filepath': 'src/components/Button.js'`,0.0,0,0,0
16602,16602,`'filepath': 'src/components/Placeholder.js'`,0.0,0,0,0
16603,16603,"`'fo""o'`",0.0,0,0,0
16604,16604,`'fo\\'o'`,0.0,0,0,0
16605,16605,"`'foo""`",0.0,0,0,0
16606,16606,`'foo'`,0.0,0,0,0
16607,16607,`(en) Hello from /`,0.0,0,0,0
16608,16608,`(es) Hello from /`,0.0,0,0,0
16609,16609,"`(function() {
      window.beforeNav = 1
      window.next.router.push('/not-found/first?hiding=true')
    })()`",0.0,0,0,0
16610,16610,"`(function() {
      window.beforeNav = 1
      window.next.router.push('/not-found?hiding=true')
    })()`",0.0,0,0,0
16611,16611,"`- error Page / provided runtime 'edge', the edge runtime for rendering is currently experimental. Use runtime 'experimental-edge' instead.`",0.0,0,0,0
16612,16612,`- warn /api/edge provided runtime 'experimental-edge'. It can be updated to 'edge' instead.`,0.0,0,0,0
16613,16613,"`- warn You are using an experimental edge runtime, the API might change.`",0.0,0,0,0
16614,16614,`---`,0.0,0,0,0
16615,16615,`../../../dist/mobx.cjs.production.min.js`,0.0,0,0,0
16616,16616,`.bs.${,0.0,0,0,0
16617,16617,`.next/server/app/gsp/sitemap/${,0.0,0,0,0
16618,16618,`/${,0.0,0,0,0
16619,16619,`/%2/`,0.0,0,0,0
16620,16620,`/%2`,0.0,0,0,0
16621,16621,`/404`,0.0,0,0,0
16622,16622,`/_next/data/BUILD_ID/en/fallback-true-blog/rewritten.json`,0.0,0,0,0
16623,16623,`/about/`,0.0,0,0,0
16624,16624,`/api/edge-search-params`,0.0,0,0,0
16625,16625,`/api/edge`,0.0,0,0,0
16626,16626,`/blog/shu/hi`,0.0,0,0,0
16627,16627,`/catch-all-optional/${,0.0,0,0,0
16628,16628,`/catch-all-optional`,0.0,0,0,0
16629,16629,`/catch-all/${,0.0,0,0,0
16630,16630,`/catch-all`,0.0,0,0,0
16631,16631,`/custom-cache`,0.0,0,0,0
16632,16632,`/dynamic-no-gen-params-ssr/${,0.0,0,0,0
16633,16633,`/dynamic-no-gen-params/${,0.0,0,0,0
16634,16634,`/edge/foo`,0.0,0,0,0
16635,16635,`/enable-and-redirect?to=${,0.0,0,0,0
16636,16636,`/es/index`,0.0,0,0,0
16637,16637,`/external-push/${,0.0,0,0,0
16638,16638,`/fallback-true-blog/${,0.0,0,0,0
16639,16639,`/fetch-user-agent-crypto`,0.0,0,0,0
16640,16640,`/fetch-user-agent-default`,0.0,0,0,0
16641,16641,`/global`,0.0,0,0,0
16642,16642,`/gsp/sitemap.xml/${,0.0,0,0,0
16643,16643,`/gsp/sitemap/${,0.0,0,0,0
16644,16644,`/index`,0.0,0,0,0
16645,16645,`/old-home`,0.0,0,0,0
16646,16646,`/onclick-prevent-default`,0.0,0,0,0
16647,16647,`/onclick`,0.0,0,0,0
16648,16648,`/partial-gen-params-no-additional-lang/en/first`,0.0,0,0,0
16649,16649,`/promise`,0.0,0,0,0
16650,16650,`/redirect-1/`,0.0,0,0,0
16651,16651,`/redirect-1`,0.0,0,0,0
16652,16652,`/redirect/external-log/${,0.0,0,0,0
16653,16653,`/ref`,0.0,0,0,0
16654,16654,`/rewrite-1/`,0.0,0,0,0
16655,16655,`/rewrite-1`,0.0,0,0,0
16656,16656,`/rewrite-2/`,0.0,0,0,0
16657,16657,`/rewrite-2`,0.0,0,0,0
16658,16658,`/root/es/index`,0.0,0,0,0
16659,16659,`/root/index`,0.0,0,0,0
16660,16660,`/something`,0.0,0,0,0
16661,16661,`/ssr-page-2`,0.0,0,0,0
16662,16662,`/ssr-page/`,0.0,0,0,0
16663,16663,`/ssr-page`,0.0,0,0,0
16664,16664,`/url/relative-next-redirect`,0.0,0,0,0
16665,16665,`/url/relative-next-request`,0.0,0,0,0
16666,16666,`/url/relative-next-rewrite`,0.0,0,0,0
16667,16667,`/url/relative-redirect`,0.0,0,0,0
16668,16668,`/url/relative-request`,0.0,0,0,0
16669,16669,`/url/relative-url`,0.0,0,0,0
16670,16670,"`;
return (pizza);`",0.0,0,0,0
16671,16671,"`<Script id=""inline-script"" strategy=""worker"" dangerouslySetInnerHTML={{__html: ""document.getElementById('text').textContent += 'abcd'""}}/>`",0.0,0,0,0
16672,16672,"`<Script id=""inline-script"" strategy=""worker"">{""document.getElementById('text').textContent += 'abc'""}</Script>`",0.0,0,0,0
16673,16673,"`<base href=""http://mysite.com/"" data-react-helmet=""true"">`",0.0,0,0,0
16674,16674,"`<base href=""http://mysite.com/public"" ${",0.0,0,0,0
16675,16675,`<body ${,0.0,0,0,0
16676,16676,`<div>${,0.0,0,0,0
16677,16677,`<div><title ${,0.0,0,0,0
16678,16678,`<html ${,0.0,0,0,0
16679,16679,"`<link href=""http://localhost/helmet"" rel=""canonical"" data-react-helmet=""true"">`",0.0,0,0,0
16680,16680,"`<link href=""http://localhost/helmet/newest"" rel=""canonical"" ${",0.0,0,0,0
16681,16681,"`<link href=""http://localhost/inner.css"" rel=""stylesheet"" type=""text/css"" media=""all"" ${",0.0,0,0,0
16682,16682,"`<link href=""http://localhost/style.css"" rel=""stylesheet"" type=""text/css"" data-react-helmet=""true"">`",0.0,0,0,0
16683,16683,"`<link href=""http://localhost/style.css"" rel=""stylesheet"" type=""text/css"" media=""all"" ${",0.0,0,0,0
16684,16684,"`<link href=""http://localhost/style2.css"" rel=""stylesheet"" type=""text/css"" data-react-helmet=""true"">`",0.0,0,0,0
16685,16685,"`<link rel=""canonical"" href=""http://localhost/helmet"" ${",0.0,0,0,0
16686,16686,"`<link rel=""canonical"" href=""http://localhost/helmet/component"" ${",0.0,0,0,0
16687,16687,"`<link rel=""canonical"" href=""http://localhost/helmet/innercomponent"" ${",0.0,0,0,0
16688,16688,"`<link rel=""stylesheet"" href=""http://localhost/inner.css"" type=""text/css"" media=""all"" ${",0.0,0,0,0
16689,16689,"`<link rel=""stylesheet"" type=""text/css"" href=""/style.css"" />`",0.0,0,0,0
16690,16690,"`<link rel=""stylesheet"" type=""text/css"" href=""/style2.css"" />`",0.0,0,0,0
16691,16691,"`<link rel=""stylesheet"" type=""text/css"" href=""foo.css"" />`",0.0,0,0,0
16692,16692,`<loc>https://example.com/dynamic/${,0.0,0,0,0
16693,16693,"`<meta charset=""utf-8"" ${",0.0,0,0,0
16694,16694,"`<meta charset=""utf-8"" data-react-helmet=""true"">`",0.0,0,0,0
16695,16695,"`<meta content=""Test Description"" name=""description"" ${",0.0,0,0,0
16696,16696,"`<meta name=""description"" content=""Duplicate description"" ${",0.0,0,0,0
16697,16697,"`<meta name=""description"" content=""Inner description"" ${",0.0,0,0,0
16698,16698,"`<meta name=""description"" content=""Inner duplicate description"" ${",0.0,0,0,0
16699,16699,"`<meta name=""description"" content=""New description"" data-react-helmet=""true"">`",0.0,0,0,0
16700,16700,"`<meta name=""description"" content=""Test description"" ${",0.0,0,0,0
16701,16701,"`<meta name=""description"" content=""This is &quot;quoted&quot; text and &amp; and '."" ${",0.0,0,0,0
16702,16702,"`<meta name=""keywords"" content=""test,meta,tags"" ${",0.0,0,0,0
16703,16703,`<script ${,0.0,0,0,0
16704,16704,"`<script src=""foo.js"" async="""" ${",0.0,0,0,0
16705,16705,"`<script src=""http://localhost/test.js"" type=""text/javascript"" ${",0.0,0,0,0
16706,16706,"`<script src=""http://localhost/test.js"" type=""text/javascript"" data-react-helmet=""true""></script>`",0.0,0,0,0
16707,16707,"`<script src=""http://localhost/test2.js"" type=""text/javascript"" ${",0.0,0,0,0
16708,16708,`<style ${,0.0,0,0,0
16709,16709,"`<style type=""text/css"" ${",0.0,0,0,0
16710,16710,`<title ${,0.0,0,0,0
16711,16711,`<title>Existing Title</title>`,0.0,0,0,0
16712,16712,"`<transition event=""TIMER"" target=""light.yellow"" />`",0.0,0,0,0
16713,16713,"`API route returned a Response object in the Node.js runtime, this is not supported.`",0.0,0,0,0
16714,16714,`About page`,0.0,0,0,0
16715,16715,"`Additional keys were returned from \`getServerSideProps\`. Properties intended for your component must be nested under the \`props\` key, e.g.:`",0.0,0,0,0
16716,16716,`All ${,0.0,0,0,0
16717,16717,`Attempted import error:`,0.0,0,0,0
16718,16718,`Build failed`,0.0,0,0,0
16719,16719,"`Can't retrieve item ""barKey"" before loading storage`",0.0,0,0,0
16720,16720,"`Can't set item ""barKey"" before loading storage`",0.0,0,0,0
16721,16721,`Dangerous <script> include`,0.0,0,0,0
16722,16722,`Entire page / deopted into client-side rendering.`,0.0,0,0,0
16723,16723,"`Error: Page / provided runtime 'edge', the edge runtime for rendering is currently experimental. Use runtime 'experimental-edge' instead.`",0.0,0,0,0
16724,16724,`Export path: ${,0.0,0,0,0
16725,16725,`Given Mario is ${,0.0,0,0,0
16726,16726,`Home page`,0.0,0,0,0
16727,16727,"`Keys that need to be moved: world, query, params, time, random`",0.0,0,0,0
16728,16728,"`No method named ""${",0.0,0,0,0
16729,16729,`Object.keys(window.next.router.sdc)`,0.0,0,0,0
16730,16730,"`Page ""/variable-revalidate-edge/revalidate-3"" is using runtime = 'edge' which is currently incompatible with dynamic = 'force-static'. Please remove either ""runtime"" or ""force-static"" for correct behavior`",0.0,0,0,0
16731,16731,`Page 2`,0.0,0,0,0
16732,16732,`Pages directory cannot be found at ${,0.0,0,0,0
16733,16733,"`Private method.
@private`",0.0,0,0,0
16734,16734,"`Public method.
@public`",0.0,0,0,0
16735,16735,"`Reaches state ""a"": GO_TO_B → GO_TO_A`",0.0,0,0,0
16736,16736,"`Reaches state ""a"": GO_TO_C → GO_TO_A`",0.0,0,0,0
16737,16737,`React.Fragment`,0.0,0,0,0
16738,16738,`Server Actions are not supported with static export.`,0.0,0,0,0
16739,16739,`State '${,0.0,0,0,0
16740,16740,`The event 'EVENT' returned a promise - did you mean to use the sync method?`,0.0,0,0,0
16741,16741,`The test for 'a' returned a promise - did you mean to use the sync method?`,0.0,0,0,0
16742,16742,`[${,0.0,0,0,0
16743,16743,`[Cosmos] See you at http://localhost:${,0.0,0,0,0
16744,16744,`[Error: Actor terminated without satisfying predicate]`,0.0,0,0,0
16745,16745,"`[].slice.call(document.querySelectorAll(""link[rel=prefetch]"")).map((e) => new URL(e.href).pathname)`",0.0,0,0,0
16746,16746,`^\\/api\\-docs\\/(.+?)(?:\\/)?$`,0.0,0,0,0
16747,16747,`^\\/dynamic\\/([^\\/]+?)(?:\\/)?$`,0.0,0,0,0
16748,16748,`^\\/user\\/([^\\/]+?)\\/profile(?:\\/)?$`,0.0,0,0,0
16749,16749,"`__jsx(""a"",{href:""/""`",0.0,0,0,0
16750,16750,`__jsx(${,0.0,0,0,0
16751,16751,`_plugin/plugin-${,0.0,0,0,0
16752,16752,``,0.0,0,0,0
16753,16753,`active`,0.0,0,0,0
16754,16754,`base[${,0.0,0,0,0
16755,16755,`body {background-color: green;}`,0.0,0,0,0
16756,16756,`bs.${,0.0,0,0,0
16757,16757,"`button[name=""${",0.0,0,0,0
16758,16758,`ca observed`,0.0,0,0,0
16759,16759,`ca unobserved`,0.0,0,0,0
16760,16760,`cb observed`,0.0,0,0,0
16761,16761,`cb unobserved`,0.0,0,0,0
16762,16762,`child of ${,0.0,0,0,0
16763,16763,"`colors: PropTypes.objectOf(
			PropTypes.shape({
				bar: PropTypes.number.isRequired,
				baz: PropTypes.any
			})
		)`",0.0,0,0,0
16764,16764,"`const a = () => <a href=""/"">home</a>;`",0.0,0,0,0
16765,16765,"`const a = ()=><a href=""/"">home</a>`",0.0,0,0,0
16766,16766,`cp -r ./node_modules_bak/* ./node_modules`,0.0,0,0,0
16767,16767,`data=cool`,0.0,0,0,0
16768,16768,`default-src 'nonce-${,0.0,0,0,0
16769,16769,`default-src 'nonce-othernonce'; script-src 'nonce-${,0.0,0,0,0
16770,16770,`document.body.innerText`,0.0,0,0,0
16771,16771,"`document.cookie = ""test-cookie=${",0.0,0,0,0
16772,16772,`document.cookie = 'auth=0'`,0.0,0,0,0
16773,16773,`document.cookie = 'auth=1'`,0.0,0,0,0
16774,16774,`document.cookie = 'edge-auth=0'`,0.0,0,0,0
16775,16775,`document.cookie = 'edge-auth=1'`,0.0,0,0,0
16776,16776,`document.getElementById('client-name').value = 'test'`,0.0,0,0,0
16777,16777,`document.getElementById('n').value = '123'`,0.0,0,0,0
16778,16778,`document.getElementById('name').value = 'test'`,0.0,0,0,0
16779,16779,`document.querySelector('#content').innerText`,0.0,0,0,0
16780,16780,`document.querySelector('h1').textContent`,0.0,0,0,0
16781,16781,"`document.querySelector('script[data-nscript=""beforeInteractive""]')`",0.0,0,0,0
16782,16782,`document.querySelector('script[data-partytown-config]').innerHTML`,0.0,0,0,0
16783,16783,`document.querySelector('script[data-partytown]').innerHTML`,0.0,0,0,0
16784,16784,`document.querySelector('script[data-partytown]')`,0.0,0,0,0
16785,16785,"`document.querySelectorAll('link[rel=""stylesheet""][href*=""/page.css""]').length`",0.0,0,0,0
16786,16786,"`document.querySelectorAll('script[type=""text/partytown-x""]').length`",0.0,0,0,0
16787,16787,`document.title`,0.0,0,0,0
16788,16788,`error`,0.0,0,0,0
16789,16789,`export const config={};`,0.0,0,0,0
16790,16790,`export default function () { return <div>{cats + bar()}</div> }`,0.0,0,0,0
16791,16791,`export default function () { return bar(); }`,0.0,0,0,0
16792,16792,`export default function () { return cats + bar(); }`,0.0,0,0,0
16793,16793,`export function getStaticProps() {foo();baz2();ff();ooo(); return { props: {} }}`,0.0,0,0,0
16794,16794,`export function getStaticProps() {foo();baz2();ff();ooo();cats; return { props: {} }}`,0.0,0,0,0
16795,16795,`export function getStaticProps() {foo;bar;baz;cats;baz2;ff; return { props: {} } }`,0.0,0,0,0
16796,16796,`export function register() {console.log('bread')}`,0.0,0,0,0
16797,16797,`export function register() {console.log('toast')}`,0.0,0,0,0
16798,16798,`fetch(...args)`,0.0,0,0,0
16799,16799,`finished`,0.0,0,0,0
16800,16800,"`foo: PropTypes.shape({
			/**
			 * Number
			 */
			bar: PropTypes.number.isRequired,
			/** Any */
			baz: PropTypes.any
		})`",0.0,0,0,0
16801,16801,`foo`,0.0,0,0,0
16802,16802,"`function Wrapper(ref) {
	var children = ref.children;
	return React.createElement('div', {id: 'foo'}, children);
}

;
return (React.createElement(Wrapper, null,
	React.createElement(Wrapper, null, React.createElement(Icon, {name: ""plus""})),
	React.createElement(Wrapper, null, React.createElement(Icon, {name: ""clip""}))
));`",0.0,0,0,0
16803,16803,"`function Wrapper(ref) {
	var children = ref.children;
	return React.createElement('div', {id: 'foo'}, children);
}

;React.createElement(Wrapper, null,
	React.createElement(Wrapper, null, React.createElement(Icon, {name: ""plus""})),
	React.createElement(Wrapper, null, React.createElement(Icon, {name: ""clip""}))
)`",0.0,0,0,0
16804,16804,"`function Wrapper(ref) {
	var children = ref.children;
	return React.createElement('div', {id: 'foo'}, children);
}

`",0.0,0,0,0
16805,16805,`function a(){console.log(typeof window === 'undefined')}`,0.0,0,0,0
16806,16806,"`function f() { require(""foo""); }`",0.0,0,0,0
16807,16807,`getComputedStyle(document.querySelector('button')).color`,0.0,0,0,0
16808,16808,`hello from /catch-all-optional/this/is/a/test`,0.0,0,0,0
16809,16809,`hello from /catch-all/this/is/a/test`,0.0,0,0,0
16810,16810,`hello from app/dashboard/deployments/info/[id]. ID is: 123`,0.0,0,0,0
16811,16811,"`href=""${",0.0,0,0,0
16812,16812,`https://example.com${,0.0,0,0,0
16813,16813,`id property is required for every item returned from generateImageMetadata`,0.0,0,0,0
16814,16814,`id property is required for every item returned from generateSitemaps`,0.0,0,0,0
16815,16815,`if (process.browser === false) {}`,0.0,0,0,0
16816,16816,`if (process.browser) {}`,0.0,0,0,0
16817,16817,`if (process.env.NODE_ENV !== 'production') {}`,0.0,0,0,0
16818,16818,`if (process.env.NODE_ENV === 'development') {}`,0.0,0,0,0
16819,16819,`if (process.env.NODE_ENV === 'production') {}`,0.0,0,0,0
16820,16820,"`import * as React from ""react"";`",0.0,0,0,0
16821,16821,"`import React from""react""`",0.0,0,0,0
16822,16822,"`import baz2,{yeet}from""c"";`",0.0,0,0,0
16823,16823,"`import baz3,{cats}from""d"";`",0.0,0,0,0
16824,16824,"`import { observable } from ""mobx""

  class Box {
      /*0*/
      @observable
      /*1*/
      field /*2 */ = /*3*/ 1 /*4*/
  }`",0.0,0,0,0
16825,16825,"`import""core-js"";`",0.0,0,0,0
16826,16826,"`import*as React from""react"";`",0.0,0,0,0
16827,16827,"`import{c,d}from""e"";`",0.0,0,0,0
16828,16828,"`import{e as ee,f as ff}from""f"";`",0.0,0,0,0
16829,16829,"`import{foo,bar}from""a"";import baz from""b"";`",0.0,0,0,0
16830,16830,"`import{foo,bar}from""a"";import baz from""b"";import ooo from""ooo"";`",0.0,0,0,0
16831,16831,"`initialState = {a: 1};
React.createElement('i', null, state.a);`",0.0,0,0,0
16832,16832,"`initialState = {a: 1};
return (React.createElement('i', null, state.a));`",0.0,0,0,0
16833,16833,`link[${,0.0,0,0,0
16834,16834,"`location.href = ""/?useragent=${",0.0,0,0,0
16835,16835,`meta[${,0.0,0,0,0
16836,16836,"`meta[name=""test-head-${",0.0,0,0,0
16837,16837,"`meta[name=""test-head-initial-props""]`",0.0,0,0,0
16838,16838,"`meta[name=""test-in-fragment""]`",0.0,0,0,0
16839,16839,"`next.router.isReady ? ""yup"" : ""nope""`",0.0,0,0,0
16840,16840,"`next.router.push(""/afterfiles-rewrite-ssg"")`",0.0,0,0,0
16841,16841,"`next.router.push(""/fallback-true-blog/first"")`",0.0,0,0,0
16842,16842,"`next.router.push(""/to/some/404/path"")`",0.0,0,0,0
16843,16843,"`next.router.push('/about', undefined, { shallow: true })`",0.0,0,0,0
16844,16844,"`next.router.push('/about?hello=world', undefined, { shallow: true })`",0.0,0,0,0
16845,16845,`next.router.push('/fallback-true-blog/rewritten')`,0.0,0,0,0
16846,16846,`next.router.push('/fallback-true-blog/second')`,0.0,0,0,0
16847,16847,`next.router.push('/redirect-1')`,0.0,0,0,0
16848,16848,`next.router.push('/rewrite-1')`,0.0,0,0,0
16849,16849,`next.router.push('/rewrite-2')`,0.0,0,0,0
16850,16850,`next.router.query.hello || 'empty'`,0.0,0,0,0
16851,16851,`next.router.query.hello`,0.0,0,0,0
16852,16852,`next.router.query.slug`,0.0,0,0,0
16853,16853,`noscript[${,0.0,0,0,0
16854,16854,`o observed`,0.0,0,0,0
16855,16855,`o unobserved`,0.0,0,0,0
16856,16856,`p {font-size: 12px;}`,0.0,0,0,0
16857,16857,`path-/external-push/${,0.0,0,0,0
16858,16858,`process.browser == false`,0.0,0,0,0
16859,16859,`process.browser`,0.0,0,0,0
16860,16860,`process.env.NODE_ENV`,0.0,0,0,0
16861,16861,"`require ( ""foo"" )`",0.0,0,0,0
16862,16862,"`require(""f"" + ""o"" + ""o"")`",0.0,0,0,0
16863,16863,"`require(""f"" + (""o"" + ""o""))`",0.0,0,0,0
16864,16864,"`require(""foo"")`",0.0,0,0,0
16865,16865,"`require(""react"")`",0.0,0,0,0
16866,16866,`require('./foo')`,0.0,0,0,0
16867,16867,`require('foo' + 'bar')`,0.0,0,0,0
16868,16868,`require('foo');require('bar')`,0.0,0,0,0
16869,16869,`require('foo')`,0.0,0,0,0
16870,16870,`require(foo)`,0.0,0,0,0
16871,16871,"`require.call(module, ""foo"")`",0.0,0,0,0
16872,16872,"`script-src 'nonce-""><script></script>""'`",0.0,0,0,0
16873,16873,`script-src 'nonce-${,0.0,0,0,0
16874,16874,`script-src 'nonce-'`,0.0,0,0,0
16875,16875,`script-src 'self' 'nonce-${,0.0,0,0,0
16876,16876,`script[${,0.0,0,0,0
16877,16877,`style-src 'self'; script-src 'nonce-${,0.0,0,0,0
16878,16878,`style[${,0.0,0,0,0
16879,16879,`test-${,0.0,0,0,0
16880,16880,`to /edge/[id]`,0.0,0,0,0
16881,16881,`typeof window !== 'object';`,0.0,0,0,0
16882,16882,`typeof window !== 'undefined';`,0.0,0,0,0
16883,16883,`typeof window === 'object';`,0.0,0,0,0
16884,16884,`typeof window === 'undefined';`,0.0,0,0,0
16885,16885,`var ${,0.0,0,0,0
16886,16886,"`var __jsx = React.createElement;import ""core-js"";import { bar } from ""a"";import baz from ""b"";import * as React from ""react"";import { yeet } from ""c"";import baz3, { cats } from ""d"";import { c, d } from ""e"";import { e as ee } from ""f"";export var __N_SSG = true;export default function () {  return __jsx(""div"", {    __self: this,    __source: {      fileName: _jsxFileName,      lineNumber: 1,      columnNumber: 326    }  }, cats + bar());}`",0.0,0,0,0
16887,16887,"`var __jsx = React.createElement;import React from ""react"";export var __N_SSG = true;export default function Home(_ref) {  var greeting = _ref.greeting;  return __jsx(""h1"", {    __self: this,    __source: {      fileName: _jsxFileName,      lineNumber: 8,      columnNumber: 20    }  }, greeting);}_c = Home;var _c;$RefreshReg$(_c, ""Home"");`",0.0,0,0,0
16888,16888,`var __jsx=${,0.0,0,0,0
16889,16889,`var __jsx=React.createElement`,0.0,0,0,0
16890,16890,"`var a = 1;
React.createElement('i', null, a);`",0.0,0,0,0
16891,16891,"`var a = 1;
return (React.createElement('i', null, a));`",0.0,0,0,0
16892,16892,`var f = require;`,0.0,0,0,0
16893,16893,`warn`,0.0,0,0,0
16894,16894,`window.__log`,0.0,0,0,0
16895,16895,`window.__manipulated_by_injection`,0.0,0,0,0
16896,16896,`window.__v = 1`,0.0,0,0,0
16897,16897,`window.__v`,0.0,0,0,0
16898,16898,`window._script_order`,0.0,0,0,0
16899,16899,`window.didFullPageTransition = 'no'`,0.0,0,0,0
16900,16900,`window.didFullPageTransition`,0.0,0,0,0
16901,16901,`window.document.body.innerText`,0.0,0,0,0
16902,16902,`window.getComputedStyle(document.querySelector('#client-component')).fontSize`,0.0,0,0,0
16903,16903,`window.getComputedStyle(document.querySelector('#css-modules')).fontSize`,0.0,0,0,0
16904,16904,`window.getComputedStyle(document.querySelector('#cssm')).color`,0.0,0,0,0
16905,16905,`window.getComputedStyle(document.querySelector('#sass-client-layout')).backgroundColor`,0.0,0,0,0
16906,16906,`window.getComputedStyle(document.querySelector('#sass-client-layout')).color`,0.0,0,0,0
16907,16907,`window.getComputedStyle(document.querySelector('#sass-client-page')).backgroundColor`,0.0,0,0,0
16908,16908,`window.getComputedStyle(document.querySelector('#sass-client-page')).color`,0.0,0,0,0
16909,16909,`window.getComputedStyle(document.querySelector('#sass-server-layout')).backgroundColor`,0.0,0,0,0
16910,16910,`window.getComputedStyle(document.querySelector('#sass-server-page')).backgroundColor`,0.0,0,0,0
16911,16911,`window.getComputedStyle(document.querySelector('#sass-server-page')).color`,0.0,0,0,0
16912,16912,`window.getComputedStyle(document.querySelector('#scss-client-layout')).backgroundColor`,0.0,0,0,0
16913,16913,`window.getComputedStyle(document.querySelector('#scss-client-layout')).color`,0.0,0,0,0
16914,16914,`window.getComputedStyle(document.querySelector('#scss-client-page')).backgroundColor`,0.0,0,0,0
16915,16915,`window.getComputedStyle(document.querySelector('#scss-client-page')).color`,0.0,0,0,0
16916,16916,`window.getComputedStyle(document.querySelector('#scss-server-layout')).backgroundColor`,0.0,0,0,0
16917,16917,`window.getComputedStyle(document.querySelector('#scss-server-page')).backgroundColor`,0.0,0,0,0
16918,16918,`window.getComputedStyle(document.querySelector('#scss-server-page')).color`,0.0,0,0,0
16919,16919,`window.getComputedStyle(document.querySelector('#server-cssm')).color`,0.0,0,0,0
16920,16920,`window.getComputedStyle(document.querySelector('.btn.btn-blue')).backgroundColor`,0.0,0,0,0
16921,16921,`window.getComputedStyle(document.querySelector('.btn:not(.btn-blue)')).backgroundColor`,0.0,0,0,0
16922,16922,`window.getComputedStyle(document.querySelector('.page-2')).backgroundColor`,0.0,0,0,0
16923,16923,`window.getComputedStyle(document.querySelector('b')).color`,0.0,0,0,0
16924,16924,`window.getComputedStyle(document.querySelector('button')).color`,0.0,0,0,0
16925,16925,`window.getComputedStyle(document.querySelector('button')).fontSize`,0.0,0,0,0
16926,16926,`window.getComputedStyle(document.querySelector('h1')).backgroundColor`,0.0,0,0,0
16927,16927,`window.getComputedStyle(document.querySelector('main')).paddingTop`,0.0,0,0,0
16928,16928,`window.getComputedStyle(document.querySelector('p')).color`,0.0,0,0,0
16929,16929,`window.getComputedStyle(document.querySelector('p')).fontFamily`,0.0,0,0,0
16930,16930,`window.location.pathname`,0.0,0,0,0
16931,16931,"`window.nd.router.prefetch(""/static-page"", {kind: ""auto""})`",0.0,0,0,0
16932,16932,"`window.next.router.push(""${",0.0,0,0,0
16933,16933,"`window.next.router.push('/', '/redirect-1', { shallow: true })`",0.0,0,0,0
16934,16934,"`window.next.router.replace(""${",0.0,0,0,0
16935,16935,"`window.router.push(""/0/0/100/10000/page2"")`",0.0,0,0,0
16936,16936,"`window.router.push(""/0/0/10000/10000/page2"")`",0.0,0,0,0
16937,16937,"`window.router.push(""/0/1000/100/1000/page2"")`",0.0,0,0,0
16938,16938,"`window.router.push(""/10/100/100/1000/page2"")`",0.0,0,0,0
16939,16939,"`window.router.push(""/10/1000/100/1000/page2"")`",0.0,0,0,0
16940,16940,`window.router.refresh()`,0.0,0,0,0
16941,16941,`yarn next build --no-lint`,0.0,0,0,0
16942,16942,`yarn next start`,0.0,0,0,0
16943,16943,`yarn next`,0.0,0,0,0
16944,16944,`yarn set version berry && yarn config set enableGlobalCache true && yarn config set compressionLevel 0 && yarn add ${,0.0,0,0,0
16945,16945,a11,0.0,0,0,0
16946,16946,a3,0.0,0,0,0
16947,16947,about,0.0,0,0,0
16948,16948,absent,0.0,0,0,0
16949,16949,absolute,0.0,0,0,0
16950,16950,accept,0.0,0,0,0
16951,16951,action2,0.0,0,0,0
16952,16952,actionFunction,0.0,0,0,0
16953,16953,activate,0.0,0,0,0
16954,16954,activateCrosswalkLight,0.0,0,0,0
16955,16955,activity,0.0,0,0,0
16956,16956,activityMachine,0.0,0,0,0
16957,16957,addBasePath,0.0,0,0,0
16958,16958,addCookie,0.0,0,0,0
16959,16959,addNumber,0.0,0,0,0
16960,16960,address,0.0,0,0,0
16961,16961,afterAll,0.0,0,0,0
16962,16962,allHeaders,0.0,0,0,0
16963,16963,allSections,0.0,0,0,0
16964,16964,alwaysFalse,0.0,0,0,0
16965,16965,amp,0.0,0,0,0
16966,16966,animation,0.0,0,0,0
16967,16967,another,0.0,0,0,0
16968,16968,anotherEvent,0.0,0,0,0
16969,16969,anotherParentMachine,0.0,0,0,0
16970,16970,answering,0.0,0,0,0
16971,16971,apiPath,0.0,0,0,0
16972,16972,appDir,0.0,0,0,0
16973,16973,apply,0.0,0,0,0
16974,16974,architecture,0.0,0,0,0
16975,16975,arg,0.0,0,0,0
16976,16976,arr1,0.0,0,0,0
16977,16977,arr2,0.0,0,0,0
16978,16978,arr3,0.0,0,0,0
16979,16979,arr4,0.0,0,0,0
16980,16980,arrayBuffer,0.0,0,0,0
16981,16981,assets,0.0,0,0,0
16982,16982,assignPassword,0.0,0,0,0
16983,16983,asyncMock,0.0,0,0,0
16984,16984,attachReactRefresh,0.0,0,0,0
16985,16985,attempts,0.0,0,0,0
16986,16986,authorized,0.0,0,0,0
16987,16987,authorizing,0.0,0,0,0
16988,16988,autoBind,0.0,0,0,0
16989,16989,autofocus,0.0,0,0,0
16990,16990,autohide,0.0,0,0,0
16991,16991,backgroundColor,0.0,0,0,0
16992,16992,barAgain,0.0,0,0,0
16993,16993,barFinal,0.0,0,0,0
16994,16994,barKey,0.0,0,0,0
16995,16995,baseBackground,0.0,0,0,0
16996,16996,basename,0.0,0,0,0
16997,16997,bazGuard,0.0,0,0,0
16998,16998,beforePageLoad,0.0,0,0,0
16999,16999,bind,0.0,0,0,0
17000,17000,blah,0.0,0,0,0
17001,17001,blinkCrosswalkLight,0.0,0,0,0
17002,17002,blob,0.0,0,0,0
17003,17003,block,0.0,0,0,0
17004,17004,blog,0.0,0,0,0
17005,17005,book,0.0,0,0,0
17006,17006,borderRadius,0.0,0,0,0
17007,17007,browserConfigWithFixedTime,0.0,0,0,0
17008,17008,build,0.0,0,0,0
17009,17009,buildCliOutputIndex,0.0,0,0,0
17010,17010,buildCommand,0.0,0,0,0
17011,17011,c1,0.0,0,0,0
17012,17012,c2,0.0,0,0,0
17013,17013,c3,0.0,0,0,0
17014,17014,cacheDir,0.0,0,0,0
17015,17015,callFake,0.0,0,0,0
17016,17016,camera,0.0,0,0,0
17017,17017,can,0.0,0,0,0
17018,17018,canTurnGreen,0.0,0,0,0
17019,17019,changed,0.0,0,0,0
17020,17020,channel,0.0,0,0,0
17021,17021,charset,0.0,0,0,0
17022,17022,chdir,0.0,0,0,0
17023,17023,checkMetaNameContentPair,0.0,0,0,0
17024,17024,child_a,0.0,0,0,0
17025,17025,child_b,0.0,0,0,0
17026,17026,chunkFilename,0.0,0,0,0
17027,17027,chunkify,0.0,0,0,0
17028,17028,city,0.0,0,0,0
17029,17029,classList,0.0,0,0,0
17030,17030,clearCache,0.0,0,0,0
17031,17031,clearFixture,0.0,0,0,0
17032,17032,clearMenus,0.0,0,0,0
17033,17033,clearPointerEvents,0.0,0,0,0
17034,17034,clickCallback,0.0,0,0,0
17035,17035,clientMachine,0.0,0,0,0
17036,17036,clientModules,0.0,0,0,0
17037,17037,closed,0.0,0,0,0
17038,17038,codeRevision,0.0,0,0,0
17039,17039,coffee,0.0,0,0,0
17040,17040,collapseFixtureDirs,0.0,0,0,0
17041,17041,collapseIndexes,0.0,0,0,0
17042,17042,collapseNamedIndexes,0.0,0,0,0
17043,17043,collapseOuterDirs,0.0,0,0,0
17044,17044,command,0.0,0,0,0
17045,17045,compare,0.0,0,0,0
17046,17046,compileMyCar,0.0,0,0,0
17047,17047,completely,0.0,0,0,0
17048,17048,complexNextState,0.0,0,0,0
17049,17049,componentDidCatch,0.0,0,0,0
17050,17050,componentStack,0.0,0,0,0
17051,17051,componentToolbar,0.0,0,0,0
17052,17052,componentWithEverything,0.0,0,0,0
17053,17053,composes,0.0,0,0,0
17054,17054,compress,0.0,0,0,0
17055,17055,concurrency,0.0,0,0,0
17056,17056,condMachine,0.0,0,0,0
17057,17057,conditionallyRevealAnswer,0.0,0,0,0
17058,17058,configurable,0.0,0,0,0
17059,17059,confusingExport,0.0,0,0,0
17060,17060,consoleLogSpy,0.0,0,0,0
17061,17061,containConflictsError,0.0,0,0,0
17062,17062,containObjects,0.0,0,0,0
17063,17063,convert,0.0,0,0,0
17064,17064,cookieWithRequestMeta,0.0,0,0,0
17065,17065,core,0.0,0,0,0
17066,17066,countMachineNoActions,0.0,0,0,0
17067,17067,counted,0.0,0,0,0
17068,17068,counting,0.0,0,0,0
17069,17069,cpu,0.0,0,0,0
17070,17070,crash,0.0,0,0,0
17071,17071,createAnalyzer,0.0,0,0,0
17072,17072,createCosmosConfig,0.0,0,0,0
17073,17073,createDevTools,0.0,0,0,0
17074,17074,createDomMatcher,0.0,0,0,0
17075,17075,createHash,0.0,0,0,0
17076,17076,createIframeMock,0.0,0,0,0
17077,17077,createInstance,0.0,0,0,0
17078,17078,createModel,0.0,0,0,0
17079,17079,createMultiDomMatcher,0.0,0,0,0
17080,17080,createMultiHtmlMatcher,0.0,0,0,0
17081,17081,createNext,0.0,0,0,0
17082,17082,createNextApp,0.0,0,0,0
17083,17083,createNextConfig,0.0,0,0,0
17084,17084,createNextDescribe,0.0,0,0,0
17085,17085,createRawFixtureTree,0.0,0,0,0
17086,17086,createRendererUrl,0.0,0,0,0
17087,17087,createRequestsListener,0.0,0,0,0
17088,17088,createSchema,0.0,0,0,0
17089,17089,createServer,0.0,0,0,0
17090,17090,createStyleSheet,0.0,0,0,0
17091,17091,createTestMachine,0.0,0,0,0
17092,17092,createTestModel,0.0,0,0,0
17093,17093,createValidFileMatcher,0.0,0,0,0
17094,17094,createValueTree,0.0,0,0,0
17095,17095,creator,0.0,0,0,0
17096,17096,crouching,0.0,0,0,0
17097,17097,crypto,0.0,0,0,0
17098,17098,cssnanoPresetSimple,0.0,0,0,0
17099,17099,customAttribute,0.0,0,0,0
17100,17100,customClass,0.0,0,0,0
17101,17101,customStyleBorderColor,0.0,0,0,0
17102,17102,customThemeColor,0.0,0,0,0
17103,17103,customThemeMaxWidth,0.0,0,0,0
17104,17104,dangerouslyUpdateWebpackConfig,0.0,0,0,0
17105,17105,dashboard,0.0,0,0,0
17106,17106,deabs,0.0,0,0,0
17107,17107,deactivate,0.0,0,0,0
17108,17108,decodeRendererUrlFixture,0.0,0,0,0
17109,17109,decoding,0.0,0,0,0
17110,17110,decoratorsAfterExport,0.0,0,0,0
17111,17111,decrement,0.0,0,0,0
17112,17112,deepClone,0.0,0,0,0
17113,17113,deepParallelMachine,0.0,0,0,0
17114,17114,deepfreeze,0.0,0,0,0
17115,17115,defaultConfig,0.0,0,0,0
17116,17116,defaultLocale,0.0,0,0,0
17117,17117,defaultTitle,0.0,0,0,0
17118,17118,defer,0.0,0,0,0
17119,17119,deferEvents,0.0,0,0,0
17120,17120,defineDocumentElementOntouchstart,0.0,0,0,0
17121,17121,defineJQueryPlugin,0.0,0,0,0
17122,17122,definition,0.0,0,0,0
17123,17123,delegateTarget,0.0,0,0,0
17124,17124,deleteCookies,0.0,0,0,0
17125,17125,deleteDocumentElementOntouchstart,0.0,0,0,0
17126,17126,deleteFile,0.0,0,0,0
17127,17127,deploy,0.0,0,0,0
17128,17128,describeCase,0.0,0,0,0
17129,17129,destroy,0.0,0,0,0
17130,17130,detectContentType,0.0,0,0,0
17131,17131,detectCosmosConfig,0.0,0,0,0
17132,17132,devDependencies,0.0,0,0,0
17133,17133,devServer,0.0,0,0,0
17134,17134,devServerCleanup,0.0,0,0,0
17135,17135,devServerOn,0.0,0,0,0
17136,17136,device,0.0,0,0,0
17137,17137,devicesInfo,0.0,0,0,0
17138,17138,die,0.0,0,0,0
17139,17139,dieHardModel,0.0,0,0,0
17140,17140,digest,0.0,0,0,0
17141,17141,dirWithPages,0.0,0,0,0
17142,17142,dirname,0.0,0,0,0
17143,17143,disable,0.0,0,0,0
17144,17144,disableCache,0.0,0,0,0
17145,17145,disableJavaScript,0.0,0,0,0
17146,17146,disableLifecycleMethods,0.0,0,0,0
17147,17147,discardComments,0.0,0,0,0
17148,17148,discardEmpty,0.0,0,0,0
17149,17149,displayMode,0.0,0,0,0
17150,17150,displayName,0.0,0,0,0
17151,17151,distDir,0.0,0,0,0
17152,17152,doEffect,0.0,0,0,0
17153,17153,doclets,0.0,0,0,0
17154,17154,doneInvoke,0.0,0,0,0
17155,17155,down,0.0,0,0,0
17156,17156,dring,0.0,0,0,0
17157,17157,drink,0.0,0,0,0
17158,17158,dynamic,0.0,0,0,0
17159,17159,edgeLightPackage,0.0,0,0,0
17160,17160,edgeLightPackageExports,0.0,0,0,0
17161,17161,editing,0.0,0,0,0
17162,17162,eight,0.0,0,0,0
17163,17163,eleven,0.0,0,0,0
17164,17164,emitRouterFixtureReselect,0.0,0,0,0
17165,17165,emitRouterFixtureSelect,0.0,0,0,0
17166,17166,emitRouterFixtureUnselect,0.0,0,0,0
17167,17167,enable,0.0,0,0,0
17168,17168,enableDismissTrigger,0.0,0,0,0
17169,17169,encodeSpecialCharacters,0.0,0,0,0
17170,17170,encodeURI,0.0,0,0,0
17171,17171,encodeURIComponent,0.0,0,0,0
17172,17172,endCallback,0.0,0,0,0
17173,17173,engine,0.0,0,0,0
17174,17174,entryAction,0.0,0,0,0
17175,17175,enumerable,0.0,0,0,0
17176,17176,equals,0.0,0,0,0
17177,17177,escalate,0.0,0,0,0
17178,17178,escape,0.0,0,0,0
17179,17179,eslintConfig,0.0,0,0,0
17180,17180,evalNumber,0.0,0,0,0
17181,17181,even,0.0,0,0,0
17182,17182,evenAction,0.0,0,0,0
17183,17183,eventName,0.0,0,0,0
17184,17184,eventsCausingActions,0.0,0,0,0
17185,17185,eventsCausingDelays,0.0,0,0,0
17186,17186,eventsCausingGuards,0.0,0,0,0
17187,17187,eventsCausingServices,0.0,0,0,0
17188,17188,every,0.0,0,0,0
17189,17189,evil,0.0,0,0,0
17190,17190,example 1,0.0,0,0,0
17191,17191,example 2,0.0,0,0,0
17192,17192,exampleToolbar,0.0,0,0,0
17193,17193,examplesLoader,0.0,0,0,0
17194,17194,exclude,0.0,0,0,0
17195,17195,excludeAll,0.0,0,0,0
17196,17196,executeAfterTransition,0.0,0,0,0
17197,17197,existsSync,0.0,0,0,0
17198,17198,expandDefaultComponent,0.0,0,0,0
17199,17199,expectSnapshotToMatch,0.0,0,0,0
17200,17200,expectTypeOf,0.0,0,0,0
17201,17201,expectedManifestRoutes,0.0,0,0,0
17202,17202,export,0.0,0,0,0
17203,17203,exposedKeys,0.0,0,0,0
17204,17204,expressApp,0.0,0,0,0
17205,17205,extendObservable,0.0,0,0,0
17206,17206,extendWithValues,0.0,0,0,0
17207,17207,extractJSON,0.0,0,0,0
17208,17208,fadeInGreen,0.0,0,0,0
17209,17209,falseSyncOption,0.0,0,0,0
17210,17210,fastForwardTo,0.0,0,0,0
17211,17211,fetchSmth,0.0,0,0,0
17212,17212,fetchWithPolicy,0.0,0,0,0
17213,17213,fetched,0.0,0,0,0
17214,17214,fifteen,0.0,0,0,0
17215,17215,fileURLToPath,0.0,0,0,0
17216,17216,fillsWithIds,0.0,0,0,0
17217,17217,filterComponentExamples,0.0,0,0,0
17218,17218,filterComponentsByExactName,0.0,0,0,0
17219,17219,filterComponentsByName,0.0,0,0,0
17220,17220,filterComponentsInSectionsByExactName,0.0,0,0,0
17221,17221,filterComponentsWithExample,0.0,0,0,0
17222,17222,filterModuleRules,0.0,0,0,0
17223,17223,filterSectionExamples,0.0,0,0,0
17224,17224,filterSectionsByName,0.0,0,0,0
17225,17225,findConfig,0.0,0,0,0
17226,17226,findCosmosPluginConfigs,0.0,0,0,0
17227,17227,findFileCaseInsensitive,0.0,0,0,0
17228,17228,findOne,0.0,0,0,0
17229,17229,findPageFile,0.0,0,0,0
17230,17230,findSection,0.0,0,0,0
17231,17231,findUserWebpackConfig,0.0,0,0,0
17232,17232,finish,0.0,0,0,0
17233,17233,finish_one,0.0,0,0,0
17234,17234,finish_two,0.0,0,0,0
17235,17235,firstNameRef,0.0,0,0,0
17236,17236,five,0.0,0,0,0
17237,17237,fixtureDir,0.0,0,0,0
17238,17238,fixtureNames,0.0,0,0,0
17239,17239,fixtureTree,0.0,0,0,0
17240,17240,flatten,0.0,0,0,0
17241,17241,flattenFixtureTree,0.0,0,0,0
17242,17242,flow2,0.0,0,0,0
17243,17243,flowType,0.0,0,0,0
17244,17244,flushToDisk,0.0,0,0,0
17245,17245,focusableChildren,0.0,0,0,0
17246,17246,fonts,0.0,0,0,0
17247,17247,fooEnvVar,0.0,0,0,0
17248,17248,fooKey,0.0,0,0,0
17249,17249,foobar,0.0,0,0,0
17250,17250,foobaz,0.0,0,0,0
17251,17251,forceLocale,0.0,0,0,0
17252,17252,forcedPort,0.0,0,0,0
17253,17253,form,0.0,0,0,0
17254,17254,forwardTo,0.0,0,0,0
17255,17255,four,0.0,0,0,0
17256,17256,fourteen,0.0,0,0,0
17257,17257,fromJSONSchema,0.0,0,0,0
17258,17258,fromPromise,0.0,0,0,0
17259,17259,fromReducer,0.0,0,0,0
17260,17260,fulfill,0.0,0,0,0
17261,17261,generate,0.0,0,0,0
17262,17262,generateCookies,0.0,0,0,0
17263,17263,generateExport,0.0,0,0,0
17264,17264,generator,0.0,0,0,0
17265,17265,getAdjacencyList,0.0,0,0,0
17266,17266,getAllContentPages,0.0,0,0,0
17267,17267,getAnnouncerContent,0.0,0,0,0
17268,17268,getAttrs,0.0,0,0,0
17269,17269,getClassNames,0.0,0,0,0
17270,17270,getClasses,0.0,0,0,0
17271,17271,getComponent,0.0,0,0,0
17272,17272,getComponentFiles,0.0,0,0,0
17273,17273,getComponentFilesFromSections,0.0,0,0,0
17274,17274,getComponentPatternsFromSections,0.0,0,0,0
17275,17275,getComponents,0.0,0,0,0
17276,17276,getConfig,0.0,0,0,0
17277,17277,getConfiguration,0.0,0,0,0
17278,17278,getConnectedRendererIds,0.0,0,0,0
17279,17279,getCookieFromResponse,0.0,0,0,0
17280,17280,getCustomDevWebpackConfig,0.0,0,0,0
17281,17281,getCustomExportWebpackConfig,0.0,0,0,0
17282,17282,getDOMNode,0.0,0,0,0
17283,17283,getDataAttributes,0.0,0,0,0
17284,17284,getDefaultDevWebpackConfig,0.0,0,0,0
17285,17285,getDefaultExportWebpackConfig,0.0,0,0,0
17286,17286,getDefaultWebpackConfig,0.0,0,0,0
17287,17287,getDummyFixture,0.0,0,0,0
17288,17288,getElementFromSelector,0.0,0,0,0
17289,17289,getElementScrollSpy,0.0,0,0,0
17290,17290,getExampleFilename,0.0,0,0,0
17291,17291,getExamples,0.0,0,0,0
17292,17292,getFilterRegExp,0.0,0,0,0
17293,17293,getFixture,0.0,0,0,0
17294,17294,getFixtureState,0.0,0,0,0
17295,17295,getFixtures,0.0,0,0,0
17296,17296,getImage,0.0,0,0,0
17297,17297,getInfoFromHash,0.0,0,0,0
17298,17298,getInitialProps,0.0,0,0,0
17299,17299,getInitialState,0.0,0,0,0
17300,17300,getLeftScroll,0.0,0,0,0
17301,17301,getMarkdown,0.0,0,0,0
17302,17302,getMaxAge,0.0,0,0,0
17303,17303,getMessageHandlerContext,0.0,0,0,0
17304,17304,getMessageHandlerMethods,0.0,0,0,0
17305,17305,getMiddlewareMatchers,0.0,0,0,0
17306,17306,getMultipleElementsFromSelector,0.0,0,0,0
17307,17307,getNodeOptionsWithoutInspect,0.0,0,0,0
17308,17308,getOxfordCommaList,0.0,0,0,0
17309,17309,getPagePath,0.0,0,0,0
17310,17310,getPageStaticInfo,0.0,0,0,0
17311,17311,getPageTitle,0.0,0,0,0
17312,17312,getPathSnapshot,0.0,0,0,0
17313,17313,getPaths,0.0,0,0,0
17314,17314,getPathsSnapshot,0.0,0,0,0
17315,17315,getPrimaryRendererId,0.0,0,0,0
17316,17316,getRedboxDescription,0.0,0,0,0
17317,17317,getRedboxSource,0.0,0,0,0
17318,17318,getRendererCoreContext,0.0,0,0,0
17319,17319,getRendererCoreMethods,0.0,0,0,0
17320,17320,getRendererUrl,0.0,0,0,0
17321,17321,getRequestMeta,0.0,0,0,0
17322,17322,getRouteData,0.0,0,0,0
17323,17323,getRowKey,0.0,0,0,0
17324,17324,getSanitizedTraces,0.0,0,0,0
17325,17325,getSections,0.0,0,0,0
17326,17326,getSelectedFixtureId,0.0,0,0,0
17327,17327,getSelectorFromElement,0.0,0,0,0
17328,17328,getShortestPaths,0.0,0,0,0
17329,17329,getShortestPathsFrom,0.0,0,0,0
17330,17330,getSimplePaths,0.0,0,0,0
17331,17331,getSimplePathsFrom,0.0,0,0,0
17332,17332,getSocketUrl,0.0,0,0,0
17333,17333,getStateNode,0.0,0,0,0
17334,17334,getStateNodeById,0.0,0,0,0
17335,17335,getStateNodes,0.0,0,0,0
17336,17336,getStorageMethods,0.0,0,0,0
17337,17337,getTopScroll,0.0,0,0,0
17338,17338,getType,0.0,0,0,0
17339,17339,getUrl,0.0,0,0,0
17340,17340,getUrlParams,0.0,0,0,0
17341,17341,getUserPackageJson,0.0,0,0,0
17342,17342,getWebpackVersion,0.0,0,0,0
17343,17343,getjQuery,0.0,0,0,0
17344,17344,glob,0.0,0,0,0
17345,17345,globalThis,0.0,0,0,0
17346,17346,globalizeComponent,0.0,0,0,0
17347,17347,globalizeComponents,0.0,0,0,0
17348,17348,go,0.0,0,0,0
17349,17349,gone,0.0,0,0,0
17350,17350,googlebot,0.0,0,0,0
17351,17351,green,0.0,0,0,0
17352,17352,gsp,0.0,0,0,0
17353,17353,gssp,0.0,0,0,0
17354,17354,handleChange,0.0,0,0,0
17355,17355,handleSuccess,0.0,0,0,0
17356,17356,handleUpdate,0.0,0,0,0
17357,17357,has,0.0,0,0,0
17358,17358,hasSidebar,0.0,0,0,0
17359,17359,headElement,0.0,0,0,0
17360,17360,hidden,0.0,0,0,0
17361,17361,hide,0.0,0,0,0
17362,17362,hideFixtureSuffix,0.0,0,0,0
17363,17363,hiding,0.0,0,0,0
17364,17364,highlightCode,0.0,0,0,0
17365,17365,highlightCodeInMarkdown,0.0,0,0,0
17366,17366,hist,0.0,0,0,0
17367,17367,homepageUrl,0.0,0,0,0
17368,17368,htmlEscapeJsonString,0.0,0,0,0
17369,17369,httpEquiv,0.0,0,0,0
17370,17370,httpMock,0.0,0,0,0
17371,17371,httpServer,0.0,0,0,0
17372,17372,http_proxy,0.0,0,0,0
17373,17373,icons,0.0,0,0,0
17374,17374,ignore,0.0,0,0,0
17375,17375,ignoreImports,0.0,0,0,0
17376,17376,inert,0.0,0,0,0
17377,17377,infinite$,0.0,0,0,0
17378,17378,initConnection,0.0,0,0,0
17379,17379,initEvent,0.0,0,0,0
17380,17380,initNextServerScript,0.0,0,0,0
17381,17381,initialFixtureId,0.0,0,0,0
17382,17382,initialRand,0.0,0,0,0
17383,17383,initialize,0.0,0,0,0
17384,17384,inspect,0.0,0,0,0
17385,17385,installCommand,0.0,0,0,0
17386,17386,intermediate,0.0,0,0,0
17387,17387,internal,0.0,0,0,0
17388,17388,internalEvents,0.0,0,0,0
17389,17389,intervalMachine,0.0,0,0,0
17390,17390,invalid,0.0,0,0,0
17391,17391,invalidDynamicCode,0.0,0,0,0
17392,17392,invalidStaticCode,0.0,0,0,0
17393,17393,invokeChild,0.0,0,0,0
17394,17394,invokePromiseMachine,0.0,0,0,0
17395,17395,invokeSrcNameMap,0.0,0,0,0
17396,17396,isAnimated,0.0,0,0,0
17397,17397,isBot,0.0,0,0,0
17398,17398,isEmergency,0.0,0,0,0
17399,17399,isNextProd,0.0,0,0,0
17400,17400,isNextStart,0.0,0,0,0
17401,17401,isOverflowing,0.0,0,0,0
17402,17402,isRTL,0.0,0,0,0
17403,17403,isRendererConnected,0.0,0,0,0
17404,17404,isScrollBarHidden,0.0,0,0,0
17405,17405,isServer,0.0,0,0,0
17406,17406,isSupported,0.0,0,0,0
17407,17407,isSuspenseyDataResolved,0.0,0,0,0
17408,17408,isWebpack4,0.0,0,0,0
17409,17409,isolated,0.0,0,0,0
17410,17410,itemProp,0.0,0,0,0
17411,17411,joinPaths,0.0,0,0,0
17412,17412,jp,0.0,0,0,0
17413,17413,jquery,0.0,0,0,0
17414,17414,jss,0.0,0,0,0
17415,17415,jssBase,0.0,0,0,0
17416,17416,jumping,0.0,0,0,0
17417,17417,keepDecorators,0.0,0,0,0
17418,17418,keywords,0.0,0,0,0
17419,17419,kill,0.0,0,0,0
17420,17420,killApp,0.0,0,0,0
17421,17421,land,0.0,0,0,0
17422,17422,lastIsPending,0.0,0,0,0
17423,17423,least,0.0,0,0,0
17424,17424,leftCallback,0.0,0,0,0
17425,17425,lightConfig,0.0,0,0,0
17426,17426,linterConfig,0.0,0,0,0
17427,17427,linterConfigWithMultipleDirectories,0.0,0,0,0
17428,17428,listen,0.0,0,0,0
17429,17429,loadConfig,0.0,0,0,0
17430,17430,loadEnvConfig,0.0,0,0,0
17431,17431,loadGetInitialProps,0.0,0,0,0
17432,17432,loadPlugins,0.0,0,0,0
17433,17433,loadTestPlugins,0.0,0,0,0
17434,17434,loaded,0.0,0,0,0
17435,17435,loader,0.0,0,0,0
17436,17436,loc,0.0,0,0,0
17437,17437,localeCompare,0.0,0,0,0
17438,17438,locales,0.0,0,0,0
17439,17439,logger,0.0,0,0,0
17440,17440,loginCount,0.0,0,0,0
17441,17441,major,0.0,0,0,0
17442,17442,makeWebpackConfig,0.0,0,0,0
17443,17443,mapState,0.0,0,0,0
17444,17444,matchLogs,0.0,0,0,0
17445,17445,matchesStates,0.0,0,0,0
17446,17446,maxInactiveAge,0.0,0,0,0
17447,17447,me,0.0,0,0,0
17448,17448,mergeWebpackConfig,0.0,0,0,0
17449,17449,minimizer,0.0,0,0,0
17450,17450,missingImplementations,0.0,0,0,0
17451,17451,mitt,0.0,0,0,0
17452,17452,mockCliArgs,0.0,0,0,0
17453,17453,mockConsole,0.0,0,0,0
17454,17454,mockCosmosConfig,0.0,0,0,0
17455,17455,mockCwdModuleDefault,0.0,0,0,0
17456,17456,mockFixtureListUpdate,0.0,0,0,0
17457,17457,mockFixtureStateChange,0.0,0,0,0
17458,17458,mockFixtureStateChangeResponse,0.0,0,0,0
17459,17459,mockImplementation,0.0,0,0,0
17460,17460,mockMessageHandler,0.0,0,0,0
17461,17461,mockNotifications,0.0,0,0,0
17462,17462,mockRendererCore,0.0,0,0,0
17463,17463,mockRestore,0.0,0,0,0
17464,17464,mockReturnValue,0.0,0,0,0
17465,17465,mockSetFixtureStateCall,0.0,0,0,0
17466,17466,mockSetItem,0.0,0,0,0
17467,17467,mockWebpackConfig,0.0,0,0,0
17468,17468,mockWebpackOverride,0.0,0,0,0
17469,17469,mockedGoogleFontResponses,0.0,0,0,0
17470,17470,mod,0.0,0,0,0
17471,17471,modifiers,0.0,0,0,0
17472,17472,modulePaths,0.0,0,0,0
17473,17473,mountNode,0.0,0,0,0
17474,17474,moveTo,0.0,0,0,0
17475,17475,multiPathMachine,0.0,0,0,0
17476,17476,multiple,0.0,0,0,0
17477,17477,myActivity,0.0,0,0,0
17478,17478,myChild,0.0,0,0,0
17479,17479,navigateTest,0.0,0,0,0
17480,17480,navigator,0.0,0,0,0
17481,17481,nestedParallelState,0.0,0,0,0
17482,17482,newLightMachine,0.0,0,0,0
17483,17483,nextBuild,0.0,0,0,0
17484,17484,nextConfigHeaders,0.0,0,0,0
17485,17485,nextStart,0.0,0,0,0
17486,17486,nextUrl,0.0,0,0,0
17487,17487,nextWhenVisible,0.0,0,0,0
17488,17488,nine,0.0,0,0,0
17489,17489,nochrome,0.0,0,0,0
17490,17490,nodeFs,0.0,0,0,0
17491,17491,nodeType,0.0,0,0,0
17492,17492,noeditor,0.0,0,0,0
17493,17493,normalizePagePath,0.0,0,0,0
17494,17494,normalizeSpyEvents,0.0,0,0,0
17495,17495,normalizeWhitespace,0.0,0,0,0
17496,17496,nxtPcomment,0.0,0,0,0
17497,17497,nxtPid,0.0,0,0,0
17498,17498,nxtPlang,0.0,0,0,0
17499,17499,nxtPuser,0.0,0,0,0
17500,17500,obj1,0.0,0,0,0
17501,17501,objectFit,0.0,0,0,0
17502,17502,objectPosition,0.0,0,0,0
17503,17503,observable2,0.0,0,0,0
17504,17504,observableMachine,0.0,0,0,0
17505,17505,observableMap,0.0,0,0,0
17506,17506,observe_,0.0,0,0,0
17507,17507,odd,0.0,0,0,0
17508,17508,oddAction,0.0,0,0,0
17509,17509,onEvent,0.0,0,0,0
17510,17510,onExit,0.0,0,0,0
17511,17511,onFirstUpdate,0.0,0,0,0
17512,17512,onMessageHandler,0.0,0,0,0
17513,17513,onRegister,0.0,0,0,0
17514,17514,onRendererCore,0.0,0,0,0
17515,17515,onRouter,0.0,0,0,0
17516,17516,onStop,0.0,0,0,0
17517,17517,onTransition,0.0,0,0,0
17518,17518,once,0.0,0,0,0
17519,17519,onlyActive,0.0,0,0,0
17520,17520,onlyGenerated,0.0,0,0,0
17521,17521,onlyRemoveTypeImports,0.0,0,0,0
17522,17522,optimization,0.0,0,0,0
17523,17523,ordered,0.0,0,0,0
17524,17524,origRandHome,0.0,0,0,0
17525,17525,origRandWithCookies,0.0,0,0,0
17526,17526,os,0.0,0,0,0
17527,17527,overwrite,0.0,0,0,0
17528,17528,paddingRight,0.0,0,0,0
17529,17529,pageFilePath,0.0,0,0,0
17530,17530,pagePerSection,0.0,0,0,0
17531,17531,pageType,0.0,0,0,0
17532,17532,pagesDir,0.0,0,0,0
17533,17533,para,0.0,0,0,0
17534,17534,parallel,0.0,0,0,0
17535,17535,parallelDeepMachine,0.0,0,0,0
17536,17536,parallelSteps,0.0,0,0,0
17537,17537,parentElement,0.0,0,0,0
17538,17538,parseExample,0.0,0,0,0
17539,17539,parseFloat,0.0,0,0,0
17540,17540,pass,0.0,0,0,0
17541,17541,passwordField,0.0,0,0,0
17542,17542,pathLine,0.0,0,0,0
17543,17543,pathToBundles,0.0,0,0,0
17544,17544,pathToConfig,0.0,0,0,0
17545,17545,pathToConfigFn,0.0,0,0,0
17546,17546,patterns,0.0,0,0,0
17547,17547,pause,0.0,0,0,0
17548,17548,pending,0.0,0,0,0
17549,17549,persistedFetchState,0.0,0,0,0
17550,17550,phase,0.0,0,0,0
17551,17551,pingPong,0.0,0,0,0
17552,17552,pipe,0.0,0,0,0
17553,17553,pitch,0.0,0,0,0
17554,17554,pizza,0.0,0,0,0
17555,17555,playgroundConfig,0.0,0,0,0
17556,17556,pluginConfigs,0.0,0,0,0
17557,17557,pongActorMachine,0.0,0,0,0
17558,17558,pop,0.0,0,0,0
17559,17559,popUrlParams,0.0,0,0,0
17560,17560,postcss,0.0,0,0,0
17561,17561,pow,0.0,0,0,0
17562,17562,preconnect,0.0,0,0,0
17563,17563,predicate,0.0,0,0,0
17564,17564,preload,0.0,0,0,0
17565,17565,prerenderManifest,0.0,0,0,0
17566,17566,present,0.0,0,0,0
17567,17567,preserveActionOrder,0.0,0,0,0
17568,17568,preventDefault,0.0,0,0,0
17569,17569,previewDelay,0.0,0,0,0
17570,17570,previewModeId,0.0,0,0,0
17571,17571,priority,0.0,0,0,0
17572,17572,process$env$nodeEnv,0.0,0,0,0
17573,17573,processComponent,0.0,0,0,0
17574,17574,processComponents,0.0,0,0,0
17575,17575,processSection,0.0,0,0,0
17576,17576,processSections,0.0,0,0,0
17577,17577,prod,0.0,0,0,0
17578,17578,projectId,0.0,0,0,0
17579,17579,propsLoader,0.0,0,0,0
17580,17580,publicPath,0.0,0,0,0
17581,17581,publisher,0.0,0,0,0
17582,17582,pure,0.0,0,0,0
17583,17583,pushBaz,0.0,0,0,0
17584,17584,pushUrlParams,0.0,0,0,0
17585,17585,query1,0.0,0,0,0
17586,17586,question,0.0,0,0,0
17587,17587,quux,0.0,0,0,0
17588,17588,qwertyService,0.0,0,0,0
17589,17589,race,0.0,0,0,0
17590,17590,raw,0.0,0,0,0
17591,17591,read,0.0,0,0,0
17592,17592,readJSON,0.0,0,0,0
17593,17593,readJson,0.0,0,0,0
17594,17594,readMiddlewareError,0.0,0,0,0
17595,17595,readdir,0.0,0,0,0
17596,17596,ready,0.0,0,0,0
17597,17597,reason,0.0,0,0,0
17598,17598,recommended,0.0,0,0,0
17599,17599,recursiveDelete,0.0,0,0,0
17600,17600,recursiveReadDir,0.0,0,0,0
17601,17601,redData,0.0,0,0,0
17602,17602,redirects,0.0,0,0,0
17603,17603,referencedAction,0.0,0,0,0
17604,17604,referrer,0.0,0,0,0
17605,17605,reflow,0.0,0,0,0
17606,17606,registerTestPlugins,0.0,0,0,0
17607,17607,rejects,0.0,0,0,0
17608,17608,relativePaths,0.0,0,0,0
17609,17609,relativeToDir,0.0,0,0,0
17610,17610,relay,0.0,0,0,0
17611,17611,release_down,0.0,0,0,0
17612,17612,removeAll,0.0,0,0,0
17613,17613,removeAttribute,0.0,0,0,0
17614,17614,removeDataAttribute,0.0,0,0,0
17615,17615,removeDoclets,0.0,0,0,0
17616,17616,removeProperty,0.0,0,0,0
17617,17617,removed,0.0,0,0,0
17618,17618,renderFlow,0.0,0,0,0
17619,17619,renderStatic,0.0,0,0,0
17620,17620,renderStyleguide,0.0,0,0,0
17621,17621,renderToStaticMarkup,0.0,0,0,0
17622,17622,renderWithPolicy,0.0,0,0,0
17623,17623,rendererConfig,0.0,0,0,0
17624,17624,rendererCore,0.0,0,0,0
17625,17625,rendererCoreConfig,0.0,0,0,0
17626,17626,rendererSocketMessage,0.0,0,0,0
17627,17627,requireInRuntime,0.0,0,0,0
17628,17628,requireIt,0.0,0,0,0
17629,17629,requirePage,0.0,0,0,0
17630,17630,requiresReaction,0.0,0,0,0
17631,17631,resolveDataDir,0.0,0,0,0
17632,17632,resolveMachine,0.0,0,0,0
17633,17633,resolveSend,0.0,0,0,0
17634,17634,resolveState,0.0,0,0,0
17635,17635,resolveStreamResponse,0.0,0,0,0
17636,17636,resolvedUrl,0.0,0,0,0
17637,17637,resolves,0.0,0,0,0
17638,17638,resource,0.0,0,0,0
17639,17639,resourcePath,0.0,0,0,0
17640,17640,respond,0.0,0,0,0
17641,17641,restorePointerEvents,0.0,0,0,0
17642,17642,returnValue,0.0,0,0,0
17643,17643,returns,0.0,0,0,0
17644,17644,revalidatedTags,0.0,0,0,0
17645,17645,reveal,0.0,0,0,0
17646,17646,revealAnswer,0.0,0,0,0
17647,17647,rewriteSlug,0.0,0,0,0
17648,17648,ribbon,0.0,0,0,0
17649,17649,rightCallback,0.0,0,0,0
17650,17650,robots,0.0,0,0,0
17651,17651,rootElement,0.0,0,0,0
17652,17652,rootNode,0.0,0,0,0
17653,17653,ruleName,0.0,0,0,0
17654,17654,runInNewContext,0.0,0,0,0
17655,17655,runTest,0.0,0,0,0
17656,17656,s3,0.0,0,0,0
17657,17657,s4,0.0,0,0,0
17658,17658,s7,0.0,0,0,0
17659,17659,s8,0.0,0,0,0
17660,17660,safe,0.0,0,0,0
17661,17661,same,0.0,0,0,0
17662,17662,sanitize,0.0,0,0,0
17663,17663,sanitizeConfig,0.0,0,0,0
17664,17664,sass,0.0,0,0,0
17665,17665,saved,0.0,0,0,0
17666,17666,searching,0.0,0,0,0
17667,17667,second,0.0,0,0,0
17668,17668,secondInvalidDynamicCode,0.0,0,0,0
17669,17669,sectionToolbar,0.0,0,0,0
17670,17670,semantic,0.0,0,0,0
17671,17671,semi,0.0,0,0,0
17672,17672,sendMachine,0.0,0,0,0
17673,17673,sendMessage,0.0,0,0,0
17674,17674,sending,0.0,0,0,0
17675,17675,serialize,0.0,0,0,0
17676,17676,serializeEvent,0.0,0,0,0
17677,17677,serializeState,0.0,0,0,0
17678,17678,serverDistDir,0.0,0,0,0
17679,17679,serverSocketMessage,0.0,0,0,0
17680,17680,sessionId,0.0,0,0,0
17681,17681,setContent,0.0,0,0,0
17682,17682,setDataAttribute,0.0,0,0,0
17683,17683,setType,0.0,0,0,0
17684,17684,setup,0.0,0,0,0
17685,17685,setupLogger,0.0,0,0,0
17686,17686,setupTestDir,0.0,0,0,0
17687,17687,seven,0.0,0,0,0
17688,17688,short_name,0.0,0,0,0
17689,17689,showCode,0.0,0,0,0
17690,17690,showSidebar,0.0,0,0,0
17691,17691,showSpaces,0.0,0,0,0
17692,17692,showUsage,0.0,0,0,0
17693,17693,showcode,0.0,0,0,0
17694,17694,simple,0.0,0,0,0
17695,17695,simpleNextState,0.0,0,0,0
17696,17696,since,0.0,0,0,0
17697,17697,six,0.0,0,0,0
17698,17698,skipComponentsWithoutExample,0.0,0,0,0
17699,17699,skipDeploy,0.0,0,0,0
17700,17700,skipStart,0.0,0,0,0
17701,17701,slot,0.0,0,0,0
17702,17702,slotName,0.0,0,0,0
17703,17703,slotProps,0.0,0,0,0
17704,17704,slots,0.0,0,0,0
17705,17705,small,0.0,0,0,0
17706,17706,smoothScroll,0.0,0,0,0
17707,17707,someAction,0.0,0,0,0
17708,17708,someCallback,0.0,0,0,0
17709,17709,someCondition,0.0,0,0,0
17710,17710,somePromise,0.0,0,0,0
17711,17711,someSrc,0.0,0,0,0
17712,17712,someState,0.0,0,0,0
17713,17713,something,0.0,0,0,0
17714,17714,sortProps,0.0,0,0,0
17715,17715,splice,0.0,0,0,0
17716,17716,splitCookiesString,0.0,0,0,0
17717,17717,splitExampleCode,0.0,0,0,0
17718,17718,spyOnProperty,0.0,0,0,0
17719,17719,srcset,0.0,0,0,0
17720,17720,standing,0.0,0,0,0
17721,17721,startCommand,0.0,0,0,0
17722,17722,startDevServer,0.0,0,0,0
17723,17723,start_url,0.0,0,0,0
17724,17724,startsWith,0.0,0,0,0
17725,17725,state2BP,0.0,0,0,0
17726,17726,state2BQ,0.0,0,0,0
17727,17727,stateACDKL,0.0,0,0,0
17728,17728,stateACEKMO,0.0,0,0,0
17729,17729,stateInitial,0.0,0,0,0
17730,17730,stateM,0.0,0,0,0
17731,17731,stateMatcher,0.0,0,0,0
17732,17732,stateSimple,0.0,0,0,0
17733,17733,static,0.0,0,0,0
17734,17734,stats,0.0,0,0,0
17735,17735,statusCode,0.0,0,0,0
17736,17736,statusText,0.0,0,0,0
17737,17737,stdio,0.0,0,0,0
17738,17738,stopServer,0.0,0,0,0
17739,17739,storybookPlugin,0.0,0,0,0
17740,17740,strict,0.0,0,0,0
17741,17741,stringService,0.0,0,0,0
17742,17742,stringifiedBaseTag,0.0,0,0,0
17743,17743,stringifiedBodyAttributes,0.0,0,0,0
17744,17744,stringifiedData,0.0,0,0,0
17745,17745,stringifiedHtmlAttributes,0.0,0,0,0
17746,17746,stringifiedLinkTags,0.0,0,0,0
17747,17747,stringifiedMetaTags,0.0,0,0,0
17748,17748,stringifiedMetaTagsFromServer,0.0,0,0,0
17749,17749,stringifiedNoscriptTags,0.0,0,0,0
17750,17750,stringifiedScriptTags,0.0,0,0,0
17751,17751,stringifiedStyleTags,0.0,0,0,0
17752,17752,stringifiedTitle,0.0,0,0,0
17753,17753,stringifiedTitleWithItemprop,0.0,0,0,0
17754,17754,stringifiedTitleWithItempropFromServer,0.0,0,0,0
17755,17755,stringifiedTitleWithTitleExpression,0.0,0,0,0
17756,17756,stripShebang,0.0,0,0,0
17757,17757,struct,0.0,0,0,0
17758,17758,stub,0.0,0,0,0
17759,17759,styleguide,0.0,0,0,0
17760,17760,styleguideComponents,0.0,0,0,0
17761,17761,styleguideConfig,0.0,0,0,0
17762,17762,styleguideLoader,0.0,0,0,0
17763,17763,styleguidist,0.0,0,0,0
17764,17764,submitting,0.0,0,0,0
17765,17765,substring,0.0,0,0,0
17766,17766,succeed,0.0,0,0,0
17767,17767,supportPointerEvent,0.0,0,0,0
17768,17768,swc,0.0,0,0,0
17769,17769,switch,0.0,0,0,0
17770,17770,symlink,0.0,0,0,0
17771,17771,tab body,0.0,0,0,0
17772,17772,tab buttons,0.0,0,0,0
17773,17773,tabBody,0.0,0,0,0
17774,17774,tabButtons,0.0,0,0,0
17775,17775,tabIndex,0.0,0,0,0
17776,17776,tagName,0.0,0,0,0
17777,17777,take,0.0,0,0,0
17778,17778,targetIndex,0.0,0,0,0
17779,17779,targetName,0.0,0,0,0
17780,17780,targetWindow,0.0,0,0,0
17781,17781,ten,0.0,0,0,0
17782,17782,tenantID,0.0,0,0,0
17783,17783,testAction,0.0,0,0,0
17784,17784,testActions,0.0,0,0,0
17785,17785,testComponentName,0.0,0,0,0
17786,17786,testDelay,0.0,0,0,0
17787,17787,testFinal,0.0,0,0,0
17788,17788,testFunction,0.0,0,0,0
17789,17789,testGuard,0.0,0,0,0
17790,17790,testHistory,0.0,0,0,0
17791,17791,testNum,0.0,0,0,0
17792,17792,testParallel,0.0,0,0,0
17793,17793,testPathSync,0.0,0,0,0
17794,17794,testRuleName,0.0,0,0,0
17795,17795,testServerPlugin,0.0,0,0,0
17796,17796,testService,0.0,0,0,0
17797,17797,testType,0.0,0,0,0
17798,17798,testUtils,0.0,0,0,0
17799,17799,testing,0.0,0,0,0
17800,17800,thanks,0.0,0,0,0
17801,17801,theme_color,0.0,0,0,0
17802,17802,third,0.0,0,0,0
17803,17803,thirdInvalidDynamicCode,0.0,0,0,0
17804,17804,thirteen,0.0,0,0,0
17805,17805,three,0.0,0,0,0
17806,17806,threshold,0.0,0,0,0
17807,17807,thresholds,0.0,0,0,0
17808,17808,tmpdir,0.0,0,0,0
17809,17809,toA,0.0,0,0,0
17810,17810,toB,0.0,0,0,0
17811,17811,toBeCalledTimes,0.0,0,0,0
17812,17812,toBeEmpty,0.0,0,0,0
17813,17813,toBeEmptyObject,0.0,0,0,0
17814,17814,toBeInstanceOf,0.0,0,0,0
17815,17815,toBeOneOf,0.0,0,0,0
17816,17816,toC,0.0,0,0,0
17817,17817,toContainAllKeys,0.0,0,0,0
17818,17818,toDirectedGraph,0.0,0,0,0
17819,17819,toEndWith,0.0,0,0,0
17820,17820,toEqualTypeOf,0.0,0,0,0
17821,17821,toIncludeAllMembers,0.0,0,0,0
17822,17822,toMatchTypeOf,0.0,0,0,0
17823,17823,toUpperCase,0.0,0,0,0
17824,17824,toc,0.0,0,0,0
17825,17825,todoMachine,0.0,0,0,0
17826,17826,todosMachine,0.0,0,0,0
17827,17827,toggleEnabled,0.0,0,0,0
17828,17828,topLevelAwait,0.0,0,0,0
17829,17829,topLevelMachine,0.0,0,0,0
17830,17830,touch,0.0,0,0,0
17831,17831,touches,0.0,0,0,0
17832,17832,trackEntries,0.0,0,0,0
17833,17833,trailingSlash,0.0,0,0,0
17834,17834,transform,0.0,0,0,0
17835,17835,transient,0.0,0,0,0
17836,17836,transitionDelay,0.0,0,0,0
17837,17837,transitionDuration,0.0,0,0,0
17838,17838,transitionToSCXML,0.0,0,0,0
17839,17839,traversalLimit,0.0,0,0,0
17840,17840,triggerTransitionEnd,0.0,0,0,0
17841,17841,tsTypes,0.0,0,0,0
17842,17842,twelve,0.0,0,0,0
17843,17843,typeScript,0.0,0,0,0
17844,17844,ua,0.0,0,0,0
17845,17845,unEncodedStringifiedTitle,0.0,0,0,0
17846,17846,underlined,0.0,0,0,0
17847,17847,unknownAction,0.0,0,0,0
17848,17848,unknownDelay,0.0,0,0,0
17849,17849,unknownGuard,0.0,0,0,0
17850,17850,unknownService,0.0,0,0,0
17851,17851,unquote,0.0,0,0,0
17852,17852,unsaved,0.0,0,0,0
17853,17853,unselectFixture,0.0,0,0,0
17854,17854,unstable_getImgProps,0.0,0,0,0
17855,17855,unsubscribe,0.0,0,0,0
17856,17856,untracked,0.0,0,0,0
17857,17857,updateMachine,0.0,0,0,0
17858,17858,upperCase,0.0,0,0,0
17859,17859,urlsError,0.0,0,0,0
17860,17860,useIsolatedLinks,0.0,0,0,0
17861,17861,useSelectorCustomFn,0.0,0,0,0
17862,17862,userAgentFromString,0.0,0,0,0
17863,17863,userImportsLazyTemplate,0.0,0,0,0
17864,17864,userImportsTemplate,0.0,0,0,0
17865,17865,userOptions,0.0,0,0,0
17866,17866,users,0.0,0,0,0
17867,17867,valid,0.0,0,0,0
17868,17868,validAnchorCode,0.0,0,0,0
17869,17869,validCode,0.0,0,0,0
17870,17870,validDownloadLinkCode,0.0,0,0,0
17871,17871,validExternalLinkCode,0.0,0,0,0
17872,17872,validPublicFile,0.0,0,0,0
17873,17873,validTargetBlankLinkCode,0.0,0,0,0
17874,17874,value1Computed,0.0,0,0,0
17875,17875,valueA,0.0,0,0,0
17876,17876,valueB,0.0,0,0,0
17877,17877,vendor,0.0,0,0,0
17878,17878,verbose,0.0,0,0,0
17879,17879,visibility,0.0,0,0,0
17880,17880,vm,0.0,0,0,0
17881,17881,waitForCacheWrite,0.0,0,0,0
17882,17882,waitForCondition,0.0,0,0,0
17883,17883,waitForScrollToComplete,0.0,0,0,0
17884,17884,waitHydration,0.0,0,0,0
17885,17885,wait_one,0.0,0,0,0
17886,17886,wait_two,0.0,0,0,0
17887,17887,waiting,0.0,0,0,0
17888,17888,waitingForCode,0.0,0,0,0
17889,17889,wak1,0.0,0,0,0
17890,17890,wak2,0.0,0,0,0
17891,17891,walk,0.0,0,0,0
17892,17892,walkData,0.0,0,0,0
17893,17893,walking,0.0,0,0,0
17894,17894,warningMessages,0.0,0,0,0
17895,17895,web,0.0,0,0,0
17896,17896,webpack,0.0,0,0,0
17897,17897,weight,0.0,0,0,0
17898,17898,welcomeScreen,0.0,0,0,0
17899,17899,whatever,0.0,0,0,0
17900,17900,while,0.0,0,0,0
17901,17901,window.__spy__(1),0.0,0,0,0
17902,17902,window.__spy__(2),0.0,0,0,0
17903,17903,withAfter,0.0,0,0,0
17904,17904,withAppLinter,0.0,0,0,0
17905,17905,withContext,0.0,0,0,0
17906,17906,withRequestMeta,0.0,0,0,0
17907,17907,withWebSocketServer,0.0,0,0,0
17908,17908,withoutPagesLinter,0.0,0,0,0
17909,17909,world,0.0,0,0,0
17910,17910,worstGuard,0.0,0,0,0
17911,17911,writable,0.0,0,0,0
17912,17912,ws,0.0,0,0,0
17913,17913,xml2js,0.0,0,0,0
17914,17914,y_key,0.0,0,0,0
17915,17915,yellow,0.0,0,0,0
17916,17916,yellowData,0.0,0,0,0
17917,17917,} > div`,0.0,0,0,0
17918,17918,} `,0.0,0,0,0
17919,17919,} or ${,0.0,0,0,0
17920,17920,} via ${,0.0,0,0,0
17921,17921,"}""))`",0.0,0,0,0
17922,17922,"}"">Click me</a>`",0.0,0,0,0
17923,17923,}&q=${,0.0,0,0,0
17924,17924,}' 'nonce-othernonce'`,0.0,0,0,0
17925,17925,}' `,0.0,0,0,0
17926,17926,}' not found on machine ${,0.0,0,0,0
17927,17927,}';`,0.0,0,0,0
17928,17928,})\\/opengraph\\/static\\/opengraph-image.png\\?b76e8f0282c93c8e`,0.0,0,0,0
17929,17929,})\\/opengraph\\/static\\/twitter-image.png\\?b76e8f0282c93c8e`,0.0,0,0,0
17930,17930,"}, then ${",0.0,0,0,0
17931,17931,"}, when ${",0.0,0,0,0
17932,17932,}-config-redirect-catchall`,0.0,0,0,0
17933,17933,}-config-redirect`,0.0,0,0,0
17934,17934,}-config-rewrite`,0.0,0,0,0
17935,17935,}-middleware-redirect`,0.0,0,0,0
17936,17936,}-middleware-rewrite`,0.0,0,0,0
17937,17937,"}. If using a custom path, please configure with the \`no-html-link-for-pages\` rule in your eslint config file.`",0.0,0,0,0
17938,17938,}.Fragment`,0.0,0,0,0
17939,17939,}.createElement`,0.0,0,0,0
17940,17940,}.html`,0.0,0,0,0
17941,17941,}.json`,0.0,0,0,0
17942,17942,}.rsc`,0.0,0,0,0
17943,17943,}.xml.meta`,0.0,0,0,0
17944,17944,}.xml`,0.0,0,0,0
17945,17945,}/(?<nxtPid>[^/]+?)\\.json$`,0.0,0,0,0
17946,17946,}/([^/]+?)\\.json$`,0.0,0,0,0
17947,17947,}/321.json`,0.0,0,0,0
17948,17948,}/_buildManifest.js`,0.0,0,0,0
17949,17949,}/_cosmos.ico`,0.0,0,0,0
17950,17950,}/_devMiddlewareManifest.json`,0.0,0,0,0
17951,17951,}/_next/data/${,0.0,0,0,0
17952,17952,}/_plugin${,0.0,0,0,0
17953,17953,}/absolute-url-basepath?port=${,0.0,0,0,0
17954,17954,}/absolute-url-no-basepath?port=${,0.0,0,0,0
17955,17955,}/absolute-url`,0.0,0,0,0
17956,17956,}/add-header-no-basepath`,0.0,0,0,0
17957,17957,}/add-header`,0.0,0,0,0
17958,17958,}/amp-hybrid.amp`,0.0,0,0,0
17959,17959,}/amp-hybrid?amp=1`,0.0,0,0,0
17960,17960,}/amp-hybrid`,0.0,0,0,0
17961,17961,}/another-middleware.json`,0.0,0,0,0
17962,17962,}/api-docs/[...slug].json`,0.0,0,0,0
17963,17963,}/api-docs/first.json`,0.0,0,0,0
17964,17964,}/api\\-docs/(?<nxtPslug>.+?)\\.json$`,0.0,0,0,0
17965,17965,}/blocking-fallback-once/[slug].json`,0.0,0,0,0
17966,17966,}/blocking-fallback-some/[slug].json`,0.0,0,0,0
17967,17967,}/blocking-fallback/[slug].json`,0.0,0,0,0
17968,17968,}/blocking-fallback/b.json`,0.0,0,0,0
17969,17969,}/blocking-fallback/pewpewdata.json`,0.0,0,0,0
17970,17970,}/blocking\\-fallback/(?<nxtPslug>[^/]+?)\\.json$`,0.0,0,0,0
17971,17971,}/blocking\\-fallback\\-once/(?<nxtPslug>[^/]+?)\\.json$`,0.0,0,0,0
17972,17972,}/blocking\\-fallback\\-some/(?<nxtPslug>[^/]+?)\\.json$`,0.0,0,0,0
17973,17973,}/blog/(?<nxtPpost>[^/]+?)/(?<nxtPcomment>[^/]+?)\\.json$`,0.0,0,0,0
17974,17974,}/blog/(?<nxtPpost>[^/]+?)\\.json$`,0.0,0,0,0
17975,17975,}/blog/[post].json`,0.0,0,0,0
17976,17976,}/blog/[post]/[comment].json`,0.0,0,0,0
17977,17977,}/blog/post-1.json`,0.0,0,0,0
17978,17978,}/blog/post-10.json`,0.0,0,0,0
17979,17979,}/blog/post-2/comment-3.json`,0.0,0,0,0
17980,17980,}/blog/post-3.json`,0.0,0,0,0
17981,17981,}/catchall-explicit/[...slug].json`,0.0,0,0,0
17982,17982,}/catchall-optional/[[...slug]].json`,0.0,0,0,0
17983,17983,}/catchall/(?<nxtPslug>.+?)\\.json$`,0.0,0,0,0
17984,17984,}/catchall/[...slug].json`,0.0,0,0,0
17985,17985,}/catchall/first.json`,0.0,0,0,0
17986,17986,}/catchall/first/second/third.json`,0.0,0,0,0
17987,17987,}/catchall\\-explicit/(?<nxtPslug>.+?)\\.json$`,0.0,0,0,0
17988,17988,}/catchall\\-optional(?:/(?<nxtPslug>.+?))?\\.json$`,0.0,0,0,0
17989,17989,}/components/Button/Button.js`,0.0,0,0,0
17990,17990,}/components/Placeholder/Placeholder.js`,0.0,0,0,0
17991,17991,}/components`,0.0,0,0,0
17992,17992,}/custom-cache.json`,0.0,0,0,0
17993,17993,}/data.txt`,0.0,0,0,0
17994,17994,}/docs/another`,0.0,0,0,0
17995,17995,}/dynamic/(?<nxtPslug>[^/]+?)\\.json$`,0.0,0,0,0
17996,17996,}/dynamic/[slug].json`,0.0,0,0,0
17997,17997,}/edge/dynamic`,0.0,0,0,0
17998,17998,}/en/fallback-true-blog/${,0.0,0,0,0
17999,17999,}/external-and-back`,0.0,0,0,0
18000,18000,}/external-push/${,0.0,0,0,0
18001,18001,}/fallback-only/[slug].json`,0.0,0,0,0
18002,18002,}/fallback-only/second%2Fpost.json`,0.0,0,0,0
18003,18003,}/fallback\\-only/(?<nxtPslug>[^/]+?)\\.json$`,0.0,0,0,0
18004,18004,}/fonts`,0.0,0,0,0
18005,18005,}/gsp.json`,0.0,0,0,0
18006,18006,}/hello-dynamic`,0.0,0,0,0
18007,18007,}/index.json$`,0.0,0,0,0
18008,18008,}/index.json`,0.0,0,0,0
18009,18009,}/invalid-manual-basepath`,0.0,0,0,0
18010,18010,}/lang/(?<nxtPlang>[^/]+?)/about\\.json$`,0.0,0,0,0
18011,18011,}/lang/[lang]/about.json`,0.0,0,0,0
18012,18012,}/link-to-root`,0.0,0,0,0
18013,18013,}/middleware-rewrite-with-slash.json`,0.0,0,0,0
18014,18014,}/middleware-rewrite-without-slash.json`,0.0,0,0,0
18015,18015,}/middleware/works.json`,0.0,0,0,0
18016,18016,}/next-api/link`,0.0,0,0,0
18017,18017,}/non-json-blocking/[p].json`,0.0,0,0,0
18018,18018,}/non-json/[p].json`,0.0,0,0,0
18019,18019,}/non\\-json/(?<nxtPp>[^/]+?)\\.json$`,0.0,0,0,0
18020,18020,}/non\\-json\\-blocking/(?<nxtPp>[^/]+?)\\.json$`,0.0,0,0,0
18021,18021,"}/other-page"")`",0.0,0,0,0
18022,18022,}/pages`,0.0,0,0,0
18023,18023,}/parallel-tab-bar${,0.0,0,0,0
18024,18024,}/parallel-tab-bar/view-duration`,0.0,0,0,0
18025,18025,}/playground.bundle.js.map`,0.0,0,0,0
18026,18026,}/playground.bundle.js`,0.0,0,0,0
18027,18027,}/redirect-1`,0.0,0,0,0
18028,18028,}/redirect/external-log/${,0.0,0,0,0
18029,18029,}/rewrite-1`,0.0,0,0,0
18030,18030,}/rewrite-no-basePath`,0.0,0,0,0
18031,18031,}/rewritten-to-dashboard`,0.0,0,0,0
18032,18032,}/root`,0.0,0,0,0
18033,18033,}/send-url.json`,0.0,0,0,0
18034,18034,}/sha.json?hello=goodbye`,0.0,0,0,0
18035,18035,}/slug-1`,0.0,0,0,0
18036,18036,}/slug-2`,0.0,0,0,0
18037,18037,}/something.json?another=thing`,0.0,0,0,0
18038,18038,}/something.json?hello=world`,0.0,0,0,0
18039,18039,}/something.json`,0.0,0,0,0
18040,18040,}/ssr-page-2`,0.0,0,0,0
18041,18041,}/ssr-page.json`,0.0,0,0,0
18042,18042,}/static-mpa-navigation/slug-not-existed`,0.0,0,0,0
18043,18043,}/streaming-rsc`,0.0,0,0,0
18044,18044,}/ui.js`,0.0,0,0,0
18045,18045,}/user/(?<nxtPuser>[^/]+?)/profile\\.json$`,0.0,0,0,0
18046,18046,}/user/[user]/profile.json`,0.0,0,0,0
18047,18047,}/valid.json`,0.0,0,0,0
18048,18048,}/vercel-user`,0.0,0,0,0
18049,18049,}/with-middleware.json`,0.0,0,0,0
18050,18050,"}: Option ""parent"" provided type ""number"" but expected type ""(string|element)"".`",0.0,0,0,0
18051,18051,};data=cool`,0.0,0,0,0
18052,18052,}</div>`,0.0,0,0,0
18053,18053,}</loc>`,0.0,0,0,0
18054,18054,}</title>`,0.0,0,0,0
18055,18055,"}=""true"" src=""foo.js"" async></script>`",0.0,0,0,0
18056,18056,"}=""true"" src=""http://localhost/test.js"" type=""text/javascript"" />`",0.0,0,0,0
18057,18057,"}=""true""></title></div>`",0.0,0,0,0
18058,18058,"}=""true""></title>`",0.0,0,0,0
18059,18059,}=${,0.0,0,0,0
18060,18060,}=`,0.0,0,0,0
18061,18061,}></body>`,0.0,0,0,0
18062,18062,}></html>`,0.0,0,0,0
18063,18063,}?next-config-headers=true`,0.0,0,0,0
18064,18064,}?read=1`,0.0,0,0,0
18065,18065,}?reload=false&overlay=false`,0.0,0,0,0
18066,18066,}?reload=true&overlay=false`,0.0,0,0,0
18067,18067,}?w=${,0.0,0,0,0
18068,18068,}@${,0.0,0,0,0
18069,18069,}\\/another.json$`,0.0,0,0,0
18070,18070,}\\/api\\-docs\\/(.+?)\\.json$`,0.0,0,0,0
18071,18071,}\\/bad-gssp.json$`,0.0,0,0,0
18072,18072,}\\/bad-ssr.json$`,0.0,0,0,0
18073,18073,}\\/blocking\\-fallback\\-once\\/([^\\/]+?)\\.json$`,0.0,0,0,0
18074,18074,}\\/blocking\\-fallback\\-some\\/([^\\/]+?)\\.json$`,0.0,0,0,0
18075,18075,}\\/blocking\\-fallback\\/([^\\/]+?)\\.json$`,0.0,0,0,0
18076,18076,}\\/blog.json$`,0.0,0,0,0
18077,18077,}\\/blog\\/([^\\/]+?)\\.json$`,0.0,0,0,0
18078,18078,}\\/blog\\/([^\\/]+?)\\/([^\\/]+?)\\.json$`,0.0,0,0,0
18079,18079,}\\/catchall\\-explicit\\/(.+?)\\.json$`,0.0,0,0,0
18080,18080,}\\/catchall\\-optional(?:\\/(.+?))?\\.json$`,0.0,0,0,0
18081,18081,}\\/catchall\\/(.+?)\\.json$`,0.0,0,0,0
18082,18082,}\\/default-revalidate.json$`,0.0,0,0,0
18083,18083,}\\/dynamic\\/([^\\/]+?)\\.json$`,0.0,0,0,0
18084,18084,}\\/fallback\\-only\\/([^\\/]+?)\\.json$`,0.0,0,0,0
18085,18085,}\\/index.json$`,0.0,0,0,0
18086,18086,}\\/lang\\/([^\\/]+?)\\/about\\.json$`,0.0,0,0,0
18087,18087,}\\/large-page-data-ssr.json$`,0.0,0,0,0
18088,18088,}\\/large-page-data.json$`,0.0,0,0,0
18089,18089,}\\/non\\-json\\-blocking\\/([^\\/]+?)\\.json$`,0.0,0,0,0
18090,18090,}\\/non\\-json\\/([^\\/]+?)\\.json$`,0.0,0,0,0
18091,18091,}\\/preview.json$`,0.0,0,0,0
18092,18092,}\\/something.json$`,0.0,0,0,0
18093,18093,}\\/ssr.json$`,0.0,0,0,0
18094,18094,}\\/user\\/([^\\/]+?)\\/profile\\.json$`,0.0,0,0,0
18095,18095,}]`,0.0,0,0,0
18096,18096,}_error.js`,0.0,0,0,0
18097,18097,}_error`,0.0,0,0,0
18098,18098,}abc${,0.0,0,0,0
18099,18099,}abc`,0.0,0,0,0
18100,18100,}def`,0.0,0,0,0
18101,18101,}index`,0.0,0,0,0
18102,18102,}react$`,0.0,0,0,0
18103,18103,}react-dom$`,0.0,0,0,0
